Rk,Team,Date,PTS,,Opp,Result,MP,FG,FGA,FG%,2P,2PA,2P%,3P,3PA,3P%,FT,FTA,FT%,PTS,FG,FGA,FG%,2P,2PA,2P%,3P,3PA,3P%,FT,FTA,FT%,PTS
1,HOU,2019-11-30,158,,ATL,W 158-111,240,52,89,.584,27,38,.711,25,51,.490,29,34,.853,158,38,89,.427,23,43,.535,15,46,.326,20,25,.800,111
2,WAS,2019-10-30,158,,HOU,L 158-159,240,57,91,.626,37,55,.673,20,36,.556,24,29,.828,158,55,103,.534,32,49,.653,23,54,.426,26,33,.788,159
3,ATL,2020-01-26,152,,WAS,W 152-133,240,54,93,.581,39,58,.672,15,35,.429,29,34,.853,152,42,88,.477,31,55,.564,11,33,.333,38,42,.905,133
4,MIL,2020-01-28,151,,WAS,W 151-131,240,50,90,.556,31,53,.585,19,37,.514,32,35,.914,151,44,94,.468,30,62,.484,14,32,.438,29,34,.853,131
5,LAC,2019-12-01,150,,WAS,W 150-125,240,52,94,.553,38,62,.613,14,32,.438,32,40,.800,150,47,102,.461,36,72,.500,11,30,.367,20,27,.741,125
6,LAC,2019-11-16,150,,ATL,W 150-101,240,50,93,.538,33,60,.550,17,33,.515,33,35,.943,150,34,90,.378,28,66,.424,6,24,.250,27,37,.730,101
7,BOS,2020-08-05,149,,BRK,W 149-115,240,50,88,.568,30,49,.612,20,39,.513,29,35,.829,149,45,95,.474,37,63,.587,8,32,.250,17,21,.810,115
8,DAL,2020-07-31,149,,HOU,L 149-153 (OT),265,50,105,.476,29,56,.518,21,49,.429,28,38,.737,149,52,101,.515,33,53,.623,19,48,.396,30,39,.769,153
9,ATL,2020-03-09,143,,CHO,W 143-138 (2OT),290,53,96,.552,32,53,.604,21,43,.488,16,27,.593,143,49,104,.471,30,56,.536,19,48,.396,21,23,.913,138
10,NYK,2019-12-17,143,,ATL,W 143-120,240,53,95,.558,40,67,.597,13,28,.464,24,31,.774,143,45,99,.455,30,56,.536,15,43,.349,15,20,.750,120
11,DAL,2019-11-22,143,,CLE,W 143-101,240,58,100,.580,38,63,.603,20,37,.541,7,9,.778,143,37,86,.430,25,57,.439,12,29,.414,15,17,.882,101
12,MIN,2020-02-08,142,,LAC,W 142-115,240,52,95,.547,26,51,.510,26,44,.591,12,18,.667,142,41,86,.477,32,60,.533,9,26,.346,24,29,.828,115
13,LAL,2019-12-08,142,,MIN,W 142-125,240,55,94,.585,41,63,.651,14,31,.452,18,20,.900,142,44,84,.524,29,47,.617,15,37,.405,22,26,.846,125
14,DAL,2019-11-20,142,,GSW,W 142-94,240,51,90,.567,29,52,.558,22,38,.579,18,23,.783,142,35,90,.389,27,63,.429,8,27,.296,16,25,.640,94
15,ATL,2020-02-28,141,,BRK,W 141-118,240,50,97,.515,31,58,.534,19,39,.487,22,30,.733,141,42,92,.457,24,46,.522,18,46,.391,16,21,.762,118
16,BOS,2020-02-13,141,,LAC,W 141-133 (2OT),290,45,103,.437,27,60,.450,18,43,.419,33,40,.825,141,46,110,.418,35,75,.467,11,35,.314,30,37,.811,133
17,PHI,2019-12-07,141,,CLE,W 141-94,240,57,90,.633,46,64,.719,11,26,.423,16,23,.696,141,36,96,.375,27,61,.443,9,35,.257,13,17,.765,94
18,SAC,2020-08-06,140,,NOP,W 140-125,240,50,93,.538,34,60,.567,16,33,.485,24,33,.727,140,47,82,.573,33,48,.688,14,34,.412,17,23,.739,125
19,POR,2020-07-31,140,,MEM,W 140-135 (OT),265,49,91,.538,36,61,.590,13,30,.433,29,34,.853,140,42,93,.452,29,52,.558,13,41,.317,38,50,.760,135
20,PHO,2020-03-08,140,,MIL,W 140-131,240,47,85,.553,28,42,.667,19,43,.442,27,31,.871,140,51,95,.537,38,62,.613,13,33,.394,16,21,.762,131
21,HOU,2020-02-26,140,,MEM,W 140-112,240,52,93,.559,29,43,.674,23,50,.460,13,15,.867,140,43,108,.398,30,69,.435,13,39,.333,13,21,.619,112
22,ATL,2020-02-09,140,,NYK,W 140-135 (2OT),290,49,108,.454,35,68,.515,14,40,.350,28,31,.903,140,52,110,.473,39,76,.513,13,34,.382,18,25,.720,135
23,OKC,2020-01-24,140,,ATL,W 140-111,240,50,86,.581,36,61,.590,14,25,.560,26,34,.765,140,42,92,.457,31,56,.554,11,36,.306,16,20,.800,111
24,TOR,2020-01-17,140,,WAS,W 140-111,240,52,91,.571,30,48,.625,22,43,.512,14,16,.875,140,40,89,.449,25,54,.463,15,35,.429,16,23,.696,111
25,BOS,2020-01-11,140,,NOP,W 140-105,240,55,100,.550,41,71,.577,14,29,.483,16,18,.889,140,40,100,.400,26,55,.473,14,45,.311,11,18,.611,105
26,BOS,2019-11-13,140,,WAS,W 140-133,240,49,96,.510,33,60,.550,16,36,.444,26,29,.897,140,50,96,.521,39,67,.582,11,29,.379,22,27,.815,133
27,BRK,2020-03-06,139,,SAS,W 139-120,240,51,96,.531,36,60,.600,15,36,.417,22,31,.710,139,43,92,.467,33,58,.569,10,34,.294,24,27,.889,120
28,DAL,2020-02-24,139,,MIN,W 139-123,240,51,101,.505,35,57,.614,16,44,.364,21,28,.750,139,42,95,.442,27,53,.509,15,42,.357,24,34,.706,123
29,NOP,2020-01-31,139,,MEM,W 139-111,240,51,95,.537,36,61,.590,15,34,.441,22,26,.846,139,45,96,.469,39,65,.600,6,31,.194,15,26,.577,111
30,POR,2020-01-26,139,,IND,W 139-129,240,49,90,.544,29,55,.527,20,35,.571,21,25,.840,139,48,93,.516,35,65,.538,13,28,.464,20,21,.952,129
31,BOS,2020-01-20,139,,LAL,W 139-107,240,52,93,.559,36,59,.610,16,34,.471,19,29,.655,139,39,89,.438,32,63,.508,7,26,.269,22,29,.759,107
32,HOU,2020-01-11,139,,MIN,W 139-109,240,49,95,.516,31,50,.620,18,45,.400,23,29,.793,139,36,95,.379,23,47,.489,13,48,.271,24,36,.667,109
33,OKC,2019-12-06,139,,MIN,W 139-127 (OT),265,49,88,.557,44,70,.629,5,18,.278,36,40,.900,139,50,96,.521,37,58,.638,13,38,.342,14,20,.700,127
34,NOP,2020-02-11,138,,POR,W 138-117,240,49,92,.533,35,58,.603,14,34,.412,26,32,.813,138,44,93,.473,37,64,.578,7,29,.241,22,28,.786,117
35,NOP,2020-01-16,138,,UTA,W 138-132 (OT),265,51,93,.548,40,67,.597,11,26,.423,25,35,.714,138,46,100,.460,31,61,.508,15,39,.385,25,32,.781,132
36,WAS,2019-11-20,138,,SAS,W 138-132,240,54,92,.587,36,62,.581,18,30,.600,12,15,.800,138,49,93,.527,37,61,.607,12,32,.375,22,29,.759,132
37,PHO,2019-11-10,138,,BRK,W 138-112,240,52,99,.525,33,57,.579,19,42,.452,15,19,.789,138,44,91,.484,36,57,.632,8,34,.235,16,17,.941,112
38,TOR,2020-02-10,137,,MIN,W 137-126,240,51,89,.573,34,56,.607,17,33,.515,18,23,.783,137,39,86,.453,21,46,.457,18,40,.450,30,35,.857,126
39,MIA,2020-02-03,137,,PHI,W 137-106,240,48,85,.565,32,53,.604,16,32,.500,25,30,.833,137,36,83,.434,23,45,.511,13,38,.342,21,25,.840,106
40,MIL,2019-11-30,137,,CHO,W 137-96,240,54,96,.563,34,52,.654,20,44,.455,9,15,.600,137,37,101,.366,22,56,.393,15,45,.333,7,8,.875,96
41,MIL,2019-11-21,137,,POR,W 137-129,240,50,106,.472,34,63,.540,16,43,.372,21,26,.808,137,50,103,.485,33,64,.516,17,39,.436,12,14,.857,129
42,MEM,2019-11-06,137,,MIN,W 137-121,240,50,88,.568,38,65,.585,12,23,.522,25,30,.833,137,43,96,.448,27,51,.529,16,45,.356,19,26,.731,121
43,DAL,2020-08-08,136,,MIL,W 136-132 (OT),265,48,115,.417,31,62,.500,17,53,.321,23,25,.920,136,47,99,.475,32,55,.582,15,44,.341,23,34,.676,132
44,LAC,2020-03-01,136,,PHI,W 136-130,240,45,76,.592,32,52,.615,13,24,.542,33,41,.805,136,48,95,.505,27,52,.519,21,43,.488,13,20,.650,130
45,ORL,2020-02-28,136,,MIN,W 136-125,240,53,98,.541,41,58,.707,12,40,.300,18,22,.818,136,46,95,.484,29,51,.569,17,44,.386,16,24,.667,125
46,SAS,2019-12-28,136,,DET,W 136-109,240,53,93,.570,35,58,.603,18,35,.514,12,15,.800,136,40,90,.444,28,54,.519,12,36,.333,17,30,.567,109
47,CHI,2019-12-11,136,,ATL,W 136-102,240,54,94,.574,43,70,.614,11,24,.458,17,19,.895,136,35,83,.422,22,45,.489,13,38,.342,19,26,.731,102
48,POR,2019-11-27,136,,OKC,W 136-119,240,49,94,.521,35,64,.547,14,30,.467,24,24,1.000,136,39,88,.443,28,53,.528,11,35,.314,30,38,.789,119
49,ORL,2020-02-10,135,,ATL,W 135-126,240,50,95,.526,32,57,.561,18,38,.474,17,22,.773,135,47,88,.534,31,51,.608,16,37,.432,16,17,.941,126
50,LAC,2020-01-05,135,,NYK,W 135-132,240,45,83,.542,27,51,.529,18,32,.563,27,33,.818,135,48,84,.571,36,61,.590,12,23,.522,24,37,.649,132
51,MIA,2019-12-10,135,,ATL,W 135-121 (OT),265,53,103,.515,39,62,.629,14,41,.341,15,22,.682,135,45,95,.474,25,41,.610,20,54,.370,11,18,.611,121
52,SAS,2019-12-03,135,,HOU,W 135-133 (2OT),290,50,106,.472,37,76,.487,13,30,.433,22,32,.688,135,42,111,.378,27,60,.450,15,51,.294,34,36,.944,133
53,BRK,2019-11-04,135,,NOP,W 135-125,240,49,92,.533,33,51,.647,16,41,.390,21,28,.750,135,48,97,.495,35,65,.538,13,32,.406,16,21,.762,125
54,DEN,2020-08-08,134,,UTA,W 134-132 (2OT),290,51,108,.472,42,71,.592,9,37,.243,23,30,.767,134,47,105,.448,25,50,.500,22,55,.400,16,22,.727,132
55,NOP,2020-03-03,134,,MIN,L 134-139,240,52,100,.520,38,61,.623,14,39,.359,16,27,.593,134,54,97,.557,40,63,.635,14,34,.412,17,20,.850,139
56,WAS,2020-02-24,134,,MIL,L 134-137 (OT),265,47,98,.480,32,63,.508,15,35,.429,25,33,.758,134,49,86,.570,32,49,.653,17,37,.459,22,27,.815,137
57,CLE,2020-02-03,134,,NYK,L 134-139 (OT),265,52,92,.565,34,57,.596,18,35,.514,12,18,.667,134,57,102,.559,47,76,.618,10,26,.385,15,21,.714,139
58,MIA,2020-01-22,134,,WAS,W 134-129 (OT),265,43,85,.506,26,52,.500,17,33,.515,31,36,.861,134,50,99,.505,37,57,.649,13,42,.310,16,20,.800,129
59,MEM,2020-01-10,134,,SAS,W 134-121,240,52,100,.520,36,62,.581,16,38,.421,14,16,.875,134,42,87,.483,25,47,.532,17,40,.425,20,23,.870,121
60,LAC,2019-11-24,134,,NOP,W 134-109,240,46,98,.469,30,55,.545,16,43,.372,26,33,.788,134,43,98,.439,30,57,.526,13,41,.317,10,18,.556,109
61,MEM,2019-10-27,134,,BRK,W 134-133 (OT),265,50,103,.485,36,70,.514,14,33,.424,20,25,.800,134,44,101,.436,29,56,.518,15,45,.333,30,37,.811,133
62,ORL,2020-08-13,133,,NOP,W 133-127,240,48,84,.571,33,56,.589,15,28,.536,22,30,.733,133,48,87,.552,38,53,.717,10,34,.294,21,27,.778,127
63,BRK,2020-08-13,133,,POR,L 133-134,240,53,96,.552,39,63,.619,14,33,.424,13,19,.684,133,50,104,.481,37,65,.569,13,39,.333,21,24,.875,134
64,SAC,2020-03-03,133,,WAS,W 133-126,240,50,89,.562,37,60,.617,13,29,.448,20,24,.833,133,41,80,.513,25,42,.595,16,38,.421,28,34,.824,126
65,DEN,2020-03-01,133,,TOR,W 133-118,240,47,83,.566,29,47,.617,18,36,.500,21,30,.700,133,41,89,.461,31,51,.608,10,38,.263,26,29,.897,118
66,MIL,2020-02-28,133,,OKC,W 133-86,240,50,100,.500,29,55,.527,21,45,.467,12,14,.857,133,33,91,.363,27,56,.482,6,35,.171,14,20,.700,86
67,BRK,2020-01-31,133,,CHI,W 133-118,240,50,80,.625,35,49,.714,15,31,.484,18,25,.720,133,42,86,.488,30,52,.577,12,34,.353,22,26,.846,118
68,TOR,2019-12-16,133,,CLE,W 133-113,240,52,89,.584,36,57,.632,16,32,.500,13,17,.765,133,44,90,.489,32,55,.582,12,35,.343,13,17,.765,113
69,PHI,2020-08-03,132,,SAS,W 132-130,240,46,87,.529,32,56,.571,14,31,.452,26,30,.867,132,46,93,.495,34,67,.507,12,26,.462,26,29,.897,130
70,ORL,2020-08-02,132,,SAC,W 132-116,240,43,82,.524,25,44,.568,18,38,.474,28,35,.800,132,45,91,.495,37,63,.587,8,28,.286,18,22,.818,116
71,CLE,2020-03-08,132,,SAS,W 132-129 (OT),265,43,94,.457,30,60,.500,13,34,.382,33,45,.733,132,43,98,.439,33,72,.458,10,26,.385,33,36,.917,129
72,LAC,2020-02-28,132,,DEN,W 132-103,240,48,89,.539,30,50,.600,18,39,.462,18,20,.900,132,41,91,.451,32,66,.485,9,25,.360,12,16,.750,103
73,DET,2019-12-26,132,,WAS,W 132-102,240,46,86,.535,27,38,.711,19,48,.396,21,26,.808,132,38,92,.413,31,68,.456,7,24,.292,19,27,.704,102
74,NOP,2019-12-05,132,,PHO,L 132-139 (OT),265,44,87,.506,27,46,.587,17,41,.415,27,35,.771,132,50,106,.472,36,70,.514,14,36,.389,25,27,.926,139
75,MIL,2019-12-02,132,,NYK,W 132-88,240,48,86,.558,32,51,.627,16,35,.457,20,32,.625,132,28,91,.308,18,52,.346,10,39,.256,22,33,.667,88
76,DET,2019-12-01,132,,SAS,W 132-98,240,52,88,.591,37,57,.649,15,31,.484,13,18,.722,132,36,88,.409,29,62,.468,7,26,.269,19,22,.864,98
77,PHO,2019-11-27,132,,WAS,L 132-140,240,48,93,.516,33,55,.600,15,38,.395,21,24,.875,132,51,89,.573,32,54,.593,19,35,.543,19,20,.950,140
78,HOU,2019-11-18,132,,POR,W 132-108,240,47,100,.470,30,55,.545,17,45,.378,21,26,.808,132,40,96,.417,29,60,.483,11,36,.306,17,23,.739,108
79,TOR,2019-11-18,132,,CHO,W 132-96,240,50,97,.515,30,54,.556,20,43,.465,12,15,.800,132,33,78,.423,18,33,.545,15,45,.333,15,24,.625,96
80,NOP,2019-11-14,132,,LAC,W 132-127,240,47,98,.480,29,64,.453,18,34,.529,20,29,.690,132,46,84,.548,35,60,.583,11,24,.458,24,31,.774,127
81,DAL,2020-08-11,131,,POR,L 131-134,240,42,81,.519,22,37,.595,20,44,.455,27,33,.818,131,46,98,.469,31,60,.517,15,38,.395,27,29,.931,134
82,ATL,2020-03-11,131,,NYK,L 131-136 (OT),265,48,106,.453,34,65,.523,14,41,.341,21,26,.808,131,50,94,.532,39,66,.591,11,28,.393,25,34,.735,136
83,OKC,2020-02-23,131,,SAS,W 131-103,240,50,87,.575,40,65,.615,10,22,.455,21,24,.875,131,38,103,.369,27,65,.415,11,38,.289,16,19,.842,103
84,GSW,2020-01-16,131,,DEN,L 131-134 (OT),265,42,95,.442,22,50,.440,20,45,.444,27,31,.871,131,47,100,.470,30,65,.462,17,35,.486,23,26,.885,134
85,MIL,2020-08-06,130,,MIA,W 130-116,240,41,78,.526,26,41,.634,15,37,.405,33,38,.868,130,35,83,.422,14,37,.378,21,46,.457,25,27,.926,116
86,DAL,2020-02-12,130,,SAC,W 130-111,240,48,85,.565,31,45,.689,17,40,.425,17,21,.810,130,41,99,.414,29,60,.483,12,39,.308,17,22,.773,111
87,TOR,2020-01-28,130,,ATL,W 130-114,240,48,97,.495,35,54,.648,13,43,.302,21,27,.778,130,41,92,.446,29,45,.644,12,47,.255,20,25,.800,114
88,NOP,2020-01-18,130,,LAC,L 130-133,240,46,86,.535,31,45,.689,15,41,.366,23,36,.639,130,46,93,.495,36,62,.581,10,31,.323,31,39,.795,133
89,HOU,2019-12-31,130,,DEN,W 130-104,240,46,87,.529,30,53,.566,16,34,.471,22,31,.710,130,45,97,.464,37,72,.514,8,25,.320,6,9,.667,104
90,DAL,2019-12-07,130,,NOP,W 130-84,240,46,86,.535,33,48,.688,13,38,.342,25,31,.806,130,32,89,.360,29,57,.509,3,32,.094,17,21,.810,84
91,TOR,2019-12-01,130,,UTA,W 130-110,240,47,90,.522,28,54,.519,19,36,.528,17,21,.810,130,38,90,.422,25,55,.455,13,35,.371,21,29,.724,110
92,PHO,2019-10-26,130,,LAC,W 130-122,240,43,86,.500,26,43,.605,17,43,.395,27,34,.794,130,40,87,.460,29,55,.527,11,32,.344,31,39,.795,122
93,TOR,2019-10-22,130,,NOP,W 130-122 (OT),265,42,103,.408,28,63,.444,14,40,.350,32,38,.842,130,43,102,.422,24,57,.421,19,45,.422,17,20,.850,122
94,SAS,2020-07-31,129,,SAC,W 129-120,240,48,90,.533,37,65,.569,11,25,.440,22,27,.815,129,46,95,.484,34,57,.596,12,38,.316,16,20,.800,120
95,ATL,2020-02-29,129,,POR,W 129-117,240,46,84,.548,28,42,.667,18,42,.429,19,22,.864,129,47,94,.500,39,66,.591,8,28,.286,15,21,.714,117
96,UTA,2020-02-28,129,,WAS,W 129-119,240,44,89,.494,25,52,.481,19,37,.514,22,30,.733,129,45,98,.459,31,61,.508,14,37,.378,15,21,.714,119
97,PHI,2020-02-24,129,,ATL,W 129-112,240,45,88,.511,33,58,.569,12,30,.400,27,30,.900,129,40,97,.412,32,59,.542,8,38,.211,24,27,.889,112
98,ATL,2020-02-20,129,,MIA,W 129-124,240,41,85,.482,25,50,.500,16,35,.457,31,35,.886,129,40,98,.408,29,61,.475,11,37,.297,33,38,.868,124
99,SAC,2020-02-20,129,,MEM,W 129-125,240,42,83,.506,23,44,.523,19,39,.487,26,36,.722,129,43,85,.506,31,55,.564,12,30,.400,27,32,.844,125
100,BRK,2020-02-05,129,,GSW,W 129-88,240,51,100,.510,37,66,.561,14,34,.412,13,15,.867,129,35,96,.365,30,57,.526,5,39,.128,13,18,.722,88
101,LAL,2020-02-04,129,,SAS,W 129-102,240,50,85,.588,38,57,.667,12,28,.429,17,25,.680,129,40,91,.440,27,64,.422,13,27,.481,9,15,.600,102
102,MIL,2020-02-02,129,,PHO,W 129-108,240,48,97,.495,33,59,.559,15,38,.395,18,27,.667,129,41,104,.394,35,81,.432,6,23,.261,20,23,.870,108
103,TOR,2020-02-02,129,,CHI,W 129-102,240,47,84,.560,31,50,.620,16,34,.471,19,23,.826,129,35,90,.389,20,42,.476,15,48,.313,17,26,.654,102
104,MIN,2020-01-27,129,,SAC,L 129-133 (OT),265,43,89,.483,20,43,.465,23,46,.500,20,33,.606,129,44,88,.500,26,48,.542,18,40,.450,27,34,.794,133
105,POR,2020-01-20,129,,GSW,W 129-124 (OT),265,44,100,.440,30,56,.536,14,44,.318,27,30,.900,129,48,116,.414,39,80,.488,9,36,.250,19,22,.864,124
106,BOS,2019-12-27,129,,CLE,W 129-117,240,49,95,.516,35,55,.636,14,40,.350,17,19,.895,129,44,85,.518,35,62,.565,9,23,.391,20,29,.690,117
107,MIA,2019-12-20,129,,NYK,W 129-114,240,43,77,.558,25,39,.641,18,38,.474,25,34,.735,129,41,94,.436,31,60,.517,10,34,.294,22,33,.667,114
108,MIN,2019-11-13,129,,SAS,W 129-114,240,45,91,.495,34,57,.596,11,34,.324,28,34,.824,129,44,90,.489,41,73,.562,3,17,.176,23,29,.793,114
109,HOU,2019-11-06,129,,GSW,W 129-112,240,48,97,.495,27,52,.519,21,45,.467,12,19,.632,129,38,96,.396,25,63,.397,13,33,.394,23,28,.821,112
110,MIA,2019-11-03,129,,HOU,W 129-100,240,47,89,.528,29,48,.604,18,41,.439,17,22,.773,129,31,79,.392,17,31,.548,14,48,.292,24,31,.774,100
111,MIL,2019-10-28,129,,CLE,W 129-112,240,48,92,.522,31,54,.574,17,38,.447,16,24,.667,129,45,100,.450,33,61,.541,12,39,.308,10,12,.833,112
112,PHO,2020-08-13,128,,DAL,W 128-102,240,49,89,.551,35,55,.636,14,34,.412,16,21,.762,128,39,89,.438,31,63,.492,8,26,.308,16,19,.842,102
113,PHO,2020-08-10,128,,OKC,W 128-101,240,42,89,.472,25,55,.455,17,34,.500,27,29,.931,128,35,90,.389,22,51,.431,13,39,.333,18,21,.857,101
114,BOS,2020-08-02,128,,POR,W 128-124,240,42,77,.545,24,47,.511,18,30,.600,26,34,.765,128,45,90,.500,26,48,.542,19,42,.452,15,16,.938,124
115,DEN,2020-02-23,128,,MIN,W 128-116,240,53,90,.589,42,60,.700,11,30,.367,11,17,.647,128,40,90,.444,26,50,.520,14,40,.350,22,29,.759,116
116,LAC,2020-02-05,128,,MIA,W 128-111,240,45,89,.506,21,35,.600,24,54,.444,14,19,.737,128,40,93,.430,24,51,.471,16,42,.381,15,21,.714,111
117,DET,2020-02-02,128,,DEN,W 128-123 (OT),265,48,94,.511,34,63,.540,14,31,.452,18,24,.750,128,48,96,.500,38,64,.594,10,32,.313,17,22,.773,123
118,HOU,2020-01-31,128,,DAL,W 128-121,240,45,98,.459,24,53,.453,21,45,.467,17,20,.850,128,43,90,.478,29,54,.537,14,36,.389,21,27,.778,121
119,MIL,2020-01-16,128,,BOS,W 128-123,240,43,87,.494,27,56,.482,16,31,.516,26,37,.703,128,43,98,.439,28,49,.571,15,49,.306,22,27,.815,123
120,LAC,2020-01-14,128,,CLE,W 128-103,240,49,94,.521,34,56,.607,15,38,.395,15,21,.714,128,38,91,.418,24,54,.444,14,37,.378,13,15,.867,103
121,MIL,2020-01-14,128,,NYK,W 128-102,240,45,92,.489,30,56,.536,15,36,.417,23,28,.821,128,36,102,.353,25,65,.385,11,37,.297,19,26,.731,102
122,LAL,2020-01-13,128,,CLE,W 128-99,240,48,88,.545,37,58,.638,11,30,.367,21,28,.750,128,38,85,.447,31,60,.517,7,25,.280,16,24,.667,99
123,UTA,2020-01-08,128,,NYK,W 128-104,240,49,90,.544,33,47,.702,16,43,.372,14,23,.609,128,42,97,.433,33,72,.458,9,25,.360,11,11,1.000,104
124,WAS,2020-01-04,128,,DEN,W 128-114,240,50,91,.549,44,75,.587,6,16,.375,22,27,.815,128,40,87,.460,34,58,.586,6,29,.207,28,34,.824,114
125,SAC,2020-01-02,128,,MEM,W 128-123,240,44,90,.489,30,56,.536,14,34,.412,26,31,.839,128,45,93,.484,32,59,.542,13,34,.382,20,21,.952,123
126,MEM,2019-12-14,128,,WAS,W 128-111,240,48,84,.571,37,57,.649,11,27,.407,21,24,.875,128,36,85,.424,22,47,.468,14,38,.368,25,32,.781,111
127,ORL,2019-12-04,128,,PHO,W 128-114,240,49,85,.576,35,60,.583,14,25,.560,16,20,.800,128,43,88,.489,28,55,.509,15,33,.455,13,20,.650,114
128,UTA,2019-11-23,128,,NOP,W 128-120,240,42,82,.512,27,46,.587,15,36,.417,29,33,.879,128,42,101,.416,25,60,.417,17,41,.415,19,20,.950,120
129,DET,2019-11-22,128,,ATL,W 128-103,240,49,82,.598,32,48,.667,17,34,.500,13,20,.650,128,38,88,.432,28,51,.549,10,37,.270,17,17,1.000,103
130,PHO,2019-11-14,128,,ATL,W 128-112,240,41,85,.482,26,46,.565,15,39,.385,31,38,.816,128,40,91,.440,32,60,.533,8,31,.258,24,30,.800,112
131,POR,2019-11-02,128,,PHI,L 128-129,240,45,78,.577,26,44,.591,19,34,.559,19,25,.760,128,54,107,.505,43,74,.581,11,33,.333,10,12,.833,129
132,IND,2020-08-01,127,,PHI,W 127-121,240,48,95,.505,34,61,.557,14,34,.412,17,23,.739,127,46,93,.495,37,68,.544,9,25,.360,20,25,.800,121
133,PHO,2020-03-06,127,,POR,W 127-117,240,45,91,.495,26,49,.531,19,42,.452,18,19,.947,127,43,87,.494,30,55,.545,13,32,.406,18,24,.750,117
134,DAL,2020-03-04,127,,NOP,W 127-123 (OT),265,44,95,.463,22,45,.489,22,50,.440,17,24,.708,127,50,114,.439,33,68,.485,17,46,.370,6,11,.545,123
135,TOR,2020-02-23,127,,IND,W 127-81,240,47,92,.511,30,48,.625,17,44,.386,16,18,.889,127,31,95,.326,23,62,.371,8,33,.242,11,17,.647,81
136,CLE,2020-02-12,127,,ATL,W 127-105,240,48,94,.511,38,66,.576,10,28,.357,21,25,.840,127,36,84,.429,23,50,.460,13,34,.382,20,25,.800,105
137,DEN,2020-02-10,127,,SAS,W 127-120,240,45,80,.563,27,45,.600,18,35,.514,19,23,.826,127,41,85,.482,25,53,.472,16,32,.500,22,25,.880,120
138,PHO,2020-02-07,127,,HOU,W 127-91,240,43,77,.558,28,46,.609,15,31,.484,26,27,.963,127,29,85,.341,18,37,.486,11,48,.229,22,26,.846,91
139,DEN,2020-02-04,127,,POR,W 127-99,240,46,90,.511,29,56,.518,17,34,.500,18,25,.720,127,36,91,.396,27,60,.450,9,31,.290,18,22,.818,99
140,ATL,2020-01-30,127,,PHI,W 127-117,240,42,87,.483,31,52,.596,11,35,.314,32,37,.865,127,38,82,.463,29,51,.569,9,31,.290,32,45,.711,117
141,SAS,2020-01-29,127,,UTA,W 127-120,240,46,82,.561,38,51,.745,8,31,.258,27,30,.900,127,37,84,.440,23,46,.500,14,38,.368,32,46,.696,120
142,DET,2020-01-22,127,,SAC,W 127-106,240,39,73,.534,27,44,.614,12,29,.414,37,44,.841,127,42,98,.429,32,63,.508,10,35,.286,12,23,.522,106
143,MIL,2020-01-04,127,,SAS,W 127-118,240,43,87,.494,26,42,.619,17,45,.378,24,33,.727,127,38,92,.413,27,60,.450,11,32,.344,31,34,.912,118
144,NOP,2019-12-29,127,,HOU,W 127-112,240,50,102,.490,32,58,.552,18,44,.409,9,13,.692,127,42,81,.519,27,42,.643,15,39,.385,13,20,.650,112
145,MIL,2019-12-11,127,,NOP,W 127-112,240,50,93,.538,31,54,.574,19,39,.487,8,9,.889,127,39,88,.443,23,43,.535,16,45,.356,18,22,.818,112
146,POR,2019-12-04,127,,SAC,W 127-116,240,47,84,.560,31,52,.596,16,32,.500,17,21,.810,127,44,95,.463,33,61,.541,11,34,.324,17,23,.739,116
147,OKC,2019-11-22,127,,LAL,L 127-130,240,49,93,.527,38,62,.613,11,31,.355,18,20,.900,127,45,88,.511,28,57,.491,17,31,.548,23,29,.793,130
148,ATL,2019-11-20,127,,MIL,L 127-135,240,44,96,.458,30,65,.462,14,31,.452,25,31,.806,127,46,87,.529,29,44,.659,17,43,.395,26,34,.765,135
149,OKC,2019-11-15,127,,PHI,W 127-119 (OT),265,41,76,.539,31,52,.596,10,24,.417,35,41,.854,127,45,90,.500,31,58,.534,14,32,.438,15,22,.682,119
150,GSW,2019-11-04,127,,POR,W 127-118,240,42,86,.488,32,60,.533,10,26,.385,33,36,.917,127,47,105,.448,34,65,.523,13,40,.325,11,14,.786,118
151,SAS,2020-08-05,126,,DEN,L 126-132,240,46,93,.495,35,63,.556,11,30,.367,23,27,.852,126,50,91,.549,36,55,.655,14,36,.389,18,21,.857,132
152,LAC,2020-08-01,126,,NOP,W 126-103,240,37,87,.425,12,40,.300,25,47,.532,27,35,.771,126,38,85,.447,29,55,.527,9,30,.300,18,28,.643,103
153,MIA,2020-02-28,126,,DAL,W 126-118,240,41,79,.519,24,44,.545,17,35,.486,27,36,.750,126,40,84,.476,19,34,.559,21,50,.420,17,19,.895,118
154,MIA,2020-02-26,126,,MIN,L 126-129,240,41,78,.526,30,52,.577,11,26,.423,33,43,.767,126,47,91,.516,30,45,.667,17,46,.370,18,25,.720,129
155,CHI,2020-02-23,126,,WAS,W 126-117,240,45,81,.556,27,44,.614,18,37,.486,18,28,.643,126,37,73,.507,25,43,.581,12,30,.400,31,36,.861,117
156,WAS,2020-02-11,126,,CHI,W 126-114,240,48,89,.539,37,57,.649,11,32,.344,19,24,.792,126,44,92,.478,28,53,.528,16,39,.410,10,14,.714,114
157,SAS,2020-01-06,126,,MIL,W 126-104,240,45,88,.511,26,53,.491,19,35,.543,17,19,.895,126,38,95,.400,23,50,.460,15,45,.333,13,14,.929,104
158,NOP,2020-01-06,126,,UTA,L 126-128,240,45,94,.479,33,63,.524,12,31,.387,24,30,.800,126,46,90,.511,30,57,.526,16,33,.485,20,24,.833,128
159,LAC,2020-01-02,126,,DET,W 126-112,240,50,92,.543,39,64,.609,11,28,.393,15,21,.714,126,40,94,.426,33,61,.541,7,33,.212,25,35,.714,112
160,OKC,2019-12-20,126,,PHO,W 126-108,240,49,87,.563,39,63,.619,10,24,.417,18,21,.857,126,38,87,.437,27,55,.491,11,32,.344,21,23,.913,108
161,OKC,2019-12-18,126,,MEM,W 126-122,240,46,84,.548,39,60,.650,7,24,.292,27,34,.794,126,50,99,.505,40,73,.548,10,26,.385,12,15,.800,122
162,UTA,2019-12-07,126,,MEM,W 126-112,240,45,80,.563,26,46,.565,19,34,.559,17,18,.944,126,43,81,.531,33,46,.717,10,35,.286,16,25,.640,112
163,TOR,2019-11-27,126,,NYK,W 126-98,240,46,94,.489,25,53,.472,21,41,.512,13,17,.765,126,33,88,.375,21,47,.447,12,41,.293,20,24,.833,98
164,IND,2019-11-25,126,,MEM,W 126-114,240,51,94,.543,33,61,.541,18,33,.545,6,10,.600,126,46,96,.479,33,67,.493,13,29,.448,9,13,.692,114
165,MIL,2019-10-26,126,,MIA,L 126-131 (OT),265,41,94,.436,24,40,.600,17,54,.315,27,35,.771,126,46,101,.455,30,57,.526,16,44,.364,23,36,.639,131
166,HOU,2019-10-26,126,,NOP,W 126-123,240,43,94,.457,30,49,.612,13,45,.289,27,30,.900,126,46,100,.460,28,50,.560,18,50,.360,13,16,.813,123
167,BRK,2019-10-23,126,,MIN,L 126-127 (OT),265,48,101,.475,33,67,.493,15,34,.441,15,26,.577,126,46,108,.426,33,65,.508,13,43,.302,22,28,.786,127
168,CHO,2019-10-23,126,,CHI,W 126-125,240,45,88,.511,22,44,.500,23,44,.523,13,16,.813,126,49,105,.467,40,75,.533,9,30,.300,18,22,.818,125
169,POR,2020-03-04,125,,WAS,W 125-104,240,42,81,.519,29,50,.580,13,31,.419,28,32,.875,125,40,103,.388,29,68,.426,11,35,.314,13,21,.619,104
170,NYK,2020-03-02,125,,HOU,W 125-123,240,47,97,.485,35,67,.522,12,30,.400,19,30,.633,125,39,94,.415,19,38,.500,20,56,.357,25,27,.926,123
171,NYK,2020-02-29,125,,CHI,W 125-115,240,47,85,.553,39,65,.600,8,20,.400,23,33,.697,125,41,89,.461,24,54,.444,17,35,.486,16,23,.696,115
172,CLE,2020-02-24,125,,MIA,W 125-119 (OT),265,43,97,.443,29,60,.483,14,37,.378,25,34,.735,125,44,96,.458,28,54,.519,16,42,.381,15,20,.750,119
173,LAL,2020-02-10,125,,PHO,W 125-100,240,47,91,.516,33,54,.611,14,37,.378,17,25,.680,125,32,76,.421,21,45,.467,11,31,.355,25,31,.806,100
174,POR,2020-02-06,125,,SAS,W 125-117,240,49,92,.533,31,55,.564,18,37,.486,9,12,.750,125,41,92,.446,31,64,.484,10,28,.357,25,28,.893,117
175,HOU,2020-02-04,125,,CHO,W 125-110,240,43,97,.443,23,37,.622,20,60,.333,19,23,.826,125,39,83,.470,26,50,.520,13,33,.394,19,24,.792,110
176,POR,2020-01-29,125,,HOU,W 125-112,240,46,89,.517,33,53,.623,13,36,.361,20,27,.741,125,40,94,.426,23,47,.489,17,47,.362,15,18,.833,112
177,BRK,2020-01-29,125,,DET,W 125-115,240,43,85,.506,28,46,.609,15,39,.385,24,30,.800,125,42,83,.506,32,57,.561,10,26,.385,21,28,.750,115
178,POR,2020-01-23,125,,DAL,L 125-133,240,46,91,.505,25,52,.481,21,39,.538,12,15,.800,125,48,93,.516,26,46,.565,22,47,.468,15,24,.625,133
179,PHI,2019-12-21,125,,WAS,W 125-108,240,49,94,.521,35,61,.574,14,33,.424,13,21,.619,125,36,88,.409,29,57,.509,7,31,.226,29,34,.853,108
180,PHO,2019-12-21,125,,HOU,L 125-139,240,47,91,.516,39,63,.619,8,28,.286,23,30,.767,125,51,87,.586,32,46,.696,19,41,.463,18,23,.783,139
181,MIL,2019-12-14,125,,CLE,W 125-108,240,46,85,.541,32,48,.667,14,37,.378,19,26,.731,125,41,90,.456,26,55,.473,15,35,.429,11,15,.733,108
182,PHO,2019-12-09,125,,MIN,W 125-109,240,47,95,.495,31,55,.564,16,40,.400,15,19,.789,125,40,85,.471,34,63,.540,6,22,.273,23,29,.793,109
183,LAL,2019-11-29,125,,WAS,W 125-103,240,45,87,.517,31,55,.564,14,32,.438,21,28,.750,125,38,96,.396,28,59,.475,10,37,.270,17,19,.895,103
184,WAS,2019-11-22,125,,CHO,W 125-118,240,48,91,.527,34,57,.596,14,34,.412,15,20,.750,125,48,93,.516,34,59,.576,14,34,.412,8,8,1.000,118
185,ORL,2019-11-17,125,,WAS,W 125-121,240,43,87,.494,28,49,.571,15,38,.395,24,26,.923,125,46,97,.474,27,56,.482,19,41,.463,10,12,.833,121
186,MIN,2019-11-08,125,,GSW,W 125-119 (OT),265,48,111,.432,39,75,.520,9,36,.250,20,29,.690,125,43,103,.417,33,68,.485,10,35,.286,23,24,.958,119
187,TOR,2019-10-30,125,,DET,W 125-113,240,51,86,.593,38,59,.644,13,27,.481,10,12,.833,125,41,88,.466,27,58,.466,14,30,.467,17,23,.739,113
188,LAL,2020-08-10,124,,DEN,W 124-121,240,44,81,.543,30,52,.577,14,29,.483,22,32,.688,124,45,77,.584,32,54,.593,13,23,.565,18,23,.783,121
189,POR,2020-08-09,124,,PHI,W 124-121,240,43,91,.473,32,56,.571,11,35,.314,27,29,.931,124,47,97,.485,33,67,.493,14,30,.467,13,17,.765,121
190,UTA,2020-08-05,124,,MEM,W 124-115,240,38,84,.452,20,39,.513,18,45,.400,30,33,.909,124,43,91,.473,32,62,.516,11,29,.379,18,25,.720,115
191,PHI,2020-03-11,124,,DET,W 124-106,240,42,83,.506,28,50,.560,14,33,.424,26,32,.813,124,39,84,.464,28,49,.571,11,35,.314,17,25,.680,106
192,LAC,2020-02-24,124,,MEM,W 124-97,240,47,94,.500,31,57,.544,16,37,.432,14,17,.824,124,37,89,.416,30,62,.484,7,27,.259,16,22,.727,97
193,MIA,2020-02-22,124,,CLE,W 124-105,240,45,79,.570,26,39,.667,19,40,.475,15,20,.750,124,38,79,.481,25,43,.581,13,36,.361,16,22,.727,105
194,POR,2020-02-01,124,,UTA,W 124-107,240,47,92,.511,32,63,.508,15,29,.517,15,18,.833,124,40,94,.426,22,53,.415,18,41,.439,9,9,1.000,107
195,MIN,2020-01-24,124,,HOU,L 124-131,240,48,98,.490,37,66,.561,11,32,.344,17,20,.850,124,47,91,.516,36,59,.610,11,32,.344,26,31,.839,131
196,NYK,2020-01-12,124,,MIA,W 124-121,240,46,90,.511,37,59,.627,9,31,.290,23,28,.821,124,42,78,.538,28,43,.651,14,35,.400,23,28,.821,121
197,MIA,2019-11-20,124,,CLE,W 124-100,240,41,78,.526,22,41,.537,19,37,.514,23,31,.742,124,37,87,.425,25,49,.510,12,38,.316,14,16,.875,100
198,MIL,2019-11-14,124,,CHI,W 124-115,240,42,88,.477,36,55,.655,6,33,.182,34,47,.723,124,38,93,.409,20,50,.400,18,43,.419,21,25,.840,115
199,POR,2019-11-10,124,,ATL,W 124-113 (OT),265,45,104,.433,33,68,.485,12,36,.333,22,28,.786,124,42,104,.404,31,63,.492,11,41,.268,18,25,.720,113
200,LAC,2019-11-06,124,,MIL,L 124-129,240,41,98,.418,28,67,.418,13,31,.419,29,36,.806,124,42,98,.429,24,49,.490,18,49,.367,27,34,.794,129
201,TOR,2019-11-06,124,,SAC,W 124-120,240,43,78,.551,29,49,.592,14,29,.483,24,29,.828,124,42,95,.442,22,51,.431,20,44,.455,16,21,.762,120
202,SAS,2019-10-26,124,,WAS,W 124-122,240,50,108,.463,40,80,.500,10,28,.357,14,17,.824,124,47,95,.495,31,61,.508,16,34,.471,12,17,.706,122
203,PHO,2019-10-23,124,,SAC,W 124-95,240,49,98,.500,38,65,.585,11,33,.333,15,18,.833,124,34,87,.391,24,58,.414,10,29,.345,17,26,.654,95
204,SAS,2020-08-11,123,,HOU,W 123-105,240,46,93,.495,33,61,.541,13,32,.406,18,20,.900,123,36,89,.404,22,41,.537,14,48,.292,19,21,.905,105
205,HOU,2020-02-24,123,,NYK,W 123-112,240,43,86,.500,27,38,.711,16,48,.333,21,31,.677,123,40,91,.440,29,62,.468,11,29,.379,21,30,.700,112
206,MIL,2020-02-10,123,,SAC,W 123-111,240,43,96,.448,25,54,.463,18,42,.429,19,23,.826,123,42,101,.416,28,58,.483,14,43,.326,13,18,.722,111
207,DAL,2020-02-01,123,,ATL,W 123-100,240,44,94,.468,24,55,.436,20,39,.513,15,16,.938,123,37,91,.407,27,58,.466,10,33,.303,16,21,.762,100
208,NOP,2020-01-26,123,,BOS,W 123-108,240,44,92,.478,28,56,.500,16,36,.444,19,29,.655,123,41,89,.461,33,56,.589,8,33,.242,18,22,.818,108
209,UTA,2020-01-18,123,,SAC,W 123-101,240,43,85,.506,29,43,.674,14,42,.333,23,24,.958,123,42,86,.488,32,60,.533,10,26,.385,7,12,.583,101
210,SAC,2020-01-15,123,,DAL,L 123-127,240,50,96,.521,38,63,.603,12,33,.364,11,20,.550,123,47,92,.511,34,52,.654,13,40,.325,20,24,.833,127
211,ATL,2020-01-14,123,,PHO,W 123-110,240,46,93,.495,32,62,.516,14,31,.452,17,20,.850,123,40,87,.460,36,67,.537,4,20,.200,26,32,.813,110
212,NOP,2020-01-08,123,,CHI,W 123-108,240,41,87,.471,26,43,.605,15,44,.341,26,32,.813,123,41,92,.446,27,57,.474,14,35,.400,12,21,.571,108
213,ORL,2020-01-08,123,,WAS,W 123-89,240,43,87,.494,33,60,.550,10,27,.370,27,34,.794,123,36,84,.429,30,61,.492,6,23,.261,11,19,.579,89
214,LAL,2020-01-03,123,,NOP,W 123-113,240,43,86,.500,29,57,.509,14,29,.483,23,28,.821,123,48,102,.471,37,65,.569,11,37,.297,6,7,.857,113
215,DAL,2020-01-02,123,,BRK,W 123-111,240,45,89,.506,27,51,.529,18,38,.474,15,17,.882,123,42,91,.462,30,54,.556,12,37,.324,15,17,.882,111
216,WAS,2019-12-30,123,,MIA,W 123-105,240,43,84,.512,26,47,.553,17,37,.459,20,30,.667,123,33,73,.452,23,45,.511,10,28,.357,29,39,.744,105
217,HOU,2019-11-24,123,,DAL,L 123-137,240,45,98,.459,35,54,.648,10,44,.227,23,31,.742,123,49,102,.480,32,58,.552,17,44,.386,22,28,.786,137
218,NYK,2019-11-18,123,,CLE,W 123-105,240,44,98,.449,36,75,.480,8,23,.348,27,35,.771,123,36,76,.474,19,40,.475,17,36,.472,16,30,.533,105
219,BRK,2019-11-01,123,,HOU,W 123-116,240,42,85,.494,23,53,.434,19,32,.594,20,28,.714,123,41,99,.414,29,51,.569,12,48,.250,22,27,.815,116
220,NOP,2019-10-28,123,,GSW,L 123-134,240,48,103,.466,33,56,.589,15,47,.319,12,22,.545,123,51,104,.490,37,69,.536,14,35,.400,18,24,.750,134
221,LAL,2020-08-13,122,,SAC,L 122-136,240,48,98,.490,33,63,.524,15,35,.429,11,15,.733,122,54,95,.568,33,48,.688,21,47,.447,7,12,.583,136
222,BOS,2020-08-09,122,,ORL,W 122-119 (OT),265,45,102,.441,33,62,.532,12,40,.300,20,24,.833,122,41,102,.402,26,55,.473,15,47,.319,22,26,.846,119
223,WAS,2020-03-10,122,,NYK,W 122-115,240,35,74,.473,21,39,.538,14,35,.400,38,45,.844,122,42,81,.519,34,60,.567,8,21,.381,23,31,.742,115
224,CHI,2020-02-25,122,,OKC,L 122-124,240,52,97,.536,40,66,.606,12,31,.387,6,9,.667,122,42,76,.553,28,46,.609,14,30,.467,26,35,.743,124
225,SAC,2020-02-08,122,,SAS,W 122-102,240,45,86,.523,26,51,.510,19,35,.543,13,20,.650,122,41,81,.506,34,57,.596,7,24,.292,13,18,.722,102
226,LAC,2020-01-16,122,,ORL,W 122-95,240,47,95,.495,33,63,.524,14,32,.438,14,20,.700,122,36,92,.391,22,50,.440,14,42,.333,9,16,.563,95
227,MEM,2020-01-12,122,,GSW,W 122-102,240,45,100,.450,34,65,.523,11,35,.314,21,25,.840,122,35,92,.380,18,58,.310,17,34,.500,15,21,.714,102
228,MIA,2020-01-05,122,,POR,W 122-111,240,47,90,.522,29,46,.630,18,44,.409,10,16,.625,122,40,87,.460,27,50,.540,13,37,.351,18,20,.900,111
229,MIN,2019-12-30,122,,BRK,W 122-115 (OT),265,42,104,.404,25,60,.417,17,44,.386,21,29,.724,122,40,99,.404,25,58,.431,15,41,.366,20,27,.741,115
230,BRK,2019-12-21,122,,ATL,W 122-112,240,46,100,.460,35,70,.500,11,30,.367,19,28,.679,122,39,105,.371,28,57,.491,11,48,.229,23,27,.852,112
231,TOR,2019-12-20,122,,WAS,W 122-118,240,38,78,.487,26,48,.542,12,30,.400,34,44,.773,122,40,87,.460,26,48,.542,14,39,.359,24,32,.750,118
232,POR,2019-12-18,122,,GSW,W 122-112,240,44,97,.454,35,66,.530,9,31,.290,25,28,.893,122,41,103,.398,25,65,.385,16,38,.421,14,23,.609,112
233,GSW,2019-12-11,122,,NYK,L 122-124 (OT),265,45,104,.433,35,67,.522,10,37,.270,22,30,.733,122,43,90,.478,31,61,.508,12,29,.414,26,34,.765,124
234,IND,2019-12-11,122,,BOS,W 122-117,240,41,85,.482,31,60,.517,10,25,.400,30,36,.833,122,43,87,.494,29,51,.569,14,36,.389,17,22,.773,117
235,MIA,2019-11-29,122,,GSW,W 122-105,240,44,82,.537,31,57,.544,13,25,.520,21,28,.750,122,30,77,.390,20,49,.408,10,28,.357,35,40,.875,105
236,MIL,2019-11-25,122,,UTA,W 122-118,240,43,97,.443,30,56,.536,13,41,.317,23,29,.793,122,43,85,.506,22,40,.550,21,45,.467,11,12,.917,118
237,LAC,2019-11-22,122,,HOU,W 122-119,240,45,87,.517,32,54,.593,13,33,.394,19,24,.792,122,39,84,.464,24,41,.585,15,43,.349,26,38,.684,119
238,LAL,2019-11-17,122,,ATL,W 122-101,240,47,89,.528,32,54,.593,15,35,.429,13,16,.813,122,37,86,.430,29,58,.500,8,28,.286,19,25,.760,101
239,MEM,2019-11-09,122,,DAL,L 122-138,240,50,95,.526,38,59,.644,12,36,.333,10,14,.714,122,52,97,.536,34,55,.618,18,42,.429,16,20,.800,138
240,DET,2019-11-06,122,,NYK,W 122-102,240,44,79,.557,29,49,.592,15,30,.500,19,24,.792,122,39,80,.488,28,55,.509,11,25,.440,13,21,.619,102
241,CHO,2019-11-05,122,,IND,W 122-120 (OT),265,42,88,.477,32,57,.561,10,31,.323,28,42,.667,122,51,94,.543,39,64,.609,12,30,.400,6,7,.857,120
242,NOP,2019-10-31,122,,DEN,W 122-107,240,41,77,.532,26,44,.591,15,33,.455,25,32,.781,122,43,89,.483,36,63,.571,7,26,.269,14,16,.875,107
243,GSW,2019-10-24,122,,LAC,L 122-141,240,39,99,.394,24,57,.421,15,42,.357,29,30,.967,122,50,80,.625,32,48,.667,18,32,.563,23,30,.767,141
244,PHI,2020-08-12,121,,TOR,L 121-125,240,39,84,.464,22,44,.500,17,40,.425,26,33,.788,121,40,90,.444,22,47,.468,18,43,.419,27,40,.675,125
245,OKC,2020-08-09,121,,WAS,W 121-103,240,43,84,.512,25,45,.556,18,39,.462,17,22,.773,121,38,92,.413,29,56,.518,9,36,.250,18,22,.818,103
246,MEM,2020-08-07,121,,OKC,W 121-92,240,46,83,.554,35,52,.673,11,31,.355,18,20,.900,121,34,97,.351,21,54,.389,13,43,.302,11,15,.733,92
247,POR,2020-03-10,121,,PHO,W 121-105,240,45,89,.506,28,54,.519,17,35,.486,14,17,.824,121,35,87,.402,24,55,.436,11,32,.344,24,25,.960,105
248,DAL,2020-03-06,121,,MEM,W 121-96,240,45,95,.474,27,48,.563,18,47,.383,13,17,.765,121,39,84,.464,30,54,.556,9,30,.300,9,13,.692,96
249,WAS,2020-01-30,121,,CHO,W 121-107,240,41,86,.477,27,49,.551,14,37,.378,25,27,.926,121,43,99,.434,34,69,.493,9,30,.300,12,19,.632,107
250,HOU,2020-01-22,121,,DEN,W 121-105,240,42,89,.472,29,60,.483,13,29,.448,24,28,.857,121,42,92,.457,32,64,.500,10,28,.357,11,15,.733,105
251,OKC,2020-01-15,121,,TOR,L 121-130,240,43,85,.506,27,43,.628,16,42,.381,19,20,.950,121,52,85,.612,37,58,.638,15,27,.556,11,15,.733,130
252,MEM,2020-01-14,121,,HOU,W 121-110,240,46,91,.505,33,54,.611,13,37,.351,16,19,.842,121,37,86,.430,23,41,.561,14,45,.311,22,24,.917,110
253,GSW,2019-12-28,121,,DAL,L 121-141,240,45,93,.484,27,54,.500,18,39,.462,13,17,.765,121,48,92,.522,24,41,.585,24,51,.471,21,21,1.000,141
254,UTA,2019-12-26,121,,POR,W 121-115,240,46,81,.568,32,45,.711,14,36,.389,15,22,.682,121,43,89,.483,28,55,.509,15,34,.441,14,19,.737,115
255,PHI,2019-12-25,121,,MIL,W 121-109,240,44,101,.436,23,57,.404,21,44,.477,12,15,.800,121,45,95,.474,32,62,.516,13,33,.394,6,8,.750,109
256,CLE,2019-12-23,121,,ATL,W 121-118,240,50,96,.521,39,67,.582,11,29,.379,10,12,.833,121,45,95,.474,30,53,.566,15,42,.357,13,17,.765,118
257,DAL,2019-12-04,121,,MIN,W 121-114,240,46,92,.500,35,55,.636,11,37,.297,18,23,.783,121,37,89,.416,20,51,.392,17,38,.447,23,26,.885,114
258,BOS,2019-11-27,121,,BRK,W 121-110,240,43,97,.443,30,63,.476,13,34,.382,22,24,.917,121,40,90,.444,19,34,.559,21,56,.375,9,19,.474,110
259,IND,2019-11-27,121,,UTA,W 121-102,240,50,96,.521,42,74,.568,8,22,.364,13,16,.813,121,36,83,.434,26,51,.510,10,32,.313,20,25,.800,102
260,PHO,2019-11-21,121,,NOP,L 121-124,240,40,86,.465,27,55,.491,13,31,.419,28,32,.875,121,47,88,.534,31,53,.585,16,35,.457,14,22,.636,124
261,DEN,2019-11-12,121,,ATL,L 121-125,240,46,104,.442,35,63,.556,11,41,.268,18,22,.818,121,44,83,.530,29,49,.592,15,34,.441,22,34,.647,125
262,SAS,2019-11-07,121,,OKC,W 121-112,240,51,94,.543,42,74,.568,9,20,.450,10,11,.909,121,42,80,.525,32,59,.542,10,21,.476,18,24,.750,112
263,IND,2019-11-06,121,,WAS,W 121-106,240,44,94,.468,32,64,.500,12,30,.400,21,26,.808,121,37,95,.389,24,55,.436,13,40,.325,19,19,1.000,106
264,LAC,2020-08-09,120,,BRK,L 120-129,240,45,93,.484,32,57,.561,13,36,.361,17,20,.850,120,47,85,.553,27,42,.643,20,43,.465,15,19,.789,129
265,IND,2020-08-04,120,,ORL,W 120-109,240,46,84,.548,33,51,.647,13,33,.394,15,19,.789,120,39,82,.476,27,48,.563,12,34,.353,19,23,.826,109
266,HOU,2020-08-02,120,,MIL,W 120-116,240,36,91,.396,15,30,.500,21,61,.344,27,31,.871,120,45,92,.489,36,57,.632,9,35,.257,17,23,.739,116
267,BOS,2020-03-03,120,,BRK,L 120-129 (OT),265,44,103,.427,29,54,.537,15,49,.306,17,23,.739,120,43,100,.430,29,51,.569,14,49,.286,29,38,.763,129
268,LAL,2020-03-03,120,,PHI,W 120-107,240,46,86,.535,33,53,.623,13,33,.394,15,18,.833,120,38,85,.447,22,45,.489,16,40,.400,15,20,.750,107
269,ATL,2020-02-26,120,,ORL,L 120-130,240,42,94,.447,29,58,.500,13,36,.361,23,25,.920,120,49,100,.490,35,68,.515,14,32,.438,18,25,.720,130
270,GSW,2020-02-08,120,,LAL,L 120-125,240,46,89,.517,33,57,.579,13,32,.406,15,23,.652,120,43,82,.524,29,53,.547,14,29,.483,25,34,.735,125
271,MIN,2020-02-05,120,,ATL,L 120-127,240,45,91,.495,36,56,.643,9,35,.257,21,28,.750,120,43,82,.524,30,50,.600,13,32,.406,28,30,.933,127
272,SAS,2020-01-17,120,,ATL,L 120-121,240,45,98,.459,37,69,.536,8,29,.276,22,23,.957,120,41,82,.500,22,42,.524,19,40,.475,20,27,.741,121
273,DAL,2020-01-17,120,,POR,W 120-112,240,39,89,.438,19,42,.452,20,47,.426,22,28,.786,120,44,85,.518,35,55,.636,9,30,.300,15,22,.682,112
274,PHI,2020-01-06,120,,OKC,W 120-113,240,46,90,.511,33,64,.516,13,26,.500,15,18,.833,120,40,89,.449,28,60,.467,12,29,.414,21,31,.677,113
275,DAL,2020-01-04,120,,CHO,L 120-123 (OT),265,47,100,.470,32,50,.640,15,50,.300,11,13,.846,120,42,85,.494,31,60,.517,11,25,.440,28,31,.903,123
276,PHO,2020-01-03,120,,NYK,W 120-112,240,42,90,.467,32,62,.516,10,28,.357,26,33,.788,120,41,92,.446,31,55,.564,10,37,.270,20,30,.667,112
277,DEN,2019-12-29,120,,SAC,W 120-115,240,42,81,.519,34,52,.654,8,29,.276,28,31,.903,120,45,85,.529,32,51,.627,13,34,.382,12,17,.706,115
278,POR,2019-12-28,120,,LAL,L 120-128,240,41,86,.477,26,51,.510,15,35,.429,23,27,.852,120,47,91,.516,36,59,.610,11,32,.344,23,28,.821,128
279,NOP,2019-12-28,120,,IND,W 120-98,240,43,93,.462,25,51,.490,18,42,.429,16,20,.800,120,33,85,.388,27,57,.474,6,28,.214,26,29,.897,98
280,IND,2019-12-23,120,,TOR,W 120-115 (OT),265,45,95,.474,27,53,.509,18,42,.429,12,20,.600,120,43,94,.457,32,54,.593,11,40,.275,18,24,.750,115
281,LAC,2019-12-17,120,,PHO,W 120-99,240,45,89,.506,31,57,.544,14,32,.438,16,22,.727,120,41,102,.402,31,67,.463,10,35,.286,7,10,.700,99
282,WAS,2019-12-03,120,,ORL,L 120-127,240,45,89,.506,33,54,.611,12,35,.343,18,23,.783,120,46,90,.511,31,59,.525,15,31,.484,20,27,.741,127
283,SAC,2019-11-19,120,,PHO,W 120-116,240,42,79,.532,29,48,.604,13,31,.419,23,25,.920,120,38,89,.427,26,53,.491,12,36,.333,28,34,.824,116
284,LAL,2019-11-13,120,,GSW,W 120-94,240,48,89,.539,39,69,.565,9,20,.450,15,18,.833,120,36,89,.404,27,54,.500,9,35,.257,13,17,.765,94
285,CHI,2019-11-12,120,,NYK,W 120-102,240,41,81,.506,27,48,.563,14,33,.424,24,31,.774,120,36,88,.409,26,56,.464,10,32,.313,20,31,.645,102
286,LAL,2019-10-29,120,,MEM,W 120-91,240,40,86,.465,33,60,.550,7,26,.269,33,39,.846,120,31,95,.326,24,61,.393,7,34,.206,22,23,.957,91
287,OKC,2019-10-27,120,,GSW,W 120-92,240,44,78,.564,29,46,.630,15,32,.469,17,22,.773,120,30,92,.326,25,59,.424,5,33,.152,27,31,.871,92
288,LAL,2019-10-27,120,,CHO,W 120-101,240,49,93,.527,38,62,.613,11,31,.355,11,14,.786,120,35,91,.385,25,56,.446,10,35,.286,21,23,.913,101
289,MIA,2019-10-23,120,,MEM,W 120-101,240,40,85,.471,33,67,.493,7,18,.389,33,39,.846,120,38,89,.427,33,57,.579,5,32,.156,20,30,.667,101
290,SAS,2019-10-23,120,,NYK,W 120-111,240,42,83,.506,35,62,.565,7,21,.333,29,36,.806,120,44,94,.468,34,64,.531,10,30,.333,13,18,.722,111
291,MEM,2020-08-13,119,,MIL,W 119-106,240,45,90,.500,32,57,.561,13,33,.394,16,23,.696,119,39,98,.398,26,57,.456,13,41,.317,15,23,.652,106
292,SAS,2020-08-07,119,,UTA,W 119-111,240,45,89,.506,36,67,.537,9,22,.409,20,26,.769,119,38,91,.418,22,54,.407,16,37,.432,19,24,.792,111
293,BRK,2020-08-07,119,,SAC,W 119-106,240,42,86,.488,25,46,.543,17,40,.425,18,28,.643,119,38,89,.427,26,49,.531,12,40,.300,18,24,.750,106
294,MIL,2020-07-31,119,,BOS,W 119-112,240,39,84,.464,26,43,.605,13,41,.317,28,34,.824,119,37,91,.407,26,54,.481,11,37,.297,27,34,.794,112
295,SAS,2020-03-10,119,,DAL,W 119-109,240,46,89,.517,31,57,.544,15,32,.469,12,15,.800,119,42,92,.457,25,48,.521,17,44,.386,8,11,.727,109
296,MIL,2020-03-04,119,,IND,W 119-100,240,43,94,.457,30,48,.625,13,46,.283,20,22,.909,119,42,97,.433,35,70,.500,7,27,.259,9,11,.818,100
297,IND,2020-02-25,119,,CHO,W 119-80,240,49,86,.570,39,63,.619,10,23,.435,11,13,.846,119,31,93,.333,21,60,.350,10,33,.303,8,18,.444,80
298,MIL,2020-02-22,119,,PHI,W 119-98,240,48,91,.527,34,50,.680,14,41,.341,9,13,.692,119,35,99,.354,22,61,.361,13,38,.342,15,18,.833,98
299,DAL,2020-02-10,119,,UTA,L 119-123,240,39,83,.470,24,40,.600,15,43,.349,26,31,.839,119,46,78,.590,31,43,.721,15,35,.429,16,21,.762,123
300,TOR,2020-02-08,119,,BRK,W 119-118,240,45,95,.474,31,60,.517,14,35,.400,15,21,.714,119,41,92,.446,25,48,.521,16,44,.364,20,24,.833,118
301,WAS,2020-02-07,119,,DAL,W 119-118,240,45,90,.500,26,52,.500,19,38,.500,10,13,.769,119,42,91,.462,26,51,.510,16,40,.400,18,21,.857,118
302,PHI,2020-02-07,119,,MEM,W 119-107,240,48,90,.533,34,65,.523,14,25,.560,9,15,.600,119,38,93,.409,33,72,.458,5,21,.238,26,31,.839,107
303,CHI,2020-02-06,119,,NOP,L 119-125,240,46,93,.495,33,64,.516,13,29,.448,14,23,.609,119,49,87,.563,33,49,.673,16,38,.421,11,19,.579,125
304,TOR,2020-02-05,119,,IND,W 119-118,240,43,86,.500,31,54,.574,12,32,.375,21,24,.875,119,43,82,.524,24,43,.558,19,39,.487,13,16,.813,118
305,BRK,2020-02-03,119,,PHO,W 119-97,240,43,89,.483,28,55,.509,15,34,.441,18,21,.857,119,39,90,.433,33,73,.452,6,17,.353,13,18,.722,97
306,LAL,2020-01-31,119,,POR,L 119-127,240,45,96,.469,34,64,.531,11,32,.344,18,28,.643,119,49,97,.505,36,61,.590,13,36,.361,16,21,.762,127
307,BOS,2020-01-30,119,,GSW,W 119-104,240,42,88,.477,27,53,.509,15,35,.429,20,22,.909,119,33,77,.429,21,38,.553,12,39,.308,26,30,.867,104
308,BOS,2020-01-22,119,,MEM,W 119-95,240,45,89,.506,31,57,.544,14,32,.438,15,20,.750,119,36,85,.424,25,53,.472,11,32,.344,12,15,.800,95
309,BOS,2020-01-18,119,,PHO,L 119-123,240,42,96,.438,27,54,.500,15,42,.357,20,22,.909,119,42,89,.472,29,58,.500,13,31,.419,26,30,.867,123
310,OKC,2020-01-18,119,,POR,W 119-106,240,43,83,.518,36,61,.590,7,22,.318,26,36,.722,119,39,91,.429,27,59,.458,12,32,.375,16,21,.762,106
311,MEM,2020-01-07,119,,MIN,W 119-112,240,46,89,.517,38,61,.623,8,28,.286,19,21,.905,119,40,90,.444,25,43,.581,15,47,.319,17,21,.810,112
312,DEN,2019-12-28,119,,MEM,W 119-110,240,45,93,.484,36,64,.563,9,29,.310,20,27,.741,119,41,84,.488,32,54,.593,9,30,.300,19,25,.760,110
313,BOS,2019-12-22,119,,CHO,W 119-93,240,46,88,.523,32,56,.571,14,32,.438,13,16,.813,119,33,82,.402,23,48,.479,10,34,.294,17,23,.739,93
314,MEM,2019-12-21,119,,SAC,W 119-115,240,40,83,.482,25,48,.521,15,35,.429,24,29,.828,119,43,100,.430,32,64,.500,11,36,.306,18,24,.750,115
315,IND,2019-12-20,119,,SAC,W 119-105,240,45,86,.523,31,55,.564,14,31,.452,15,18,.833,119,41,91,.451,31,59,.525,10,32,.313,13,15,.867,105
316,DET,2019-12-16,119,,WAS,L 119-133,240,41,86,.477,28,47,.596,13,39,.333,24,34,.706,119,49,88,.557,31,54,.574,18,34,.529,17,21,.810,133
317,NOP,2019-12-15,119,,ORL,L 119-130,240,47,88,.534,28,45,.622,19,43,.442,6,12,.500,119,46,89,.517,29,55,.527,17,34,.500,21,26,.808,130
318,PHO,2019-12-14,119,,SAS,L 119-121 (OT),265,45,103,.437,35,63,.556,10,40,.250,19,26,.731,119,44,106,.415,36,76,.474,8,30,.267,25,34,.735,121
319,WAS,2019-12-08,119,,LAC,L 119-135,240,40,88,.455,26,55,.473,14,33,.424,25,30,.833,119,50,96,.521,35,56,.625,15,40,.375,20,27,.741,135
320,MIL,2019-12-06,119,,LAC,W 119-91,240,44,94,.468,30,58,.517,14,36,.389,17,21,.810,119,33,94,.351,25,62,.403,8,32,.250,17,19,.895,91
321,WAS,2019-12-05,119,,PHI,W 119-113,240,41,90,.456,30,63,.476,11,27,.407,26,32,.813,119,41,77,.532,28,49,.571,13,28,.464,18,24,.750,113
322,PHI,2019-11-30,119,,IND,W 119-116,240,38,77,.494,27,54,.500,11,23,.478,32,36,.889,119,42,76,.553,31,54,.574,11,22,.500,21,25,.840,116
323,MEM,2019-11-27,119,,LAC,L 119-121,240,43,92,.467,32,64,.500,11,28,.393,22,26,.846,119,44,95,.463,30,54,.556,14,41,.341,19,25,.760,121
324,UTA,2019-11-12,119,,BRK,W 119-114,240,43,92,.467,37,66,.561,6,26,.231,27,35,.771,119,41,90,.456,30,53,.566,11,37,.297,21,25,.840,114
325,OKC,2019-11-10,119,,MIL,L 119-121,240,45,91,.495,28,49,.571,17,42,.405,12,17,.706,119,47,83,.566,36,55,.655,11,28,.393,16,18,.889,121
326,DAL,2019-10-27,119,,POR,L 119-121,240,37,94,.394,24,44,.545,13,50,.260,32,41,.780,119,45,87,.517,36,65,.554,9,22,.409,22,26,.846,121
327,UTA,2020-08-13,118,,SAS,W 118-112,240,47,101,.465,32,55,.582,15,46,.326,9,10,.900,118,39,79,.494,29,59,.492,10,20,.500,24,36,.667,112
328,NOP,2020-08-07,118,,WAS,W 118-107,240,42,88,.477,30,53,.566,12,35,.343,22,26,.846,118,38,90,.422,28,63,.444,10,27,.370,21,23,.913,107
329,BRK,2020-08-02,118,,WAS,W 118-110,240,38,90,.422,27,57,.474,11,33,.333,31,37,.838,118,40,88,.455,31,57,.544,9,31,.290,21,27,.778,110
330,BRK,2020-07-31,118,,ORL,L 118-128,240,44,91,.484,31,49,.633,13,42,.310,17,23,.739,118,46,87,.529,35,56,.625,11,31,.355,25,28,.893,128
331,GSW,2020-03-07,118,,PHI,W 118-114,240,44,80,.550,35,55,.636,9,25,.360,21,28,.750,118,41,84,.488,28,50,.560,13,34,.382,19,22,.864,114
332,MEM,2020-03-07,118,,ATL,W 118-101,240,43,87,.494,31,54,.574,12,33,.364,20,33,.606,118,32,95,.337,19,46,.413,13,49,.265,24,28,.857,101
333,MIN,2020-03-06,118,,ORL,L 118-132,240,46,98,.469,36,61,.590,10,37,.270,16,20,.800,118,51,84,.607,44,63,.698,7,21,.333,23,31,.742,132
334,WAS,2020-03-06,118,,ATL,W 118-112,240,36,76,.474,21,45,.467,15,31,.484,31,35,.886,118,46,86,.535,34,54,.630,12,32,.375,8,12,.667,112
335,LAL,2020-02-25,118,,NOP,W 118-109,240,45,102,.441,32,58,.552,13,44,.295,15,21,.714,118,39,86,.453,31,59,.525,8,27,.296,23,30,.767,109
336,TOR,2020-02-21,118,,PHO,W 118-101,240,42,80,.525,28,43,.651,14,37,.378,20,22,.909,118,38,92,.413,32,58,.552,6,34,.176,19,23,.826,101
337,NOP,2020-02-13,118,,OKC,L 118-123,240,42,86,.488,28,51,.549,14,35,.400,20,27,.741,118,46,92,.500,33,65,.508,13,27,.481,18,22,.818,123
338,IND,2020-02-12,118,,MIL,W 118-111,240,45,86,.523,36,59,.610,9,27,.333,19,24,.792,118,37,91,.407,24,54,.444,13,37,.351,24,25,.960,111
339,PHI,2020-02-09,118,,CHI,W 118-111,240,42,84,.500,31,57,.544,11,27,.407,23,32,.719,118,43,88,.489,31,56,.554,12,32,.375,13,17,.765,111
340,LAC,2020-02-01,118,,MIN,W 118-106,240,45,98,.459,33,64,.516,12,34,.353,16,18,.889,118,34,84,.405,27,45,.600,7,39,.179,31,37,.838,106
341,GSW,2020-01-24,118,,IND,L 118-129,240,40,82,.488,21,43,.488,19,39,.487,19,23,.826,118,50,87,.575,33,59,.559,17,28,.607,12,13,.923,129
342,PHO,2020-01-20,118,,SAS,L 118-120,240,42,80,.525,34,58,.586,8,22,.364,26,30,.867,118,43,87,.494,26,56,.464,17,31,.548,17,22,.773,120
343,UTA,2020-01-20,118,,IND,W 118-88,240,47,87,.540,35,56,.625,12,31,.387,12,12,1.000,118,39,93,.419,32,67,.478,7,26,.269,3,7,.429,88
344,MIA,2020-01-20,118,,SAC,W 118-113 (OT),265,42,83,.506,26,41,.634,16,42,.381,18,22,.818,118,44,106,.415,31,55,.564,13,51,.255,12,15,.800,113
345,CHI,2020-01-18,118,,CLE,W 118-116,240,48,87,.552,39,62,.629,9,25,.360,13,17,.765,118,40,73,.548,25,44,.568,15,29,.517,21,23,.913,116
346,LAL,2020-01-15,118,,ORL,L 118-119,240,48,97,.495,33,59,.559,15,38,.395,7,11,.636,118,43,94,.457,33,68,.485,10,26,.385,23,29,.793,119
347,DAL,2020-01-06,118,,CHI,W 118-110,240,44,84,.524,28,43,.651,16,41,.390,14,19,.737,118,46,98,.469,37,67,.552,9,31,.290,9,11,.818,110
348,HOU,2020-01-03,118,,PHI,W 118-108,240,41,86,.477,29,54,.537,12,32,.375,24,32,.750,118,42,92,.457,36,65,.554,6,27,.222,18,25,.720,108
349,OKC,2019-12-22,118,,LAC,W 118-112,240,46,97,.474,37,70,.529,9,27,.333,17,20,.850,118,40,86,.465,29,59,.492,11,27,.407,21,24,.875,112
350,POR,2019-12-20,118,,ORL,W 118-103,240,42,84,.500,25,48,.521,17,36,.472,17,19,.895,118,39,106,.368,32,78,.410,7,28,.250,18,26,.692,103
351,SAS,2019-12-19,118,,BRK,W 118-105,240,43,96,.448,30,63,.476,13,33,.394,19,23,.826,118,35,83,.422,28,47,.596,7,36,.194,28,30,.933,105
352,MEM,2019-12-16,118,,MIA,W 118-111,240,42,86,.488,29,50,.580,13,36,.361,21,30,.700,118,37,81,.457,26,57,.456,11,24,.458,26,31,.839,111
353,DAL,2019-12-14,118,,MIA,L 118-122 (OT),265,45,101,.446,28,57,.491,17,44,.386,11,17,.647,118,39,91,.429,23,51,.451,16,40,.400,28,34,.824,122
354,HOU,2019-12-09,118,,SAC,L 118-119,240,41,84,.488,24,34,.706,17,50,.340,19,23,.826,118,40,88,.455,20,43,.465,20,45,.444,19,22,.864,119
355,ATL,2019-12-04,118,,BRK,L 118-130,240,48,90,.533,39,64,.609,9,26,.346,13,21,.619,118,50,101,.495,36,70,.514,14,31,.452,16,18,.889,130
356,ORL,2019-11-08,118,,MEM,W 118-86,240,44,93,.473,37,65,.569,7,28,.250,23,27,.852,118,32,86,.372,21,57,.368,11,29,.379,11,13,.846,86
357,TOR,2020-08-14,117,,DEN,W 117-109,240,45,90,.500,27,55,.491,18,35,.514,9,14,.643,117,36,87,.414,20,49,.408,16,38,.421,21,23,.913,109
358,PHI,2020-08-11,117,,PHO,L 117-130,240,46,93,.495,31,60,.517,15,33,.455,10,14,.714,117,49,89,.551,37,61,.607,12,28,.429,20,21,.952,130
359,POR,2020-08-08,117,,LAC,L 117-122,240,44,90,.489,27,47,.574,17,43,.395,12,17,.706,117,42,85,.494,27,51,.529,15,34,.441,23,28,.821,122
360,PHO,2020-08-02,117,,DAL,W 117-115,240,42,93,.452,30,60,.500,12,33,.364,21,23,.913,117,38,93,.409,32,62,.516,6,31,.194,33,37,.892,115
361,HOU,2020-03-10,117,,MIN,W 117-111,240,41,80,.513,26,42,.619,15,38,.395,20,26,.769,117,40,83,.482,26,48,.542,14,35,.400,17,23,.739,111
362,LAL,2020-02-21,117,,MEM,W 117-105,240,41,86,.477,32,57,.561,9,29,.310,26,40,.650,117,42,92,.457,37,77,.481,5,15,.333,16,31,.516,105
363,MIN,2020-02-21,117,,BOS,L 117-127,240,36,89,.404,21,47,.447,15,42,.357,30,35,.857,117,44,95,.463,34,66,.515,10,29,.345,29,37,.784,127
364,IND,2020-02-08,117,,NOP,L 117-124,240,44,83,.530,35,57,.614,9,26,.346,20,27,.741,117,44,95,.463,29,57,.509,15,38,.395,21,25,.840,124
365,UTA,2020-02-07,117,,POR,W 117-114,240,45,91,.495,35,61,.574,10,30,.333,17,24,.708,117,44,97,.454,27,57,.474,17,40,.425,9,14,.643,114
366,WAS,2020-02-03,117,,GSW,L 117-125,240,42,83,.506,33,61,.541,9,22,.409,24,29,.828,117,43,87,.494,28,57,.491,15,30,.500,24,31,.774,125
367,HOU,2020-02-02,117,,NOP,W 117-109,240,41,105,.390,25,54,.463,16,51,.314,19,22,.864,117,42,94,.447,32,61,.525,10,33,.303,15,20,.750,109
368,UTA,2020-01-27,117,,HOU,L 117-126,240,43,85,.506,31,43,.721,12,42,.286,19,26,.731,117,38,81,.469,23,41,.561,15,40,.375,35,49,.714,126
369,DEN,2020-01-26,117,,HOU,W 117-110,240,44,93,.473,33,65,.508,11,28,.393,18,20,.900,117,40,88,.455,29,55,.527,11,33,.333,19,27,.704,110
370,MIA,2020-01-24,117,,LAC,L 117-122,240,40,93,.430,27,49,.551,13,44,.295,24,29,.828,117,43,94,.457,27,59,.458,16,35,.457,20,23,.870,122
371,CHI,2020-01-22,117,,MIN,W 117-110,240,39,84,.464,30,54,.556,9,30,.300,30,37,.811,117,41,86,.477,26,42,.619,15,44,.341,13,24,.542,110
372,NOP,2020-01-22,117,,SAS,L 117-121,240,39,84,.464,25,48,.521,14,36,.389,25,32,.781,117,45,89,.506,34,62,.548,11,27,.407,20,25,.800,121
373,ATL,2020-01-20,117,,TOR,L 117-122,240,41,83,.494,29,50,.580,12,33,.364,23,33,.697,117,38,92,.413,25,50,.500,13,42,.310,33,43,.767,122
374,PHI,2020-01-15,117,,BRK,W 117-106,240,45,88,.511,34,58,.586,11,30,.367,16,25,.640,117,38,87,.437,26,62,.419,12,25,.480,18,30,.600,106
375,BRK,2020-01-10,117,,MIA,W 117-113,240,45,93,.484,30,49,.612,15,44,.341,12,19,.632,117,44,85,.518,37,56,.661,7,29,.241,18,21,.857,113
376,LAL,2020-01-07,117,,NYK,W 117-87,240,41,82,.500,24,46,.522,17,36,.472,18,21,.857,117,37,95,.389,33,75,.440,4,20,.200,9,16,.563,87
377,LAL,2020-01-01,117,,PHO,W 117-107,240,43,90,.478,36,62,.581,7,28,.250,24,34,.706,117,42,86,.488,36,63,.571,6,23,.261,17,23,.739,107
378,NYK,2020-01-01,117,,POR,W 117-93,240,47,98,.480,33,62,.532,14,36,.389,9,14,.643,117,37,94,.394,27,62,.435,10,32,.313,9,15,.600,93
379,TOR,2019-12-31,117,,CLE,W 117-97,240,40,84,.476,23,45,.511,17,39,.436,20,25,.800,117,37,87,.425,27,49,.551,10,38,.263,13,16,.813,97
380,SAS,2019-12-31,117,,GSW,W 117-113 (OT),265,45,96,.469,31,65,.477,14,31,.452,13,17,.765,117,44,96,.458,32,69,.464,12,27,.444,13,18,.722,113
381,MEM,2019-12-29,117,,CHO,W 117-104,240,45,93,.484,35,58,.603,10,35,.286,17,17,1.000,117,37,86,.430,28,55,.509,9,31,.290,21,32,.656,104
382,MIA,2019-12-28,117,,PHI,W 117-116 (OT),265,42,94,.447,32,66,.485,10,28,.357,23,29,.793,117,42,89,.472,32,59,.542,10,30,.333,22,29,.759,116
383,MIL,2019-12-22,117,,IND,W 117-89,240,44,104,.423,29,60,.483,15,44,.341,14,17,.824,117,37,100,.370,25,60,.417,12,40,.300,3,5,.600,89
384,LAC,2019-12-19,117,,HOU,L 117-122,240,43,86,.500,27,49,.551,16,37,.432,15,19,.789,117,43,86,.500,29,49,.592,14,37,.378,22,29,.759,122
385,MIN,2019-12-13,117,,LAC,L 117-124,240,38,85,.447,28,44,.636,10,41,.244,31,37,.838,117,39,79,.494,28,54,.519,11,25,.440,35,39,.897,124
386,LAC,2019-12-03,117,,POR,W 117-97,240,43,94,.457,26,60,.433,17,34,.500,14,25,.560,117,39,91,.429,32,64,.500,7,27,.259,12,15,.800,97
387,HOU,2019-11-27,117,,MIA,W 117-108,240,38,83,.458,23,39,.590,15,44,.341,26,33,.788,117,37,80,.463,23,43,.535,14,37,.378,20,27,.741,108
388,DEN,2019-11-26,117,,WAS,W 117-104,240,47,90,.522,41,66,.621,6,24,.250,17,23,.739,117,40,95,.421,30,55,.545,10,40,.250,14,21,.667,104
389,MIA,2019-11-25,117,,CHO,W 117-100,240,40,77,.519,27,46,.587,13,31,.419,24,28,.857,117,36,87,.414,27,54,.500,9,33,.273,19,25,.760,100
390,DAL,2019-11-18,117,,SAS,W 117-110,240,42,84,.500,25,43,.581,17,41,.415,16,23,.696,117,44,96,.458,36,72,.500,8,24,.333,14,16,.875,110
391,CHO,2019-11-13,117,,MEM,L 117-119,240,43,87,.494,27,51,.529,16,36,.444,15,19,.789,117,48,89,.539,31,54,.574,17,35,.486,6,9,.667,119
392,MIA,2019-11-12,117,,DET,W 117-108,240,41,77,.532,27,45,.600,14,32,.438,21,27,.778,117,34,78,.436,19,37,.514,15,41,.366,25,37,.676,108
393,PHI,2019-10-30,117,,MIN,W 117-95,240,43,92,.467,34,67,.507,9,25,.360,22,28,.786,117,32,81,.395,22,46,.478,10,35,.286,21,28,.750,95
394,CLE,2019-10-30,117,,CHI,W 117-111,240,41,78,.526,31,54,.574,10,24,.417,25,31,.806,117,39,90,.433,25,51,.490,14,39,.359,19,23,.826,111
395,OKC,2020-08-12,116,,MIA,W 116-115,240,39,89,.438,23,47,.489,16,42,.381,22,27,.815,116,42,86,.488,28,44,.636,14,42,.333,17,20,.850,115
396,IND,2020-08-08,116,,LAL,W 116-111,240,44,84,.524,29,51,.569,15,33,.455,13,14,.929,116,42,100,.420,29,61,.475,13,39,.333,14,19,.737,111
397,MIL,2020-08-04,116,,BRK,L 116-119,240,42,88,.477,25,37,.676,17,51,.333,15,23,.652,116,43,103,.417,22,46,.478,21,57,.368,12,16,.750,119
398,MIA,2020-03-04,116,,ORL,W 116-113,240,41,79,.519,19,35,.543,22,44,.500,12,15,.800,116,44,84,.524,31,54,.574,13,30,.433,12,14,.857,113
399,MIA,2020-02-29,116,,BRK,W 116-113,240,41,91,.451,27,53,.509,14,38,.368,20,24,.833,116,40,86,.465,24,42,.571,16,44,.364,17,23,.739,113
400,NOP,2020-02-28,116,,CLE,W 116-104,240,48,88,.545,39,65,.600,9,23,.391,11,15,.733,116,43,95,.453,32,64,.500,11,31,.355,7,12,.583,104
401,UTA,2020-02-12,116,,MIA,W 116-101,240,41,85,.482,27,49,.551,14,36,.389,20,23,.870,116,38,88,.432,25,49,.510,13,39,.333,12,16,.750,101
402,DEN,2020-02-12,116,,LAL,L 116-120 (OT),265,44,88,.500,33,63,.524,11,25,.440,17,22,.773,116,47,93,.505,35,60,.583,12,33,.364,14,27,.519,120
403,ORL,2020-02-12,116,,DET,W 116-112 (OT),265,44,96,.458,32,60,.533,12,36,.333,16,18,.889,116,40,92,.435,22,47,.468,18,45,.400,14,15,.933,112
404,HOU,2020-02-11,116,,BOS,W 116-105,240,33,77,.429,20,32,.625,13,45,.289,37,42,.881,116,37,85,.435,26,53,.491,11,32,.344,20,25,.800,105
405,DET,2020-02-05,116,,PHO,W 116-108,240,46,95,.484,34,67,.507,12,28,.429,12,16,.750,116,42,77,.545,30,51,.588,12,26,.462,12,15,.800,108
406,BOS,2020-02-05,116,,ORL,W 116-100,240,46,86,.535,33,63,.524,13,23,.565,11,16,.688,116,32,75,.427,19,44,.432,13,31,.419,23,30,.767,100
407,BOS,2020-02-01,116,,PHI,W 116-95,240,38,80,.475,30,50,.600,8,30,.267,32,41,.780,116,31,84,.369,24,51,.471,7,33,.212,26,31,.839,95
408,MEM,2020-01-20,116,,NOP,L 116-126,240,46,103,.447,37,70,.529,9,33,.273,15,21,.714,116,42,88,.477,21,40,.525,21,48,.438,21,24,.875,126
409,IND,2020-01-17,116,,MIN,W 116-114,240,46,82,.561,38,58,.655,8,24,.333,16,20,.800,116,40,88,.455,23,49,.469,17,39,.436,17,21,.810,114
410,WAS,2020-01-12,116,,UTA,L 116-127,240,47,93,.505,40,71,.563,7,22,.318,15,17,.882,116,48,90,.533,38,60,.633,10,30,.333,21,25,.840,127
411,MIN,2020-01-09,116,,POR,W 116-102,240,44,89,.494,31,57,.544,13,32,.406,15,21,.714,116,35,96,.365,24,59,.407,11,37,.297,21,31,.677,102
412,ATL,2020-01-04,116,,IND,W 116-111,240,42,82,.512,32,50,.640,10,32,.313,22,24,.917,116,36,87,.414,26,60,.433,10,27,.370,29,35,.829,111
413,IND,2020-01-02,116,,DEN,L 116-124,240,43,82,.524,31,56,.554,12,26,.462,18,25,.720,116,46,87,.529,38,60,.633,8,27,.296,24,27,.889,124
414,POR,2019-12-30,116,,PHO,L 116-122,240,44,96,.458,30,62,.484,14,34,.412,14,18,.778,116,44,92,.478,31,69,.449,13,23,.565,21,22,.955,122
415,CHI,2019-12-28,116,,ATL,W 116-81,240,43,87,.494,28,56,.500,15,31,.484,15,19,.789,116,32,86,.372,23,52,.442,9,34,.265,8,11,.727,81
416,GSW,2019-12-25,116,,HOU,W 116-104,240,41,87,.471,32,59,.542,9,28,.321,25,28,.893,116,37,100,.370,21,49,.429,16,51,.314,14,16,.875,104
417,MIL,2019-12-16,116,,DAL,L 116-120,240,44,105,.419,33,64,.516,11,41,.268,17,24,.708,116,41,88,.466,25,47,.532,16,41,.390,22,27,.815,120
418,PHI,2019-12-13,116,,NOP,W 116-109,240,43,87,.494,36,67,.537,7,20,.350,23,34,.676,116,38,88,.432,29,64,.453,9,24,.375,24,35,.686,109
419,MIN,2019-12-11,116,,UTA,L 116-127,240,40,91,.440,25,50,.500,15,41,.366,21,26,.808,116,47,83,.566,31,48,.646,16,35,.457,17,22,.773,127
420,DEN,2019-11-24,116,,PHO,W 116-104,240,43,91,.473,29,60,.483,14,31,.452,16,23,.696,116,41,82,.500,29,47,.617,12,35,.343,10,12,.833,104
421,ATL,2019-11-23,116,,TOR,L 116-119,240,47,90,.522,33,56,.589,14,34,.412,8,11,.727,116,40,88,.455,27,51,.529,13,37,.351,26,30,.867,119
422,BRK,2019-11-22,116,,SAC,W 116-97,240,41,81,.506,29,47,.617,12,34,.353,22,31,.710,116,39,86,.453,35,60,.583,4,26,.154,15,19,.789,97
423,SAS,2019-11-16,116,,POR,L 116-121,240,41,88,.466,36,70,.514,5,18,.278,29,34,.853,116,42,93,.452,29,54,.537,13,39,.333,24,26,.923,121
424,MIN,2019-11-15,116,,WAS,L 116-137,240,42,89,.472,31,52,.596,11,37,.297,21,29,.724,116,54,100,.540,44,72,.611,10,28,.357,19,25,.760,137
425,NOP,2019-11-11,116,,HOU,L 116-122,240,41,95,.432,27,50,.540,14,45,.311,20,27,.741,116,44,85,.518,32,44,.727,12,41,.293,22,32,.688,122
426,BOS,2019-11-11,116,,DAL,W 116-106,240,41,86,.477,26,51,.510,15,35,.429,19,25,.760,116,37,89,.416,26,47,.553,11,42,.262,21,28,.750,106
427,BOS,2019-10-30,116,,MIL,W 116-105,240,41,92,.446,24,51,.471,17,41,.415,17,21,.810,116,38,82,.463,24,37,.649,14,45,.311,15,24,.625,105
428,HOU,2019-10-28,116,,OKC,W 116-112,240,39,90,.433,29,46,.630,10,44,.227,28,33,.848,116,41,94,.436,28,59,.475,13,35,.371,17,24,.708,112
429,MIN,2019-10-27,116,,MIA,W 116-109,240,39,91,.429,26,46,.565,13,45,.289,25,33,.758,116,42,85,.494,27,49,.551,15,36,.417,10,15,.667,109
430,NOP,2019-10-25,116,,DAL,L 116-123,240,45,98,.459,30,57,.526,15,41,.366,11,15,.733,116,45,93,.484,31,53,.585,14,40,.350,19,26,.731,123
431,DEN,2020-08-06,115,,POR,L 115-125,240,44,84,.524,30,56,.536,14,28,.500,13,17,.765,115,43,92,.467,20,53,.377,23,39,.590,16,20,.800,125
432,LAC,2020-08-04,115,,PHO,L 115-117,240,42,85,.494,34,56,.607,8,29,.276,23,27,.852,115,45,96,.469,28,64,.438,17,32,.531,10,14,.714,117
433,MEM,2020-03-10,115,,ORL,L 115-120,240,38,76,.500,27,47,.574,11,29,.379,28,38,.737,115,43,92,.467,29,59,.492,14,33,.424,20,22,.909,120
434,MIN,2020-03-04,115,,CHI,W 115-108,240,40,81,.494,21,38,.553,19,43,.442,16,25,.640,115,45,94,.479,34,64,.531,11,30,.367,7,11,.636,108
435,PHI,2020-02-27,115,,NYK,W 115-106,240,45,91,.495,30,60,.500,15,31,.484,10,13,.769,115,42,83,.506,34,60,.567,8,23,.348,14,24,.583,106
436,DEN,2020-02-25,115,,DET,W 115-98,240,44,76,.579,35,57,.614,9,19,.474,18,22,.818,115,33,81,.407,18,40,.450,15,41,.366,17,21,.810,98
437,POR,2020-02-21,115,,NOP,L 115-128,240,43,94,.457,33,67,.493,10,27,.370,19,25,.760,115,45,84,.536,27,50,.540,18,34,.529,20,33,.606,128
438,POR,2020-02-09,115,,MIA,W 115-109,240,40,85,.471,21,43,.488,19,42,.452,16,22,.727,115,39,98,.398,19,49,.388,20,49,.408,11,14,.786,109
439,ATL,2020-02-03,115,,BOS,L 115-123,240,42,84,.500,30,54,.556,12,30,.400,19,21,.905,115,48,90,.533,36,61,.590,12,29,.414,15,17,.882,123
440,MIL,2020-01-31,115,,DEN,L 115-127,240,43,95,.453,31,55,.564,12,40,.300,17,26,.654,115,48,100,.480,26,54,.481,22,46,.478,9,9,1.000,127
441,IND,2020-01-29,115,,CHI,W 115-106 (OT),265,46,89,.517,39,62,.629,7,27,.259,16,22,.727,115,45,85,.529,39,52,.750,6,33,.182,10,15,.667,106
442,PHI,2020-01-28,115,,GSW,W 115-104,240,42,82,.512,31,50,.620,11,32,.344,20,26,.769,115,37,87,.425,22,47,.468,15,40,.375,15,21,.714,104
443,HOU,2020-01-18,115,,LAL,L 115-124,240,40,90,.444,28,53,.528,12,37,.324,23,29,.793,115,45,93,.484,34,60,.567,11,33,.333,23,32,.719,124
444,CHI,2020-01-15,115,,WAS,W 115-106,240,43,85,.506,29,47,.617,14,38,.368,15,22,.682,115,37,79,.468,26,52,.500,11,27,.407,21,26,.808,106
445,POR,2020-01-13,115,,CHO,W 115-112,240,42,83,.506,26,46,.565,16,37,.432,15,19,.789,115,40,90,.444,22,52,.423,18,38,.474,14,18,.778,112
446,ATL,2020-01-08,115,,HOU,L 115-122,240,39,106,.368,26,62,.419,13,44,.295,24,27,.889,115,39,92,.424,26,47,.553,13,45,.289,31,41,.756,122
447,ATL,2020-01-06,115,,DEN,L 115-123,240,35,77,.455,17,38,.447,18,39,.462,27,32,.844,115,47,92,.511,38,65,.585,9,27,.333,20,27,.741,123
448,SAC,2020-01-04,115,,NOP,L 115-117,240,38,85,.447,26,64,.406,12,21,.571,27,36,.750,115,38,87,.437,22,42,.524,16,45,.356,25,33,.758,117
449,IND,2019-12-31,115,,PHI,W 115-97,240,42,86,.488,31,61,.508,11,25,.440,20,26,.769,115,37,91,.407,31,62,.500,6,29,.207,17,20,.850,97
450,NYK,2019-12-23,115,,WAS,L 115-121,240,44,93,.473,29,57,.509,15,36,.417,12,15,.800,115,47,100,.470,37,70,.529,10,30,.333,17,30,.567,121
451,MEM,2019-12-23,115,,SAS,L 115-145,240,45,96,.469,30,59,.508,15,37,.405,10,16,.625,115,60,89,.674,45,65,.692,15,24,.625,10,14,.714,145
452,POR,2019-12-10,115,,NYK,W 115-87,240,39,90,.433,22,49,.449,17,41,.415,20,24,.833,115,32,91,.352,25,53,.472,7,38,.184,16,26,.615,87
453,HOU,2019-12-07,115,,PHO,W 115-109,240,41,91,.451,30,51,.588,11,40,.275,22,30,.733,115,40,96,.417,29,61,.475,11,35,.314,18,28,.643,109
454,CHO,2019-11-23,115,,CHI,L 115-116,240,44,80,.550,32,52,.615,12,28,.429,15,22,.682,115,43,95,.453,21,48,.438,22,47,.468,8,12,.667,116
455,PHI,2019-11-22,115,,SAS,W 115-104,240,46,89,.517,36,63,.571,10,26,.385,13,19,.684,115,43,85,.506,37,67,.552,6,18,.333,12,16,.750,104
456,NOP,2019-11-19,115,,POR,W 115-104,240,41,93,.441,28,57,.491,13,36,.361,20,24,.833,115,40,92,.435,24,63,.381,16,29,.552,8,13,.615,104
457,PHO,2019-11-12,115,,LAL,L 115-123,240,43,91,.473,27,53,.509,16,38,.421,13,17,.765,115,51,95,.537,41,70,.586,10,25,.400,11,21,.524,123
458,SAS,2019-11-09,115,,BOS,L 115-135,240,39,99,.394,25,69,.362,14,30,.467,23,30,.767,115,48,94,.511,34,57,.596,14,37,.378,25,28,.893,135
459,POR,2019-11-08,115,,BRK,L 115-119,240,40,97,.412,29,67,.433,11,30,.367,24,25,.960,115,41,99,.414,25,62,.403,16,37,.432,21,30,.700,119
460,WAS,2019-11-04,115,,DET,W 115-99,240,43,93,.462,35,64,.547,8,29,.276,21,25,.840,115,34,82,.415,21,55,.382,13,27,.481,18,23,.783,99
461,OKC,2019-11-02,115,,NOP,W 115-104,240,41,90,.456,26,53,.491,15,37,.405,18,23,.783,115,40,94,.426,29,62,.468,11,32,.344,13,22,.591,104
462,MIL,2019-11-02,115,,TOR,W 115-105,240,41,89,.461,28,51,.549,13,38,.342,20,25,.800,115,34,84,.405,19,48,.396,15,36,.417,22,25,.880,105
463,UTA,2020-08-10,114,,DAL,L 114-122,240,39,82,.476,18,36,.500,21,46,.457,15,20,.750,114,48,85,.565,36,61,.590,12,24,.500,14,16,.875,122
464,MIA,2020-08-10,114,,IND,W 114-92,240,44,98,.449,31,58,.534,13,40,.325,13,19,.684,114,33,84,.393,23,49,.469,10,35,.286,16,25,.640,92
465,PHO,2020-08-06,114,,IND,W 114-99,240,43,92,.467,34,58,.586,9,34,.265,19,20,.950,114,37,85,.435,27,56,.482,10,29,.345,15,19,.789,99
466,PHO,2020-03-03,114,,TOR,L 114-123,240,39,85,.459,24,46,.522,15,39,.385,21,25,.840,114,40,86,.465,26,52,.500,14,34,.412,29,35,.829,123
467,NOP,2020-03-01,114,,LAL,L 114-122,240,40,95,.421,33,63,.524,7,32,.219,27,33,.818,114,50,97,.515,37,62,.597,13,35,.371,9,10,.900,122
468,SAS,2020-02-29,114,,ORL,W 114-113,240,44,84,.524,30,53,.566,14,31,.452,12,16,.750,114,41,84,.488,26,47,.553,15,37,.405,16,23,.696,113
469,LAL,2020-02-23,114,,BOS,W 114-112,240,39,86,.453,28,52,.538,11,34,.324,25,37,.676,114,38,83,.458,25,49,.510,13,34,.382,23,30,.767,112
470,SAS,2020-02-01,114,,CHO,W 114-90,240,45,87,.517,35,59,.593,10,28,.357,14,21,.667,114,35,83,.422,25,47,.532,10,36,.278,10,12,.833,90
471,MEM,2020-01-26,114,,PHO,W 114-109,240,44,84,.524,36,65,.554,8,19,.421,18,26,.692,114,35,92,.380,24,63,.381,11,29,.379,28,35,.800,109
472,ORL,2020-01-22,114,,OKC,L 114-120,240,44,92,.478,30,57,.526,14,35,.400,12,16,.750,114,46,76,.605,37,57,.649,9,19,.474,19,23,.826,120
473,DEN,2020-01-12,114,,LAC,W 114-104,240,37,77,.481,26,52,.500,11,25,.440,29,37,.784,114,38,84,.452,30,51,.588,8,33,.242,20,26,.769,104
474,DAL,2020-01-10,114,,LAL,L 114-129,240,39,96,.406,28,58,.483,11,38,.289,25,37,.676,114,47,89,.528,37,65,.569,10,24,.417,25,32,.781,129
475,BOS,2020-01-08,114,,SAS,L 114-129,240,37,89,.416,24,51,.471,13,38,.342,27,30,.900,114,48,87,.552,39,58,.672,9,29,.310,24,26,.923,129
476,PHO,2020-01-05,114,,MEM,L 114-121,240,43,95,.453,37,69,.536,6,26,.231,22,26,.846,114,45,83,.542,27,41,.659,18,42,.429,13,17,.765,121
477,LAC,2020-01-04,114,,MEM,L 114-140,240,45,101,.446,38,71,.535,7,30,.233,17,22,.773,114,49,96,.510,31,57,.544,18,39,.462,24,28,.857,140
478,BOS,2019-12-20,114,,DET,W 114-93,240,45,86,.523,36,59,.610,9,27,.333,15,21,.714,114,34,85,.400,23,54,.426,11,31,.355,14,19,.737,93
479,CLE,2019-12-20,114,,MEM,W 114-107,240,40,92,.435,23,55,.418,17,37,.459,17,23,.739,114,44,102,.431,30,61,.492,14,41,.341,5,7,.714,107
480,UTA,2019-12-13,114,,GSW,W 114-106,240,37,79,.468,21,41,.512,16,38,.421,24,31,.774,114,41,91,.451,32,62,.516,9,29,.310,15,22,.682,106
481,MEM,2019-12-13,114,,MIL,L 114-127,240,38,98,.388,18,49,.367,20,49,.408,18,23,.783,114,44,87,.506,33,57,.579,11,30,.367,28,33,.848,127
482,DEN,2019-12-12,114,,POR,W 114-99,240,42,88,.477,24,52,.462,18,36,.500,12,19,.632,114,41,86,.477,32,56,.571,9,30,.300,8,11,.727,99
483,CHO,2019-12-10,114,,WAS,W 114-107,240,38,85,.447,22,44,.500,16,41,.390,22,28,.786,114,38,90,.422,27,55,.491,11,35,.314,20,25,.800,107
484,MEM,2019-11-17,114,,DEN,L 114-131,240,39,84,.464,23,48,.479,16,36,.444,20,24,.833,114,49,89,.551,31,57,.544,18,32,.563,15,23,.652,131
485,DET,2019-11-11,114,,MIN,L 114-120,240,39,87,.448,23,55,.418,16,32,.500,20,25,.800,114,45,89,.506,30,55,.545,15,34,.441,15,19,.789,120
486,PHI,2019-11-10,114,,CHO,W 114-106,240,46,84,.548,36,56,.643,10,28,.357,12,16,.750,114,38,84,.452,24,51,.471,14,33,.424,16,22,.727,106
487,OKC,2019-11-09,114,,GSW,W 114-108,240,43,79,.544,29,49,.592,14,30,.467,14,17,.824,114,42,85,.494,35,63,.556,7,22,.318,17,17,1.000,108
488,PHO,2019-11-04,114,,PHI,W 114-109,240,41,77,.532,30,49,.612,11,28,.393,21,27,.778,114,42,89,.472,29,60,.483,13,29,.448,12,20,.600,109
489,WAS,2020-08-11,113,,MIL,L 113-126,240,39,95,.411,27,60,.450,12,35,.343,23,30,.767,113,44,87,.506,26,49,.531,18,38,.474,20,28,.714,126
490,NOP,2020-08-09,113,,SAS,L 113-122,240,42,96,.438,30,66,.455,12,30,.400,17,22,.773,113,40,89,.449,29,61,.475,11,28,.393,31,32,.969,122
491,HOU,2020-08-06,113,,LAL,W 113-97,240,36,84,.429,15,27,.556,21,57,.368,20,23,.870,113,35,77,.455,33,58,.569,2,19,.105,25,36,.694,97
492,OKC,2020-08-03,113,,DEN,L 113-121 (OT),265,37,87,.425,22,51,.431,15,36,.417,24,31,.774,113,42,87,.483,35,62,.565,7,25,.280,30,39,.769,121
493,DAL,2020-03-11,113,,DEN,W 113-97,240,42,92,.457,30,57,.526,12,35,.343,17,23,.739,113,39,83,.470,25,44,.568,14,39,.359,5,8,.625,97
494,SAC,2020-03-08,113,,TOR,L 113-118,240,42,90,.467,34,59,.576,8,31,.258,21,23,.913,113,39,82,.476,20,34,.588,19,48,.396,21,27,.778,118
495,LAL,2020-03-06,113,,MIL,W 113-103,240,38,91,.418,32,59,.542,6,32,.188,31,38,.816,113,37,89,.416,25,46,.543,12,43,.279,17,23,.739,103
496,GSW,2020-03-05,113,,TOR,L 113-121,240,40,98,.408,26,46,.565,14,52,.269,19,25,.760,113,40,84,.476,27,43,.628,13,41,.317,28,31,.903,121
497,CLE,2020-03-02,113,,UTA,L 113-126,240,42,91,.462,25,50,.500,17,41,.415,12,18,.667,113,47,83,.566,27,42,.643,20,41,.488,12,14,.857,126
498,BRK,2020-02-24,113,,ORL,L 113-115,240,46,96,.479,30,59,.508,16,37,.432,5,8,.625,113,44,89,.494,31,55,.564,13,34,.382,14,17,.824,115
499,OKC,2020-02-21,113,,DEN,W 113-101,240,40,87,.460,31,61,.508,9,26,.346,24,27,.889,113,37,77,.481,31,50,.620,6,27,.222,21,23,.913,101
500,HOU,2020-02-09,113,,UTA,L 113-114,240,44,95,.463,29,53,.547,15,42,.357,10,14,.714,113,42,86,.488,27,48,.563,15,38,.395,15,18,.833,114
501,SAC,2020-02-03,113,,MIN,W 113-109,240,38,75,.507,24,48,.500,14,27,.519,23,31,.742,113,37,85,.435,24,47,.511,13,38,.342,22,28,.786,109
502,WAS,2020-02-01,113,,BRK,W 113-107,240,44,100,.440,35,68,.515,9,32,.281,16,26,.615,113,39,94,.415,23,47,.489,16,47,.340,13,21,.619,107
503,SAC,2020-02-01,113,,LAL,L 113-129,240,39,91,.429,25,47,.532,14,44,.318,21,26,.808,113,44,86,.512,25,43,.581,19,43,.442,22,27,.815,129
504,MIA,2020-01-27,113,,ORL,W 113-92,240,42,79,.532,28,51,.549,14,28,.500,15,16,.938,113,33,89,.371,22,52,.423,11,37,.297,15,19,.789,92
505,BRK,2020-01-23,113,,LAL,L 113-128,240,40,91,.440,19,45,.422,21,46,.457,12,15,.800,113,47,94,.500,28,56,.500,19,38,.500,15,20,.750,128
506,MEM,2020-01-17,113,,CLE,W 113-109,240,45,89,.506,36,61,.590,9,28,.321,14,20,.700,113,41,92,.446,32,56,.571,9,36,.250,18,26,.692,109
507,BOS,2020-01-13,113,,CHI,W 113-101,240,39,83,.470,30,60,.500,9,23,.391,26,29,.897,113,37,81,.457,31,56,.554,6,25,.240,21,26,.808,101
508,OKC,2020-01-09,113,,HOU,W 113-92,240,43,87,.494,32,55,.582,11,32,.344,16,20,.800,113,34,89,.382,23,49,.469,11,40,.275,13,14,.929,92
509,CLE,2020-01-07,113,,DET,L 113-115,240,42,85,.494,28,54,.519,14,31,.452,15,16,.938,113,42,91,.462,29,58,.500,13,33,.394,18,21,.857,115
510,MIA,2019-12-27,113,,IND,W 113-112,240,40,89,.449,24,51,.471,16,38,.421,17,19,.895,113,44,90,.489,30,59,.508,14,31,.452,10,12,.833,112
511,GSW,2019-12-23,113,,MIN,W 113-104,240,38,87,.437,26,57,.456,12,30,.400,25,30,.833,113,35,87,.402,24,53,.453,11,34,.324,23,29,.793,104
512,POR,2019-12-21,113,,MIN,W 113-106,240,40,94,.426,27,59,.458,13,35,.371,20,25,.800,113,38,87,.437,23,50,.460,15,37,.405,15,16,.938,106
513,DEN,2019-12-18,113,,ORL,W 113-104,240,40,84,.476,29,57,.509,11,27,.407,22,25,.880,113,37,87,.425,26,58,.448,11,29,.379,19,21,.905,104
514,POR,2019-12-06,113,,LAL,L 113-136,240,39,86,.453,29,52,.558,10,34,.294,25,29,.862,113,46,85,.541,29,49,.592,17,36,.472,27,33,.818,136
515,PHO,2019-11-29,113,,DAL,L 113-120,240,41,93,.441,28,55,.509,13,38,.342,18,25,.720,113,35,85,.412,18,38,.474,17,47,.362,33,38,.868,120
516,ATL,2019-11-25,113,,MIN,L 113-125,240,41,94,.436,31,62,.500,10,32,.313,21,26,.808,113,41,90,.456,26,55,.473,15,35,.429,28,36,.778,125
517,PHI,2019-11-23,113,,MIA,W 113-86,240,42,83,.506,28,54,.519,14,29,.483,15,17,.882,113,30,75,.400,24,51,.471,6,24,.250,20,27,.741,86
518,UTA,2019-11-22,113,,GSW,W 113-109,240,43,85,.506,29,53,.547,14,32,.438,13,16,.813,113,43,94,.457,31,66,.470,12,28,.429,11,12,.917,109
519,TOR,2019-11-20,113,,ORL,W 113-97,240,45,87,.517,36,60,.600,9,27,.333,14,19,.737,113,35,91,.385,26,59,.441,9,32,.281,18,28,.643,97
520,CLE,2019-11-05,113,,BOS,L 113-119,240,40,95,.421,27,62,.435,13,33,.394,20,22,.909,113,48,85,.565,36,55,.655,12,30,.400,11,15,.733,119
521,DET,2019-11-02,113,,BRK,W 113-109,240,41,91,.451,33,64,.516,8,27,.296,23,29,.793,113,43,93,.462,33,61,.541,10,32,.313,13,17,.765,109
522,SAS,2019-10-28,113,,POR,W 113-110,240,41,85,.482,34,63,.540,7,22,.318,24,32,.750,113,39,100,.390,29,67,.433,10,33,.303,22,27,.815,110
523,UTA,2019-10-26,113,,SAC,W 113-81,240,44,78,.564,26,41,.634,18,37,.486,7,12,.583,113,30,81,.370,23,55,.418,7,26,.269,14,17,.824,81
524,BRK,2019-10-25,113,,NYK,W 113-109,240,37,78,.474,21,41,.512,16,37,.432,23,34,.676,113,38,81,.469,21,56,.375,17,25,.680,16,28,.571,109
525,SAC,2020-08-11,112,,NOP,W 112-106,240,43,88,.489,32,62,.516,11,26,.423,15,16,.938,112,42,82,.512,35,58,.603,7,24,.292,15,19,.789,106
526,SAC,2020-08-09,112,,HOU,L 112-129,240,41,87,.471,31,50,.620,10,37,.270,20,23,.870,112,43,91,.473,25,34,.735,18,57,.316,25,30,.833,129
527,MIA,2020-08-08,112,,PHO,L 112-119,240,41,84,.488,30,48,.625,11,36,.306,19,22,.864,112,44,92,.478,32,60,.533,12,32,.375,19,20,.950,119
528,MIA,2020-08-04,112,,BOS,W 112-106,240,34,77,.442,19,34,.559,15,43,.349,29,39,.744,112,37,85,.435,27,52,.519,10,33,.303,22,27,.815,106
529,WAS,2020-07-31,112,,PHO,L 112-125,240,42,91,.462,34,69,.493,8,22,.364,20,23,.870,112,42,80,.525,31,48,.646,11,32,.344,30,32,.938,125
530,CHO,2020-03-05,112,,DEN,L 112-114,240,38,77,.494,25,44,.568,13,33,.394,23,28,.821,112,44,83,.530,36,57,.632,8,26,.308,18,20,.900,114
531,OKC,2020-02-27,112,,SAC,W 112-108,240,41,84,.488,32,58,.552,9,26,.346,21,29,.724,112,41,91,.451,29,56,.518,12,35,.343,14,14,1.000,108
532,PHI,2020-02-20,112,,BRK,W 112-104 (OT),265,38,86,.442,34,64,.531,4,22,.182,32,35,.914,112,36,102,.353,26,68,.382,10,34,.294,22,28,.786,104
533,PHO,2020-02-12,112,,GSW,W 112-106,240,42,91,.462,28,54,.519,14,37,.378,14,15,.933,112,39,77,.506,28,46,.609,11,31,.355,17,19,.895,106
534,BOS,2020-02-07,112,,ATL,W 112-107,240,37,86,.430,21,49,.429,16,37,.432,22,27,.815,112,35,86,.407,22,47,.468,13,39,.333,24,26,.923,107
535,MIL,2020-02-06,112,,PHI,W 112-101,240,44,94,.468,32,57,.561,12,37,.324,12,18,.667,112,37,99,.374,18,54,.333,19,45,.422,8,14,.571,101
536,CLE,2020-02-01,112,,GSW,L 112-131,240,41,95,.432,25,51,.490,16,44,.364,14,14,1.000,112,48,90,.533,30,55,.545,18,35,.514,17,19,.895,131
537,UTA,2020-01-25,112,,DAL,W 112-107,240,40,91,.440,25,48,.521,15,43,.349,17,22,.773,112,42,97,.433,26,56,.464,16,41,.390,7,13,.538,107
538,DET,2020-01-24,112,,MEM,L 112-125,240,39,91,.429,28,59,.475,11,32,.344,23,31,.742,112,43,79,.544,32,57,.561,11,22,.500,28,31,.903,125
539,NYK,2020-01-24,112,,TOR,L 112-118,240,42,85,.494,29,49,.592,13,36,.361,15,21,.714,112,41,81,.506,24,46,.522,17,35,.486,19,23,.826,118
540,CLE,2020-01-23,112,,WAS,L 112-124,240,44,96,.458,33,63,.524,11,33,.333,13,17,.765,112,47,85,.553,31,49,.633,16,36,.444,14,18,.778,124
541,MIN,2020-01-18,112,,TOR,L 112-122,240,38,94,.404,24,44,.545,14,50,.280,22,27,.815,112,47,91,.516,34,56,.607,13,35,.371,15,17,.882,122
542,SAC,2020-01-13,112,,ORL,L 112-114,240,45,87,.517,33,56,.589,12,31,.387,10,11,.909,112,40,92,.435,31,63,.492,9,29,.310,25,30,.833,114
543,DET,2020-01-09,112,,CLE,L 112-115 (OT),265,48,98,.490,42,78,.538,6,20,.300,10,16,.625,112,48,91,.527,43,71,.606,5,20,.250,14,20,.700,115
544,MIA,2019-12-06,112,,WAS,W 112-103,240,42,86,.488,32,58,.552,10,28,.357,18,24,.750,112,39,91,.429,27,52,.519,12,39,.308,13,14,.929,103
545,BOS,2019-12-04,112,,MIA,W 112-93,240,35,79,.443,19,38,.500,16,41,.390,26,32,.813,112,34,77,.442,20,39,.513,14,38,.368,11,17,.647,93
546,BRK,2019-11-29,112,,BOS,W 112-107,240,43,93,.462,26,52,.500,17,41,.415,9,13,.692,112,41,93,.441,32,65,.492,9,28,.321,16,21,.762,107
547,LAL,2019-11-19,112,,OKC,W 112-107,240,43,89,.483,29,58,.500,14,31,.452,12,19,.632,112,38,80,.475,29,52,.558,9,28,.321,22,25,.880,107
548,ORL,2019-11-13,112,,PHI,W 112-97,240,38,86,.442,28,54,.519,10,32,.313,26,34,.765,112,40,91,.440,32,61,.525,8,30,.267,9,13,.692,97
549,IND,2019-11-08,112,,DET,W 112-106,240,43,83,.518,39,68,.574,4,15,.267,22,25,.880,112,39,86,.453,26,53,.491,13,33,.394,15,18,.833,106
550,CHI,2019-11-05,112,,LAL,L 112-118,240,43,85,.506,29,53,.547,14,32,.438,12,23,.522,112,45,92,.489,34,59,.576,11,33,.333,17,24,.708,118
551,CHI,2019-11-01,112,,DET,W 112-106,240,39,89,.438,23,49,.469,16,40,.400,18,23,.783,112,41,85,.482,35,56,.625,6,29,.207,18,24,.750,106
552,MIA,2019-10-29,112,,ATL,W 112-97,240,33,73,.452,20,42,.476,13,31,.419,33,45,.733,112,35,83,.422,24,44,.545,11,39,.282,16,24,.667,97
553,SAC,2019-10-25,112,,POR,L 112-122,240,37,87,.425,22,50,.440,15,37,.405,23,27,.852,112,46,85,.541,35,55,.636,11,30,.367,19,22,.864,122
554,BOS,2019-10-25,112,,TOR,W 112-106,240,42,109,.385,29,71,.408,13,38,.342,15,16,.938,112,37,78,.474,19,42,.452,18,36,.500,14,17,.824,106
555,LAC,2019-10-22,112,,LAL,W 112-102,240,42,81,.519,31,50,.620,11,31,.355,17,24,.708,112,37,85,.435,24,52,.462,13,33,.394,15,21,.714,102
556,DEN,2020-08-12,111,,LAC,L 111-124,240,43,87,.494,30,52,.577,13,35,.371,12,19,.632,111,46,85,.541,32,48,.667,14,37,.378,18,23,.783,124
557,DAL,2020-08-06,111,,LAC,L 111-126,240,39,87,.448,22,39,.564,17,48,.354,16,21,.762,111,50,92,.543,36,61,.590,14,31,.452,12,15,.800,126
558,IND,2020-03-10,111,,BOS,L 111-114,240,46,93,.495,37,69,.536,9,24,.375,10,11,.909,111,41,93,.441,28,56,.500,13,37,.351,19,22,.864,114
559,POR,2020-03-07,111,,SAC,L 111-123,240,42,89,.472,32,50,.640,10,39,.256,17,26,.654,111,41,85,.482,20,46,.435,21,39,.538,20,23,.870,123
560,SAS,2020-03-02,111,,IND,L 111-116,240,40,77,.519,24,45,.533,16,32,.500,15,19,.789,111,39,78,.500,24,47,.511,15,31,.484,23,26,.885,116
561,PHO,2020-02-28,111,,DET,L 111-113,240,45,75,.600,36,52,.692,9,23,.391,12,17,.706,111,44,90,.489,31,58,.534,13,32,.406,12,16,.750,113
562,UTA,2020-02-24,111,,PHO,L 111-131,240,32,68,.471,22,42,.524,10,26,.385,37,43,.860,111,49,87,.563,37,67,.552,12,20,.600,21,24,.875,131
563,ATL,2020-02-22,111,,DAL,W 111-107,240,43,98,.439,35,61,.574,8,37,.216,17,26,.654,111,40,89,.449,26,45,.578,14,44,.318,13,19,.684,107
564,MEM,2020-02-12,111,,POR,W 111-104,240,45,95,.474,39,72,.542,6,23,.261,15,22,.682,111,36,97,.371,23,60,.383,13,37,.351,19,24,.792,104
565,OKC,2020-02-09,111,,BOS,L 111-112,240,39,86,.453,28,59,.475,11,27,.407,22,29,.759,111,38,84,.452,22,48,.458,16,36,.444,20,27,.741,112
566,LAL,2020-02-06,111,,HOU,L 111-121,240,45,91,.495,36,60,.600,9,31,.290,12,16,.750,111,43,85,.506,24,43,.558,19,42,.452,16,18,.889,121
567,CLE,2020-01-28,111,,NOP,L 111-125,240,42,97,.433,31,63,.492,11,34,.324,16,18,.889,111,47,88,.534,34,54,.630,13,34,.382,18,24,.750,125
568,DET,2020-01-25,111,,BRK,L 111-121 (OT),265,43,104,.413,30,69,.435,13,35,.371,12,18,.667,111,42,94,.447,27,52,.519,15,42,.357,22,25,.880,121
569,MIL,2020-01-20,111,,CHI,W 111-98,240,45,77,.584,34,51,.667,11,26,.423,10,23,.435,111,34,92,.370,20,44,.455,14,48,.292,16,18,.889,98
570,BRK,2020-01-20,111,,PHI,L 111-117,240,39,81,.481,28,52,.538,11,29,.379,22,34,.647,111,42,94,.447,29,55,.527,13,39,.333,20,27,.741,117
571,WAS,2020-01-10,111,,ATL,W 111-101,240,42,112,.375,32,83,.386,10,29,.345,17,28,.607,111,41,89,.461,34,60,.567,7,29,.241,12,24,.500,101
572,NYK,2020-01-10,111,,NOP,L 111-123,240,46,100,.460,41,73,.562,5,27,.185,14,20,.700,111,48,86,.558,30,48,.625,18,38,.474,9,17,.529,123
573,SAC,2020-01-06,111,,GSW,W 111-98,240,39,81,.481,24,51,.471,15,30,.500,18,23,.783,111,34,86,.395,29,60,.483,5,26,.192,25,32,.781,98
574,MIL,2019-12-28,111,,ORL,W 111-100,240,43,84,.512,30,47,.638,13,37,.351,12,18,.667,111,35,87,.402,21,52,.404,14,35,.400,16,19,.842,100
575,PHO,2019-12-23,111,,DEN,L 111-113,240,42,87,.483,29,50,.580,13,37,.351,14,18,.778,111,43,78,.551,28,50,.560,15,28,.536,12,15,.800,113
576,MIL,2019-12-19,111,,LAL,W 111-104,240,36,77,.468,20,38,.526,16,39,.410,23,32,.719,111,37,80,.463,25,45,.556,12,35,.343,18,23,.783,104
577,DEN,2019-12-15,111,,NYK,W 111-105,240,44,94,.468,34,66,.515,10,28,.357,13,19,.684,111,44,94,.468,36,62,.581,8,32,.250,9,10,.900,105
578,DET,2019-12-12,111,,DAL,L 111-122,240,40,89,.449,25,47,.532,15,42,.357,16,23,.696,111,45,88,.511,29,44,.659,16,44,.364,16,23,.696,122
579,MIL,2019-11-27,111,,ATL,W 111-102,240,42,88,.477,32,54,.593,10,34,.294,17,27,.630,111,38,94,.404,27,60,.450,11,34,.324,15,22,.682,102
580,IND,2019-11-23,111,,ORL,W 111-106,240,43,79,.544,33,55,.600,10,24,.417,15,16,.938,111,43,92,.467,30,61,.492,13,31,.419,7,9,.778,106
581,CHI,2019-11-16,111,,BRK,L 111-117,240,32,91,.352,23,52,.442,9,39,.231,38,41,.927,111,40,88,.455,30,45,.667,10,43,.233,27,31,.871,117
582,HOU,2019-11-15,111,,IND,W 111-102,240,36,89,.404,22,43,.512,14,46,.304,25,29,.862,111,37,82,.451,29,49,.592,8,33,.242,20,26,.769,102
583,ORL,2019-11-15,111,,SAS,W 111-109,240,36,87,.414,24,58,.414,12,29,.414,27,34,.794,111,45,89,.506,32,63,.508,13,26,.500,6,10,.600,109
584,IND,2019-11-12,111,,OKC,W 111-85,240,46,94,.489,39,71,.549,7,23,.304,12,13,.923,111,29,82,.354,23,57,.404,6,25,.240,21,24,.875,85
585,CLE,2019-11-03,111,,DAL,L 111-131,240,39,96,.406,21,48,.438,18,48,.375,15,22,.682,111,50,94,.532,30,53,.566,20,41,.488,11,13,.846,131
586,SAC,2019-10-30,111,,CHO,L 111-118,240,44,96,.458,30,50,.600,14,46,.304,9,12,.750,111,46,84,.548,30,52,.577,16,32,.500,10,14,.714,118
587,LAC,2019-10-28,111,,CHO,W 111-96,240,40,83,.482,28,50,.560,12,33,.364,19,21,.905,111,36,83,.434,22,44,.500,14,39,.359,10,14,.714,96
588,DET,2019-10-26,111,,PHI,L 111-117,240,41,76,.539,33,57,.579,8,19,.421,21,36,.583,111,42,87,.483,29,53,.547,13,34,.382,20,30,.667,117
589,HOU,2019-10-24,111,,MIL,L 111-117,240,33,90,.367,17,42,.405,16,48,.333,29,39,.744,111,46,99,.465,30,53,.566,16,46,.348,9,18,.500,117
590,SAC,2020-08-04,110,,DAL,L 110-114 (OT),265,43,104,.413,27,61,.443,16,43,.372,8,12,.667,110,33,90,.367,24,49,.490,9,41,.220,39,50,.780,114
591,POR,2020-08-04,110,,HOU,W 110-102,240,39,95,.411,27,64,.422,12,31,.387,20,29,.690,110,34,87,.391,15,34,.441,19,53,.358,15,24,.625,102
592,OKC,2020-08-01,110,,UTA,W 110-94,240,41,77,.532,31,51,.608,10,26,.385,18,24,.750,110,34,87,.391,26,56,.464,8,31,.258,18,22,.818,94
593,BRK,2020-03-08,110,,CHI,W 110-107,240,32,64,.500,21,34,.618,11,30,.367,35,41,.854,110,39,92,.424,27,58,.466,12,34,.353,17,25,.680,107
594,NOP,2020-03-06,110,,MIA,W 110-104,240,38,91,.418,24,53,.453,14,38,.368,20,28,.714,110,37,86,.430,28,53,.528,9,33,.273,21,31,.677,104
595,GSW,2020-03-01,110,,WAS,L 110-124,240,42,89,.472,33,61,.541,9,28,.321,17,24,.708,110,40,82,.488,20,52,.385,20,30,.667,24,27,.889,124
596,BOS,2020-02-29,110,,HOU,L 110-111 (OT),265,39,100,.390,26,58,.448,13,42,.310,19,25,.760,110,41,98,.418,26,43,.605,15,55,.273,14,18,.778,111
597,WAS,2020-02-26,110,,BRK,W 110-106,240,41,96,.427,26,57,.456,15,39,.385,13,16,.813,110,36,87,.414,26,51,.510,10,36,.278,24,35,.686,106
598,UTA,2020-02-22,110,,HOU,L 110-120,240,42,90,.467,35,59,.593,7,31,.226,19,24,.792,110,45,92,.489,25,44,.568,20,48,.417,10,14,.714,120
599,PHI,2020-02-11,110,,LAC,W 110-103,240,44,95,.463,36,68,.529,8,27,.296,14,21,.667,110,40,90,.444,26,59,.441,14,31,.452,9,13,.692,103
600,CHI,2020-01-27,110,,SAS,W 110-109,240,42,93,.452,28,56,.500,14,37,.378,12,15,.800,110,38,82,.463,28,57,.491,10,25,.400,23,34,.676,109
601,NYK,2020-01-26,110,,BRK,W 110-97,240,49,92,.533,43,73,.589,6,19,.316,6,13,.462,110,34,81,.420,21,42,.500,13,39,.333,16,23,.696,97
602,DET,2020-01-13,110,,NOP,L 110-117 (OT),265,40,99,.404,29,67,.433,11,32,.344,19,24,.792,110,43,103,.417,34,77,.442,9,26,.346,22,27,.815,117
603,OKC,2020-01-11,110,,LAL,L 110-125,240,43,92,.467,34,61,.557,9,31,.290,15,17,.882,110,51,99,.515,36,67,.537,15,32,.469,8,10,.800,125
604,CHO,2020-01-08,110,,TOR,L 110-112 (OT),265,38,86,.442,23,49,.469,15,37,.405,19,26,.731,110,42,94,.447,28,58,.483,14,36,.389,14,20,.700,112
605,SAC,2019-12-28,110,,PHO,L 110-112,240,41,84,.488,29,53,.547,12,31,.387,16,24,.667,110,45,86,.523,36,60,.600,9,26,.346,13,15,.867,112
606,TOR,2019-12-22,110,,DAL,W 110-107,240,37,94,.394,27,60,.450,10,34,.294,26,31,.839,110,35,90,.389,20,44,.455,15,46,.326,22,27,.815,107
607,CHO,2019-12-17,110,,SAC,W 110-102,240,39,81,.481,26,51,.510,13,30,.433,19,27,.704,110,38,91,.418,24,52,.462,14,39,.359,12,13,.923,102
608,PHO,2019-12-16,110,,POR,L 110-111,240,41,90,.456,29,56,.518,12,34,.353,16,19,.842,110,40,84,.476,26,50,.520,14,34,.412,17,20,.850,111
609,TOR,2019-12-14,110,,BRK,W 110-102,240,38,98,.388,24,58,.414,14,40,.350,20,25,.800,110,39,101,.386,27,55,.491,12,46,.261,12,17,.706,102
610,DEN,2019-12-14,110,,OKC,W 110-102,240,43,85,.506,36,58,.621,7,27,.259,17,23,.739,110,38,81,.469,32,58,.552,6,23,.261,20,23,.870,102
611,MIA,2019-12-13,110,,LAL,L 110-113,240,39,85,.459,29,52,.558,10,33,.303,22,28,.786,110,43,87,.494,31,50,.620,12,37,.324,15,23,.652,113
612,CLE,2019-12-11,110,,HOU,L 110-116,240,46,89,.517,33,57,.579,13,32,.406,5,8,.625,110,43,87,.494,26,45,.578,17,42,.405,13,13,1.000,116
613,MIL,2019-12-09,110,,ORL,W 110-101,240,43,92,.467,27,51,.529,16,41,.390,8,15,.533,110,35,92,.380,25,61,.410,10,31,.323,21,26,.808,101
614,BOS,2019-12-09,110,,CLE,W 110-88,240,45,78,.577,30,51,.588,15,27,.556,5,8,.625,110,36,91,.396,29,60,.483,7,31,.226,9,19,.474,88
615,PHI,2019-12-08,110,,TOR,W 110-104,240,40,79,.506,26,47,.553,14,32,.438,16,21,.762,110,38,88,.432,27,55,.491,11,33,.333,17,20,.850,104
616,MIA,2019-12-08,110,,CHI,W 110-105 (OT),265,32,77,.416,21,42,.500,11,35,.314,35,44,.795,110,35,80,.438,22,44,.500,13,36,.361,22,27,.815,105
617,TOR,2019-12-03,110,,MIA,L 110-121 (OT),265,35,91,.385,24,48,.500,11,43,.256,29,36,.806,110,45,99,.455,30,61,.492,15,38,.395,16,21,.762,121
618,CLE,2019-11-29,110,,MIL,L 110-119,240,44,88,.500,27,54,.500,17,34,.500,5,10,.500,110,45,88,.511,33,54,.611,12,34,.353,17,23,.739,119
619,NOP,2019-11-27,110,,LAL,L 110-114,240,34,84,.405,17,44,.386,17,40,.425,25,30,.833,110,44,85,.518,36,61,.590,8,24,.333,18,25,.720,114
620,CLE,2019-11-23,110,,POR,W 110-104,240,37,87,.425,27,56,.482,10,31,.323,26,32,.813,110,39,87,.448,25,47,.532,14,40,.350,12,16,.750,104
621,DAL,2019-11-16,110,,TOR,W 110-102,240,37,88,.420,28,49,.571,9,39,.231,27,33,.818,110,37,89,.416,20,48,.417,17,41,.415,11,15,.733,102
622,CHO,2019-11-09,110,,NOP,L 110-115,240,36,88,.409,24,53,.453,12,35,.343,26,34,.765,110,40,75,.533,26,42,.619,14,33,.424,21,30,.700,115
623,DAL,2019-11-01,110,,LAL,L 110-119 (OT),265,40,102,.392,26,66,.394,14,36,.389,16,23,.696,110,47,96,.490,38,64,.594,9,32,.281,16,21,.762,119
624,GSW,2019-11-01,110,,SAS,L 110-127,240,39,84,.464,26,56,.464,13,28,.464,19,21,.905,110,44,93,.473,31,58,.534,13,35,.371,26,30,.867,127
625,UTA,2019-10-30,110,,LAC,W 110-96,240,44,80,.550,33,56,.589,11,24,.458,11,16,.688,110,39,82,.476,31,59,.525,8,23,.348,10,12,.833,96
626,GSW,2019-10-30,110,,PHO,L 110-121,240,36,82,.439,28,54,.519,8,28,.286,30,36,.833,110,44,96,.458,29,60,.483,15,36,.417,18,21,.857,121
627,CLE,2019-10-26,110,,IND,W 110-99,240,40,80,.500,29,49,.592,11,31,.355,19,29,.655,110,39,87,.448,29,59,.492,10,28,.357,11,13,.846,99
628,IND,2019-10-23,110,,DET,L 110-119,240,41,89,.461,33,68,.485,8,21,.381,20,24,.833,110,41,78,.526,30,54,.556,11,24,.458,26,33,.788,119
629,IND,2020-08-14,109,,MIA,W 109-92,240,43,89,.483,28,51,.549,15,38,.395,8,11,.727,109,31,87,.356,21,49,.429,10,38,.263,20,27,.741,92
630,NOP,2020-08-03,109,,MEM,W 109-99,240,37,82,.451,26,53,.491,11,29,.379,24,39,.615,109,37,93,.398,25,50,.500,12,43,.279,13,15,.867,99
631,DEN,2020-03-09,109,,MIL,W 109-95,240,41,94,.436,25,53,.472,16,41,.390,11,12,.917,109,34,90,.378,19,40,.475,15,50,.300,12,18,.667,95
632,DAL,2020-03-08,109,,IND,L 109-112,240,39,91,.429,25,48,.521,14,43,.326,17,25,.680,109,46,88,.523,38,65,.585,8,23,.348,12,18,.667,112
633,CHI,2020-03-02,109,,DAL,W 109-107,240,44,94,.468,34,58,.586,10,36,.278,11,17,.647,109,40,84,.476,28,42,.667,12,42,.286,15,20,.750,107
634,OKC,2020-02-05,109,,CLE,W 109-103,240,38,81,.469,29,55,.527,9,26,.346,24,30,.800,109,41,89,.461,26,51,.510,15,38,.395,6,11,.545,103
635,CLE,2020-01-30,109,,TOR,L 109-115,240,42,90,.467,29,54,.537,13,36,.361,12,14,.857,109,41,84,.488,29,52,.558,12,32,.375,21,28,.750,115
636,GSW,2020-01-18,109,,ORL,W 109-95,240,43,94,.457,31,54,.574,12,40,.300,11,11,1.000,109,39,86,.453,30,55,.545,9,31,.290,8,13,.615,95
637,DAL,2020-01-11,109,,PHI,W 109-91,240,40,79,.506,29,52,.558,11,27,.407,18,27,.667,109,37,98,.378,28,61,.459,9,37,.243,8,12,.667,91
638,UTA,2020-01-10,109,,CHO,W 109-92,240,40,79,.506,22,37,.595,18,42,.429,11,14,.786,109,35,75,.467,27,49,.551,8,26,.308,14,19,.737,92
639,LAC,2020-01-10,109,,GSW,W 109-100,240,41,84,.488,30,45,.667,11,39,.282,16,22,.727,109,37,96,.385,29,57,.509,8,39,.205,18,25,.720,100
640,PHI,2020-01-09,109,,BOS,W 109-98,240,43,88,.489,32,61,.525,11,27,.407,12,17,.706,109,38,88,.432,24,52,.462,14,36,.389,8,8,1.000,98
641,BOS,2020-01-03,109,,ATL,W 109-106,240,41,93,.441,35,68,.515,6,25,.240,21,29,.724,109,39,93,.419,23,48,.479,16,45,.356,12,15,.800,106
642,DET,2019-12-23,109,,PHI,L 109-125,240,43,84,.512,33,54,.611,10,30,.333,13,18,.722,109,52,95,.547,40,65,.615,12,30,.400,9,11,.818,125
643,SAS,2019-12-21,109,,LAC,L 109-134,240,42,82,.512,32,54,.593,10,28,.357,15,19,.789,109,54,99,.545,42,63,.667,12,36,.333,14,19,.737,134
644,DEN,2019-12-20,109,,MIN,W 109-100,240,44,89,.494,34,61,.557,10,28,.357,11,12,.917,109,36,87,.414,26,45,.578,10,42,.238,18,27,.667,100
645,WAS,2019-12-18,109,,CHI,L 109-110 (OT),265,34,95,.358,20,50,.400,14,45,.311,27,32,.844,109,39,97,.402,28,60,.467,11,37,.297,21,24,.875,110
646,UTA,2019-12-17,109,,ORL,W 109-102,240,42,90,.467,27,54,.500,15,36,.417,10,16,.625,109,42,93,.452,35,58,.603,7,35,.200,11,15,.733,102
647,HOU,2019-12-16,109,,SAS,W 109-107,240,40,98,.408,29,55,.527,11,43,.256,18,27,.667,109,39,91,.429,27,58,.466,12,33,.364,17,20,.850,107
648,OKC,2019-12-16,109,,CHI,W 109-106,240,35,69,.507,19,35,.543,16,34,.471,23,28,.821,109,43,87,.494,34,56,.607,9,31,.290,11,13,.846,106
649,BRK,2019-12-15,109,,PHI,W 109-89,240,43,94,.457,34,70,.486,9,24,.375,14,18,.778,109,37,86,.430,32,60,.533,5,26,.192,10,17,.588,89
650,CHI,2019-12-14,109,,LAC,W 109-106,240,40,85,.471,26,54,.481,14,31,.452,15,18,.833,109,35,80,.438,25,58,.431,10,22,.455,26,36,.722,106
651,BOS,2019-12-12,109,,PHI,L 109-115,240,42,91,.462,31,60,.517,11,31,.355,14,17,.824,109,41,82,.500,27,54,.500,14,28,.500,19,23,.826,115
652,SAS,2019-12-12,109,,CLE,L 109-117 (OT),265,42,86,.488,37,70,.529,5,16,.313,20,25,.800,109,44,96,.458,29,51,.569,15,45,.333,14,20,.700,117
653,TOR,2019-12-05,109,,HOU,L 109-119,240,38,88,.432,26,49,.531,12,39,.308,21,24,.875,109,40,98,.408,18,43,.419,22,55,.400,17,19,.895,119
654,OKC,2019-11-29,109,,NOP,W 109-104,240,43,90,.478,30,56,.536,13,34,.382,10,16,.625,109,39,87,.448,28,49,.571,11,38,.289,15,21,.714,104
655,CHI,2019-11-20,109,,DET,W 109-89,240,39,91,.429,25,64,.391,14,27,.519,17,26,.654,109,28,83,.337,20,50,.400,8,33,.242,25,32,.781,89
656,PHI,2019-11-20,109,,NYK,W 109-104,240,39,89,.438,26,57,.456,13,32,.406,18,26,.692,109,40,84,.476,27,59,.458,13,25,.520,11,15,.733,104
657,MIA,2019-11-16,109,,NOP,W 109-94,240,44,81,.543,35,57,.614,9,24,.375,12,13,.923,109,37,82,.451,21,47,.447,16,35,.457,4,6,.667,94
658,CHO,2019-11-15,109,,DET,W 109-106,240,43,96,.448,30,61,.492,13,35,.371,10,16,.625,109,40,81,.494,25,46,.543,15,35,.429,11,11,1.000,106
659,SAS,2019-11-11,109,,MEM,L 109-113,240,42,90,.467,30,60,.500,12,30,.400,13,17,.765,109,44,87,.506,33,59,.559,11,28,.393,14,20,.700,113
660,ATL,2019-11-08,109,,SAC,L 109-121,240,46,87,.529,37,59,.627,9,28,.321,8,14,.571,109,42,76,.553,24,45,.533,18,31,.581,19,22,.864,121
661,DEN,2019-11-05,109,,MIA,W 109-89,240,45,86,.523,36,63,.571,9,23,.391,10,16,.625,109,32,88,.364,23,59,.390,9,29,.310,16,25,.640,89
662,WAS,2019-11-02,109,,MIN,L 109-131,240,37,95,.389,25,60,.417,12,35,.343,23,27,.852,109,51,94,.543,34,55,.618,17,39,.436,12,17,.706,131
663,TOR,2020-08-09,108,,MEM,W 108-99,240,34,71,.479,19,32,.594,15,39,.385,25,33,.758,108,37,91,.407,23,49,.469,14,42,.333,11,16,.688,99
664,PHI,2020-08-07,108,,ORL,W 108-101,240,38,93,.409,30,64,.469,8,29,.276,24,33,.727,108,37,88,.420,29,56,.518,8,32,.250,19,25,.760,101
665,UTA,2020-08-03,108,,LAL,L 108-116,240,37,83,.446,25,40,.625,12,43,.279,22,25,.880,108,41,82,.500,32,56,.571,9,26,.346,25,31,.806,116
666,CHI,2020-03-10,108,,CLE,W 108-103,240,42,84,.500,30,50,.600,12,34,.353,12,15,.800,108,40,80,.500,34,56,.607,6,24,.250,17,23,.739,103
667,CHO,2020-03-07,108,,HOU,W 108-99,240,37,70,.529,22,38,.579,15,32,.469,19,25,.760,108,35,76,.461,20,31,.645,15,45,.333,14,20,.700,99
668,SAC,2020-03-05,108,,PHI,L 108-125,240,42,79,.532,31,50,.620,11,29,.379,13,18,.722,108,47,96,.490,30,59,.508,17,37,.459,14,17,.824,125
669,CLE,2020-02-26,108,,PHI,W 108-94,240,41,78,.526,30,54,.556,11,24,.458,15,17,.882,108,36,89,.404,23,51,.451,13,38,.342,9,14,.643,94
670,WAS,2020-02-21,108,,CLE,L 108-113,240,41,106,.387,32,69,.464,9,37,.243,17,23,.739,108,43,81,.531,32,54,.593,11,27,.407,16,25,.640,113
671,MIN,2020-02-12,108,,CHO,L 108-115,240,39,101,.386,25,52,.481,14,49,.286,16,20,.800,108,43,92,.467,29,58,.500,14,34,.412,15,23,.652,115
672,PHO,2020-02-08,108,,DEN,L 108-117,240,38,87,.437,29,55,.527,9,32,.281,23,23,1.000,108,45,82,.549,34,54,.630,11,28,.393,16,21,.762,117
673,OKC,2020-02-07,108,,DET,W 108-101,240,39,76,.513,34,53,.642,5,23,.217,25,30,.833,108,38,89,.427,27,51,.529,11,38,.289,14,19,.737,101
674,NOP,2020-02-04,108,,MIL,L 108-120,240,38,99,.384,24,50,.480,14,49,.286,18,24,.750,108,48,102,.471,37,66,.561,11,36,.306,13,17,.765,120
675,LAC,2020-02-03,108,,SAS,W 108-105,240,39,84,.464,28,57,.491,11,27,.407,19,24,.792,108,40,95,.421,28,58,.483,12,37,.324,13,16,.813,105
676,PHI,2020-01-25,108,,LAL,W 108-91,240,41,78,.526,28,41,.683,13,37,.351,13,19,.684,108,35,76,.461,29,45,.644,6,31,.194,15,23,.652,91
677,OKC,2020-01-17,108,,MIA,L 108-115,240,37,84,.440,19,38,.500,18,46,.391,16,18,.889,108,41,84,.488,27,48,.563,14,36,.389,19,24,.792,115
678,BRK,2020-01-12,108,,ATL,W 108-86,240,41,77,.532,31,51,.608,10,26,.385,16,29,.552,108,32,97,.330,20,49,.408,12,48,.250,10,11,.909,86
679,IND,2020-01-08,108,,MIA,L 108-122,240,40,84,.476,31,57,.544,9,27,.333,19,25,.760,108,43,81,.531,27,43,.628,16,38,.421,20,25,.800,122
680,LAL,2019-12-29,108,,DAL,W 108-95,240,38,78,.487,29,55,.527,9,23,.391,23,28,.821,108,32,89,.360,19,46,.413,13,43,.302,18,20,.900,95
681,HOU,2019-12-28,108,,BRK,W 108-98,240,44,101,.436,31,59,.525,13,42,.310,7,16,.438,108,37,92,.402,26,53,.491,11,39,.282,13,21,.619,98
682,BRK,2019-12-11,108,,CHO,L 108-113,240,38,88,.432,28,50,.560,10,38,.263,22,33,.667,108,36,88,.409,21,53,.396,15,35,.429,26,32,.813,113
683,PHO,2019-12-11,108,,MEM,L 108-115,240,37,93,.398,28,59,.475,9,34,.265,25,30,.833,108,42,87,.483,32,63,.508,10,24,.417,21,26,.808,115
684,DET,2019-12-06,108,,IND,W 108-101,240,39,87,.448,28,62,.452,11,25,.440,19,26,.731,108,38,83,.458,29,59,.492,9,24,.375,16,20,.800,101
685,BOS,2019-12-06,108,,DEN,W 108-95,240,44,82,.537,31,47,.660,13,35,.371,7,8,.875,108,39,94,.415,34,64,.531,5,30,.167,12,15,.800,95
686,MEM,2019-11-23,108,,LAL,L 108-109,240,43,89,.483,29,59,.492,14,30,.467,8,13,.615,108,38,84,.452,25,45,.556,13,39,.333,20,29,.690,109
687,CHI,2019-11-22,108,,MIA,L 108-116,240,41,90,.456,31,60,.517,10,30,.333,16,20,.800,108,39,79,.494,25,41,.610,14,38,.368,24,28,.857,116
688,NOP,2019-11-17,108,,GSW,W 108-100,240,37,89,.416,19,43,.442,18,46,.391,16,20,.800,108,37,91,.407,30,66,.455,7,25,.280,19,23,.826,100
689,GSW,2019-11-11,108,,UTA,L 108-122,240,45,94,.479,35,63,.556,10,31,.323,8,14,.571,108,40,81,.494,24,46,.522,16,35,.457,26,32,.813,122
690,PHO,2019-11-07,108,,MIA,L 108-124,240,37,84,.440,26,52,.500,11,32,.344,23,31,.742,108,45,82,.549,30,54,.556,15,28,.536,19,24,.792,124
691,ATL,2019-11-05,108,,SAS,W 108-100,240,43,90,.478,32,60,.533,11,30,.367,11,16,.688,108,38,91,.418,30,58,.517,8,33,.242,16,23,.696,100
692,IND,2019-11-03,108,,CHI,W 108-95,240,40,85,.471,32,59,.542,8,26,.308,20,27,.741,108,36,84,.429,27,55,.491,9,29,.310,14,25,.560,95
693,BRK,2019-10-30,108,,IND,L 108-118,240,41,93,.441,31,62,.500,10,31,.323,16,26,.615,108,45,96,.469,34,70,.486,11,26,.423,17,20,.850,118
694,DEN,2019-10-25,108,,PHO,W 108-107 (OT),265,36,92,.391,29,65,.446,7,27,.259,29,36,.806,108,34,86,.395,26,58,.448,8,28,.286,31,32,.969,107
695,DAL,2019-10-23,108,,WAS,W 108-100,240,35,76,.461,24,40,.600,11,36,.306,27,33,.818,108,37,93,.398,26,52,.500,11,41,.268,15,18,.833,100
696,LAC,2020-08-14,107,,OKC,W 107-103 (OT),265,34,85,.400,22,48,.458,12,37,.324,27,39,.692,107,38,106,.358,24,62,.387,14,44,.318,13,22,.591,103
697,MEM,2020-08-11,107,,BOS,L 107-122,240,35,89,.393,28,60,.467,7,29,.241,30,38,.789,107,44,86,.512,28,49,.571,16,37,.432,18,23,.783,122
698,TOR,2020-08-01,107,,LAL,W 107-92,240,35,84,.417,21,50,.420,14,34,.412,23,26,.885,107,29,82,.354,19,42,.452,10,40,.250,24,33,.727,92
699,GSW,2020-03-10,107,,LAC,L 107-131,240,37,79,.468,26,41,.634,11,38,.289,22,27,.815,107,46,92,.500,26,48,.542,20,44,.455,19,19,1.000,131
700,MIN,2020-03-08,107,,NOP,L 107-120,240,37,94,.394,29,61,.475,8,33,.242,25,31,.806,107,44,90,.489,33,55,.600,11,35,.314,21,31,.677,120
701,DET,2020-03-04,107,,OKC,L 107-114,240,40,86,.465,22,43,.512,18,43,.419,9,15,.600,107,46,75,.613,36,51,.706,10,24,.417,12,17,.706,114
702,ORL,2020-03-02,107,,POR,L 107-130,240,37,96,.385,23,53,.434,14,43,.326,19,22,.864,107,49,88,.557,33,55,.600,16,33,.485,16,16,1.000,130
703,CHO,2020-02-26,107,,NYK,W 107-101,240,39,83,.470,29,53,.547,10,30,.333,19,25,.760,107,43,85,.506,39,70,.557,4,15,.267,11,17,.647,101
704,POR,2020-02-23,107,,DET,W 107-104,240,41,84,.488,28,54,.519,13,30,.433,12,19,.632,107,37,86,.430,26,51,.510,11,35,.314,19,20,.950,104
705,DAL,2020-02-05,107,,MEM,L 107-121,240,34,94,.362,17,51,.333,17,43,.395,22,24,.917,107,47,89,.528,35,64,.547,12,25,.480,15,20,.750,121
706,PHO,2020-01-31,107,,OKC,L 107-111,240,36,76,.474,27,52,.519,9,24,.375,26,29,.897,107,42,97,.433,35,66,.530,7,31,.226,20,22,.909,111
707,TOR,2020-01-22,107,,PHI,W 107-95,240,40,86,.465,27,53,.509,13,33,.394,14,21,.667,107,32,84,.381,14,38,.368,18,46,.391,13,18,.722,95
708,DAL,2020-01-21,107,,LAC,L 107-110,240,39,91,.429,27,48,.563,12,43,.279,17,24,.708,107,36,97,.371,24,59,.407,12,38,.316,26,33,.788,110
709,HOU,2020-01-20,107,,OKC,L 107-112,240,43,97,.443,34,52,.654,9,45,.200,12,17,.706,107,40,92,.435,28,60,.467,12,32,.375,20,26,.769,112
710,DEN,2020-01-19,107,,IND,L 107-115,240,41,88,.466,38,65,.585,3,23,.130,22,32,.688,107,43,86,.500,30,57,.526,13,29,.448,16,19,.842,115
711,SAS,2020-01-19,107,,MIA,W 107-102,240,36,85,.424,24,52,.462,12,33,.364,23,24,.958,107,37,86,.430,27,52,.519,10,34,.294,18,20,.900,102
712,HOU,2020-01-15,107,,POR,L 107-117,240,38,96,.396,22,47,.468,16,49,.327,15,23,.652,107,41,95,.432,30,59,.508,11,36,.306,24,29,.828,117
713,BRK,2020-01-14,107,,UTA,L 107-118,240,45,90,.500,37,64,.578,8,26,.308,9,15,.600,107,46,92,.500,33,56,.589,13,36,.361,13,15,.867,118
714,LAC,2019-12-28,107,,UTA,L 107-120,240,35,95,.368,23,55,.418,12,40,.300,25,27,.926,107,45,86,.523,28,51,.549,17,35,.486,13,17,.765,120
715,MIA,2019-12-23,107,,UTA,W 107-104,240,37,90,.411,28,65,.431,9,25,.360,24,27,.889,107,39,90,.433,27,54,.500,12,36,.333,14,18,.778,104
716,DET,2019-12-21,107,,CHI,L 107-119,240,40,87,.460,24,52,.462,16,35,.457,11,12,.917,107,40,77,.519,22,42,.524,18,35,.514,21,25,.840,119
717,CHO,2019-12-21,107,,UTA,L 107-114,240,39,85,.459,27,56,.482,12,29,.414,17,22,.773,107,39,75,.520,22,41,.537,17,34,.500,19,20,.950,114
718,IND,2019-12-15,107,,CHO,W 107-85,240,40,88,.455,30,53,.566,10,35,.286,17,20,.850,107,28,91,.308,23,59,.390,5,32,.156,24,35,.686,85
719,HOU,2019-12-14,107,,DET,L 107-115,240,41,102,.402,28,57,.491,13,45,.289,12,18,.667,107,41,92,.446,29,55,.527,12,37,.324,21,25,.840,115
720,ORL,2019-12-13,107,,HOU,L 107-130,240,40,91,.440,25,54,.463,15,37,.405,12,16,.750,107,48,86,.558,26,47,.553,22,39,.564,12,13,.923,130
721,CHO,2019-12-08,107,,ATL,L 107-122,240,36,90,.400,25,59,.424,11,31,.355,24,29,.828,107,44,91,.484,26,46,.565,18,45,.400,16,17,.941,122
722,MIN,2019-12-01,107,,MEM,L 107-115,240,33,85,.388,22,49,.449,11,36,.306,30,35,.857,107,41,100,.410,25,60,.417,16,40,.400,17,21,.810,115
723,DET,2019-11-29,107,,CHO,L 107-110,240,41,83,.494,26,48,.542,15,35,.429,10,20,.500,107,40,83,.482,21,45,.467,19,38,.500,11,15,.733,110
724,POR,2019-11-29,107,,CHI,W 107-103,240,38,84,.452,28,54,.519,10,30,.333,21,28,.750,107,36,94,.383,22,56,.393,14,38,.368,17,25,.680,103
725,SAS,2019-11-29,107,,LAC,W 107-97,240,40,93,.430,26,57,.456,14,36,.389,13,14,.929,107,36,92,.391,24,59,.407,12,33,.364,13,13,1.000,97
726,LAC,2019-11-20,107,,BOS,W 107-104 (OT),265,39,93,.419,22,48,.458,17,45,.378,12,16,.750,107,41,104,.394,29,59,.492,12,45,.267,10,14,.714,104
727,MEM,2019-11-15,107,,UTA,W 107-106,240,43,96,.448,33,61,.541,10,35,.286,11,13,.846,107,35,87,.402,26,53,.491,9,34,.265,27,32,.844,106
728,SAC,2019-11-12,107,,POR,W 107-99,240,38,86,.442,27,54,.500,11,32,.344,20,26,.769,107,34,77,.442,26,47,.553,8,30,.267,23,30,.767,99
729,LAC,2019-11-07,107,,POR,W 107-101,240,39,89,.438,35,66,.530,4,23,.174,25,30,.833,107,39,104,.375,28,65,.431,11,39,.282,12,16,.750,101
730,DAL,2019-11-06,107,,ORL,W 107-106,240,36,84,.429,25,53,.472,11,31,.355,24,30,.800,107,39,80,.488,33,56,.589,6,24,.250,22,28,.786,106
731,PHI,2019-10-23,107,,BOS,W 107-93,240,37,85,.435,30,56,.536,7,29,.241,26,36,.722,107,33,90,.367,26,64,.406,7,26,.269,20,34,.588,93
732,MIL,2020-08-10,106,,TOR,L 106-114,240,33,84,.393,19,41,.463,14,43,.326,26,35,.743,106,42,97,.433,30,57,.526,12,40,.300,18,26,.692,114
733,MEM,2020-08-02,106,,SAS,L 106-108,240,42,91,.462,35,61,.574,7,30,.233,15,18,.833,106,36,86,.419,24,57,.421,12,29,.414,24,33,.727,108
734,HOU,2020-03-08,106,,ORL,L 106-126,240,39,88,.443,30,56,.536,9,32,.281,19,25,.760,106,44,91,.484,31,62,.500,13,29,.448,25,31,.806,126
735,CLE,2020-03-04,106,,BOS,L 106-112,240,39,89,.438,26,51,.510,13,38,.342,15,20,.750,106,40,86,.465,29,56,.518,11,30,.367,21,26,.808,112
736,SAC,2020-03-01,106,,DET,W 106-100,240,37,91,.407,28,56,.500,9,35,.257,23,26,.885,106,33,80,.413,15,38,.395,18,42,.429,16,24,.667,100
737,IND,2020-02-27,106,,POR,W 106-100,240,40,90,.444,32,65,.492,8,25,.320,18,23,.783,106,41,89,.461,32,59,.542,9,30,.300,9,14,.643,100
738,POR,2020-02-25,106,,BOS,L 106-118,240,38,85,.447,25,54,.463,13,31,.419,17,23,.739,106,43,90,.478,24,51,.471,19,39,.487,13,14,.929,118
739,ORL,2020-02-21,106,,DAL,L 106-122,240,41,104,.394,32,61,.525,9,43,.209,15,19,.789,106,43,84,.512,28,46,.609,15,38,.395,21,26,.808,122
740,DET,2020-02-20,106,,MIL,L 106-126,240,40,83,.482,27,46,.587,13,37,.351,13,16,.813,106,47,93,.505,37,60,.617,10,33,.303,22,27,.815,126
741,OKC,2020-02-11,106,,SAS,L 106-114,240,39,85,.459,28,54,.519,11,31,.355,17,21,.810,106,41,84,.488,34,59,.576,7,25,.280,25,27,.926,114
742,IND,2020-02-07,106,,TOR,L 106-115,240,39,86,.453,29,52,.558,10,34,.294,18,22,.818,106,42,88,.477,25,50,.500,17,38,.447,14,17,.824,115
743,DEN,2020-01-30,106,,UTA,W 106-100,240,40,85,.471,31,58,.534,9,27,.333,17,21,.810,106,36,78,.462,19,41,.463,17,37,.459,11,17,.647,100
744,NYK,2020-01-29,106,,MEM,L 106-127,240,39,91,.429,30,63,.476,9,28,.321,19,29,.655,106,43,86,.500,30,58,.517,13,28,.464,28,33,.848,127
745,SAS,2020-01-26,106,,TOR,L 106-110,240,34,82,.415,18,45,.400,16,37,.432,22,24,.917,106,41,99,.414,25,49,.510,16,50,.320,12,15,.800,110
746,CLE,2020-01-25,106,,CHI,L 106-118,240,42,84,.500,29,54,.537,13,30,.433,9,11,.818,106,44,85,.518,32,52,.615,12,33,.364,18,24,.750,118
747,NOP,2020-01-24,106,,DEN,L 106-113,240,38,82,.463,26,55,.473,12,27,.444,18,30,.600,106,40,106,.377,27,65,.415,13,41,.317,20,20,1.000,113
748,WAS,2020-01-20,106,,DET,W 106-100,240,42,82,.512,33,58,.569,9,24,.375,13,16,.813,106,38,89,.427,28,57,.491,10,32,.313,14,20,.700,100
749,MIA,2020-01-15,106,,SAS,W 106-100,240,41,88,.466,24,48,.500,17,40,.425,7,13,.538,106,39,89,.438,29,56,.518,10,33,.303,12,15,.800,100
750,SAC,2020-01-10,106,,MIL,L 106-127,240,44,96,.458,34,61,.557,10,35,.286,8,10,.800,106,47,95,.495,37,56,.661,10,39,.256,23,30,.767,127
751,DAL,2020-01-08,106,,DEN,L 106-107,240,39,77,.506,27,42,.643,12,35,.343,16,24,.667,106,41,85,.482,32,61,.525,9,24,.375,16,20,.800,107
752,LAL,2020-01-05,106,,DET,W 106-99,240,42,92,.457,36,72,.500,6,20,.300,16,23,.696,106,29,78,.372,18,52,.346,11,26,.423,30,35,.857,99
753,CLE,2020-01-04,106,,OKC,L 106-121,240,39,85,.459,25,55,.455,14,30,.467,14,17,.824,106,43,96,.448,29,59,.492,14,37,.378,21,26,.808,121
754,CLE,2020-01-02,106,,CHO,L 106-109,240,41,81,.506,28,46,.609,13,35,.371,11,14,.786,106,37,83,.446,22,45,.489,15,38,.395,20,24,.833,109
755,MIL,2020-01-01,106,,MIN,W 106-104,240,40,94,.426,31,58,.534,9,36,.250,17,26,.654,106,34,91,.374,19,45,.422,15,46,.326,21,28,.750,104
756,OKC,2019-12-31,106,,DAL,W 106-101,240,39,91,.429,33,64,.516,6,27,.222,22,28,.786,106,33,93,.355,18,42,.429,15,51,.294,20,27,.741,101
757,LAL,2019-12-25,106,,LAC,L 106-111,240,39,96,.406,27,51,.529,12,45,.267,16,21,.762,106,39,85,.459,30,60,.500,9,25,.360,24,32,.750,111
758,GSW,2019-12-20,106,,NOP,W 106-102,240,36,83,.434,26,50,.520,10,33,.303,24,25,.960,106,39,93,.419,30,59,.508,9,34,.265,15,23,.652,102
759,ATL,2019-12-19,106,,UTA,L 106-111,240,39,90,.433,28,61,.459,11,29,.379,17,19,.895,106,39,83,.470,33,59,.559,6,24,.250,27,38,.711,111
760,DAL,2019-12-08,106,,SAC,L 106-110,240,41,86,.477,24,42,.571,17,44,.386,7,8,.875,106,44,85,.518,31,51,.608,13,34,.382,9,11,.818,110
761,CHI,2019-12-04,106,,MEM,W 106-99,240,33,77,.429,20,44,.455,13,33,.394,27,37,.730,106,37,96,.385,30,66,.455,7,30,.233,18,21,.857,99
762,CHO,2019-12-04,106,,GSW,W 106-91,240,40,87,.460,19,39,.487,21,48,.438,5,8,.625,106,36,78,.462,27,55,.491,9,23,.391,10,15,.667,91
763,SAC,2019-12-02,106,,CHI,L 106-113,240,40,83,.482,31,50,.620,9,33,.273,17,20,.850,106,36,75,.480,20,38,.526,16,37,.432,25,29,.862,113
764,BRK,2019-12-01,106,,MIA,L 106-109,240,40,91,.440,26,49,.531,14,42,.333,12,16,.750,106,37,95,.389,25,58,.431,12,37,.324,23,28,.821,109
765,CLE,2019-11-25,106,,BRK,L 106-108,240,40,94,.426,27,62,.435,13,32,.406,13,20,.650,106,44,94,.468,33,60,.550,11,34,.324,9,11,.818,108
766,WAS,2019-11-24,106,,SAC,L 106-113,240,42,92,.457,29,58,.500,13,34,.382,9,12,.750,106,39,81,.481,28,50,.560,11,31,.355,24,28,.857,113
767,NYK,2019-11-14,106,,DAL,W 106-103,240,42,94,.447,29,64,.453,13,30,.433,9,11,.818,106,36,84,.429,28,48,.583,8,36,.222,23,31,.742,103
768,POR,2019-11-13,106,,TOR,L 106-114,240,38,96,.396,21,48,.438,17,48,.354,13,16,.813,106,42,92,.457,28,60,.467,14,32,.438,16,17,.941,114
769,UTA,2019-11-06,106,,PHI,W 106-104,240,41,89,.461,33,67,.493,8,22,.364,16,24,.667,106,33,80,.413,25,55,.455,8,25,.320,30,34,.882,104
770,MIN,2019-11-04,106,,MIL,L 106-134,240,37,103,.359,24,60,.400,13,43,.302,19,22,.864,106,50,93,.538,36,54,.667,14,39,.359,20,30,.667,134
771,DEN,2019-10-29,106,,DAL,L 106-109,240,43,91,.473,32,59,.542,11,32,.344,9,13,.692,106,41,84,.488,28,47,.596,13,37,.351,14,24,.583,109
772,DEN,2020-08-01,105,,MIA,L 105-125,240,39,89,.438,31,54,.574,8,35,.229,19,24,.792,105,40,72,.556,27,43,.628,13,29,.448,32,37,.865,125
773,DET,2020-03-07,105,,UTA,L 105-111,240,40,86,.465,31,56,.554,9,30,.300,16,22,.727,105,40,77,.519,30,44,.682,10,33,.303,21,28,.750,111
774,HOU,2020-03-05,105,,LAC,L 105-120,240,35,97,.361,28,55,.509,7,42,.167,28,36,.778,105,39,84,.464,26,44,.591,13,40,.325,29,39,.744,120
775,MIA,2020-03-02,105,,MIL,W 105-89,240,37,86,.430,19,49,.388,18,37,.486,13,18,.722,105,35,86,.407,28,52,.538,7,34,.206,12,19,.632,89
776,MEM,2020-02-29,105,,LAL,W 105-88,240,43,95,.453,33,64,.516,10,31,.323,9,11,.818,105,36,87,.414,27,52,.519,9,35,.257,7,12,.583,88
777,GSW,2020-02-20,105,,HOU,L 105-135,240,44,89,.494,37,56,.661,7,33,.212,10,12,.833,105,45,85,.529,20,36,.556,25,49,.510,20,22,.909,135
778,IND,2020-02-10,105,,BRK,L 105-106,240,45,92,.489,38,62,.613,7,30,.233,8,11,.727,105,35,87,.402,23,50,.460,12,37,.324,24,32,.750,106
779,SAC,2020-02-07,105,,MIA,W 105-97,240,40,82,.488,21,38,.553,19,44,.432,6,12,.500,105,34,77,.442,22,37,.595,12,40,.300,17,25,.680,97
780,NYK,2020-02-06,105,,ORL,W 105-103,240,43,92,.467,37,72,.514,6,20,.300,13,19,.684,105,34,75,.453,25,44,.568,9,31,.290,26,30,.867,103
781,CHI,2020-01-10,105,,IND,L 105-116,240,37,80,.463,19,39,.487,18,41,.439,13,16,.813,105,48,84,.571,37,54,.685,11,30,.367,9,14,.643,116
782,ORL,2020-01-03,105,,MIA,W 105-85,240,33,81,.407,20,46,.435,13,35,.371,26,29,.897,105,30,80,.375,23,43,.535,7,37,.189,18,23,.783,85
783,GSW,2019-12-27,105,,PHO,W 105-96,240,38,92,.413,29,65,.446,9,27,.333,20,25,.800,105,35,75,.467,28,42,.667,7,33,.212,19,24,.792,96
784,IND,2019-12-17,105,,LAL,W 105-102,240,41,85,.482,31,60,.517,10,25,.400,13,20,.650,105,43,91,.473,35,60,.583,8,31,.258,8,17,.471,102
785,BRK,2019-12-08,105,,DEN,W 105-102,240,40,87,.460,33,59,.559,7,28,.250,18,23,.783,105,36,89,.404,18,47,.383,18,42,.429,12,14,.857,102
786,SAS,2019-12-06,105,,SAC,W 105-104 (OT),265,41,96,.427,30,64,.469,11,32,.344,12,17,.706,105,40,102,.392,31,68,.456,9,34,.265,15,18,.833,104
787,IND,2019-11-29,105,,ATL,W 105-104 (OT),265,39,92,.424,33,66,.500,6,26,.231,21,28,.750,105,39,90,.433,30,58,.517,9,32,.281,17,18,.944,104
788,DEN,2019-11-20,105,,HOU,W 105-95,240,44,94,.468,35,67,.522,9,27,.333,8,15,.533,105,32,76,.421,20,38,.526,12,38,.316,19,25,.760,95
789,MIN,2019-11-16,105,,HOU,L 105-125,240,38,84,.452,26,46,.565,12,38,.316,17,23,.739,105,43,94,.457,24,45,.533,19,49,.388,20,22,.909,125
790,LAC,2019-11-03,105,,UTA,W 105-94,240,36,92,.391,29,60,.483,7,32,.219,26,34,.765,105,31,78,.397,21,47,.447,10,31,.323,22,31,.710,94
791,MEM,2019-11-02,105,,PHO,L 105-114,240,42,86,.488,33,58,.569,9,28,.321,12,19,.632,105,44,88,.500,30,54,.556,14,34,.412,12,16,.750,114
792,NYK,2019-10-28,105,,CHI,W 105-98,240,38,91,.418,29,62,.468,9,29,.310,20,32,.625,105,36,85,.424,27,50,.540,9,35,.257,17,21,.810,98
793,HOU,2020-08-12,104,,IND,L 104-108,240,32,86,.372,16,29,.552,16,57,.281,24,28,.857,104,40,100,.400,29,69,.420,11,31,.355,17,22,.773,108
794,NOP,2020-07-30,104,,UTA,L 104-106,240,40,94,.426,29,63,.460,11,31,.355,13,18,.722,104,37,84,.440,29,50,.580,8,34,.235,24,28,.857,106
795,BOS,2020-03-08,104,,OKC,L 104-105,240,38,92,.413,25,55,.455,13,37,.351,15,19,.789,104,35,79,.443,25,54,.463,10,25,.400,25,34,.735,105
796,CLE,2020-03-07,104,,DEN,W 104-102,240,42,76,.553,30,48,.625,12,28,.429,8,12,.667,104,43,85,.506,30,53,.566,13,32,.406,3,8,.375,102
797,NYK,2020-03-04,104,,UTA,L 104-112,240,41,85,.482,34,65,.523,7,20,.350,15,18,.833,104,41,81,.506,31,45,.689,10,36,.278,20,25,.800,112
798,CLE,2020-02-29,104,,IND,L 104-113,240,41,85,.482,36,63,.571,5,22,.227,17,20,.850,104,47,87,.540,39,64,.609,8,23,.348,11,14,.786,113
799,CHI,2020-02-22,104,,PHO,L 104-112,240,36,83,.434,22,45,.489,14,38,.368,18,21,.857,104,38,86,.442,28,56,.500,10,30,.333,26,31,.839,112
800,UTA,2020-02-21,104,,SAS,L 104-113,240,35,82,.427,23,49,.469,12,33,.364,22,26,.846,104,40,91,.440,30,71,.423,10,20,.500,23,26,.885,113
801,MEM,2020-01-28,104,,DEN,W 104-96,240,46,82,.561,40,64,.625,6,18,.333,6,14,.429,104,32,86,.372,15,41,.366,17,45,.378,15,18,.833,96
802,DAL,2020-01-28,104,,PHO,L 104-133,240,37,83,.446,30,50,.600,7,33,.212,23,27,.852,104,51,86,.593,39,58,.672,12,28,.429,19,21,.905,133
803,MIN,2020-01-25,104,,OKC,L 104-113,240,40,90,.444,28,47,.596,12,43,.279,12,18,.667,104,39,80,.488,28,56,.500,11,24,.458,24,25,.960,113
804,MIN,2020-01-13,104,,OKC,L 104-117,240,38,91,.418,26,56,.464,12,35,.343,16,21,.762,104,41,82,.500,29,52,.558,12,30,.400,23,26,.885,117
805,TOR,2020-01-12,104,,SAS,L 104-105,240,39,96,.406,22,48,.458,17,48,.354,9,11,.818,104,38,87,.437,31,55,.564,7,32,.219,22,30,.733,105
806,CHO,2020-01-06,104,,IND,L 104-115,240,37,81,.457,27,51,.529,10,30,.333,20,22,.909,104,47,89,.528,37,63,.587,10,26,.385,11,14,.786,115
807,GSW,2020-01-04,104,,DET,L 104-111,240,33,82,.402,22,61,.361,11,21,.524,27,32,.844,104,43,83,.518,32,56,.571,11,27,.407,14,16,.875,111
808,CHI,2020-01-04,104,,BOS,L 104-111,240,34,80,.425,21,46,.457,13,34,.382,23,31,.742,104,43,82,.524,35,63,.556,8,19,.421,17,21,.810,111
809,UTA,2019-12-30,104,,DET,W 104-81,240,39,83,.470,29,57,.509,10,26,.385,16,20,.800,104,30,79,.380,26,65,.400,4,14,.286,17,23,.739,81
810,SAC,2019-12-26,104,,MIN,L 104-105 (2OT),290,37,107,.346,28,68,.412,9,39,.231,21,25,.840,104,36,104,.346,26,58,.448,10,46,.217,23,29,.793,105
811,SAC,2019-12-23,104,,HOU,L 104-113,240,41,87,.471,34,57,.596,7,30,.233,15,23,.652,104,39,87,.448,24,48,.500,15,39,.385,20,23,.870,113
812,LAL,2019-12-22,104,,DEN,L 104-128,240,39,83,.470,29,54,.537,10,29,.345,16,22,.727,104,45,92,.489,34,60,.567,11,32,.344,27,30,.900,128
813,PHI,2019-12-18,104,,MIA,L 104-108,240,38,90,.422,26,51,.510,12,39,.308,16,18,.889,104,40,85,.471,28,54,.519,12,31,.387,16,20,.800,108
814,CHO,2019-12-06,104,,BRK,L 104-111,240,36,83,.434,19,43,.442,17,40,.425,15,17,.882,104,42,88,.477,27,50,.540,15,38,.395,12,15,.800,111
815,ATL,2019-12-02,104,,GSW,W 104-79,240,41,89,.461,33,60,.550,8,29,.276,14,15,.933,104,33,83,.398,30,66,.455,3,17,.176,10,12,.833,79
816,CHO,2019-12-02,104,,PHO,L 104-109,240,38,84,.452,31,59,.525,7,25,.280,21,26,.808,104,39,88,.443,30,46,.652,9,42,.214,22,30,.733,109
817,MEM,2019-12-02,104,,IND,L 104-117,240,38,89,.427,28,51,.549,10,38,.263,18,19,.947,104,44,88,.500,28,50,.560,16,38,.421,13,15,.867,117
818,NYK,2019-12-01,104,,BOS,L 104-113,240,35,76,.461,27,50,.540,8,26,.308,26,37,.703,104,41,93,.441,26,52,.500,15,41,.366,16,22,.727,113
819,NOP,2019-12-01,104,,OKC,L 104-107,240,39,87,.448,22,49,.449,17,38,.447,9,10,.900,104,38,81,.469,27,48,.563,11,33,.333,20,26,.769,107
820,CLE,2019-11-27,104,,ORL,L 104-116,240,37,81,.457,26,47,.553,11,34,.324,19,22,.864,104,45,93,.484,33,60,.550,12,33,.364,14,17,.824,116
821,GSW,2019-11-27,104,,CHI,W 104-90,240,37,81,.457,26,52,.500,11,29,.379,19,26,.731,104,34,89,.382,24,60,.400,10,29,.345,12,18,.667,90
822,SAS,2019-11-25,104,,LAL,L 104-114,240,41,88,.466,31,63,.492,10,25,.400,12,15,.800,104,44,89,.494,30,56,.536,14,33,.424,12,18,.667,114
823,NYK,2019-11-23,104,,SAS,L 104-111,240,40,93,.430,25,53,.472,15,40,.375,9,15,.600,104,40,75,.533,28,52,.538,12,23,.522,19,28,.679,111
824,MIL,2019-11-23,104,,DET,W 104-90,240,41,84,.488,28,47,.596,13,37,.351,9,18,.500,104,37,91,.407,27,56,.482,10,35,.286,6,10,.600,90
825,LAL,2019-11-10,104,,TOR,L 104-113,240,41,94,.436,31,64,.484,10,30,.333,12,19,.632,104,43,89,.483,31,53,.585,12,36,.333,15,22,.682,113
826,NOP,2019-11-08,104,,TOR,L 104-122,240,40,99,.404,30,58,.517,10,41,.244,14,21,.667,104,41,93,.441,22,50,.440,19,43,.442,21,24,.875,122
827,BOS,2019-11-01,104,,NYK,W 104-102,240,33,74,.446,22,40,.550,11,34,.324,27,29,.931,104,37,93,.398,23,55,.418,14,38,.368,14,21,.667,102
828,TOR,2019-10-28,104,,ORL,W 104-95,240,33,85,.388,23,46,.500,10,39,.256,28,30,.933,104,34,89,.382,22,50,.440,12,39,.308,15,18,.833,95
829,MIA,2020-08-03,103,,TOR,L 103-107,240,37,87,.425,23,42,.548,14,45,.311,15,16,.938,103,29,67,.433,13,35,.371,16,32,.500,33,36,.917,107
830,LAL,2020-07-30,103,,LAC,W 103-101,240,32,82,.390,21,46,.457,11,36,.306,28,37,.757,103,32,74,.432,16,38,.421,16,36,.444,21,28,.750,101
831,LAC,2020-03-08,103,,LAL,L 103-112,240,34,86,.395,27,55,.491,7,31,.226,28,37,.757,103,39,87,.448,29,52,.558,10,35,.286,24,28,.857,112
832,NYK,2020-03-06,103,,OKC,L 103-126,240,41,91,.451,37,67,.552,4,24,.167,17,22,.773,103,47,96,.490,35,65,.538,12,31,.387,20,25,.800,126
833,CHO,2020-03-03,103,,SAS,L 103-104,240,39,82,.476,27,53,.509,12,29,.414,13,18,.722,103,38,80,.475,27,48,.563,11,32,.344,17,20,.850,104
834,SAS,2020-02-26,103,,DAL,L 103-109,240,39,92,.424,28,59,.475,11,33,.333,14,19,.737,103,36,86,.419,19,41,.463,17,45,.378,20,30,.667,109
835,UTA,2020-02-26,103,,BOS,L 103-114,240,40,89,.449,28,49,.571,12,40,.300,11,15,.733,103,45,84,.536,34,58,.586,11,26,.423,13,16,.813,114
836,LAC,2020-02-22,103,,SAC,L 103-112,240,34,87,.391,24,57,.421,10,30,.333,25,29,.862,103,40,89,.449,28,58,.483,12,31,.387,20,26,.769,112
837,IND,2020-02-03,103,,DAL,L 103-112,240,44,96,.458,37,62,.597,7,34,.206,8,11,.727,103,36,86,.419,18,41,.439,18,45,.400,22,23,.957,112
838,LAC,2020-01-30,103,,SAC,L 103-124,240,35,92,.380,22,61,.361,13,31,.419,20,25,.800,103,44,88,.500,23,47,.489,21,41,.512,15,18,.833,124
839,CHO,2020-01-24,103,,MIL,L 103-116,240,32,86,.372,18,47,.383,14,39,.359,25,30,.833,103,44,87,.506,34,51,.667,10,36,.278,18,24,.750,116
840,ATL,2020-01-18,103,,DET,L 103-136,240,40,93,.430,30,59,.508,10,34,.294,13,15,.867,103,51,86,.593,36,54,.667,15,32,.469,19,25,.760,136
841,BOS,2020-01-15,103,,DET,L 103-116,240,41,83,.494,32,55,.582,9,28,.321,12,20,.600,103,47,78,.603,35,46,.761,12,32,.375,10,19,.526,116
842,DEN,2020-01-11,103,,CLE,L 103-111,240,41,95,.432,33,56,.589,8,39,.205,13,18,.722,103,44,89,.494,32,52,.615,12,37,.324,11,13,.846,111
843,PHO,2020-01-07,103,,SAC,L 103-114,240,37,77,.481,26,42,.619,11,35,.314,18,22,.818,103,37,84,.440,22,48,.458,15,36,.417,25,28,.893,114
844,BRK,2020-01-07,103,,OKC,L 103-111 (OT),265,40,98,.408,29,61,.475,11,37,.297,12,16,.750,103,38,92,.413,27,55,.491,11,37,.297,24,29,.828,111
845,CLE,2020-01-05,103,,MIN,L 103-118,240,40,84,.476,32,59,.542,8,25,.320,15,19,.789,103,47,95,.495,33,57,.579,14,38,.368,10,13,.769,118
846,WAS,2020-01-03,103,,POR,L 103-122,240,38,90,.422,27,57,.474,11,33,.333,16,25,.640,103,45,88,.511,39,63,.619,6,25,.240,26,33,.788,122
847,SAS,2020-01-02,103,,OKC,L 103-109,240,40,92,.435,27,61,.443,13,31,.419,10,12,.833,103,43,89,.483,34,64,.531,9,25,.360,14,20,.700,109
848,ORL,2019-12-23,103,,CHI,W 103-95,240,39,81,.481,29,55,.527,10,26,.385,15,23,.652,103,35,88,.398,22,51,.431,13,37,.351,12,15,.800,95
849,DAL,2019-12-18,103,,BOS,L 103-109,240,34,87,.391,19,44,.432,15,43,.349,20,25,.800,103,35,86,.407,23,48,.479,12,38,.316,27,30,.900,109
850,NOP,2019-12-09,103,,DET,L 103-105,240,40,91,.440,32,53,.604,8,38,.211,15,22,.682,103,36,85,.424,25,50,.500,11,35,.314,22,27,.815,105
851,NYK,2019-12-07,103,,IND,L 103-104,240,39,96,.406,29,65,.446,10,31,.323,15,21,.714,103,41,85,.482,29,57,.509,12,28,.429,10,13,.769,104
852,DET,2019-12-04,103,,MIL,L 103-127,240,39,93,.419,28,57,.491,11,36,.306,14,22,.636,103,44,90,.489,30,55,.545,14,35,.400,25,27,.926,127
853,PHI,2019-12-02,103,,UTA,W 103-94,240,37,91,.407,24,65,.369,13,26,.500,16,23,.696,103,38,81,.469,33,59,.559,5,22,.227,13,20,.650,94
854,DET,2019-11-25,103,,ORL,W 103-88,240,34,79,.430,20,41,.488,14,38,.368,21,25,.840,103,32,84,.381,24,59,.407,8,25,.320,16,22,.727,88
855,BOS,2019-11-25,103,,SAC,W 103-102,240,38,85,.447,31,55,.564,7,30,.233,20,23,.870,103,37,79,.468,19,32,.594,18,47,.383,10,15,.667,102
856,UTA,2019-11-08,103,,MIL,W 103-100,240,34,84,.405,19,48,.396,15,36,.417,20,29,.690,103,34,95,.358,24,59,.407,10,36,.278,22,30,.733,100
857,LAC,2019-10-31,103,,SAS,W 103-97,240,39,91,.429,34,65,.523,5,26,.192,20,27,.741,103,36,80,.450,29,59,.492,7,21,.333,18,27,.667,97
858,ATL,2019-10-28,103,,PHI,L 103-105,240,36,84,.429,27,57,.474,9,27,.333,22,32,.688,103,37,88,.420,26,47,.553,11,41,.268,20,25,.800,105
859,ATL,2019-10-26,103,,ORL,W 103-99,240,43,84,.512,34,54,.630,9,30,.300,8,15,.533,103,35,99,.354,30,68,.441,5,31,.161,24,26,.923,99
860,LAL,2020-03-10,102,,BRK,L 102-104,240,40,87,.460,25,47,.532,15,40,.375,7,12,.583,102,37,90,.411,24,50,.480,13,40,.325,17,23,.739,104
861,CHI,2020-03-06,102,,IND,L 102-108,240,40,97,.412,31,59,.525,9,38,.237,13,15,.867,102,38,75,.507,30,53,.566,8,22,.364,24,33,.727,108
862,ATL,2020-01-22,102,,LAC,W 102-95,240,36,102,.353,25,67,.373,11,35,.314,19,23,.826,102,33,78,.423,29,57,.509,4,21,.190,25,39,.641,95
863,BRK,2020-01-04,102,,TOR,L 102-121,240,32,67,.478,19,32,.594,13,35,.371,25,34,.735,102,44,97,.454,31,65,.477,13,32,.406,20,28,.714,121
864,CHI,2019-12-30,102,,MIL,L 102-123,240,40,107,.374,23,63,.365,17,44,.386,5,8,.625,102,46,84,.548,35,52,.673,11,32,.344,20,24,.833,123
865,CHO,2019-12-27,102,,OKC,L 102-104 (OT),265,42,101,.416,35,62,.565,7,39,.179,11,18,.611,102,40,89,.449,35,58,.603,5,31,.161,19,31,.613,104
866,DAL,2019-12-26,102,,SAS,W 102-98,240,38,90,.422,22,50,.440,16,40,.400,10,15,.667,102,40,83,.482,32,54,.593,8,29,.276,10,15,.667,98
867,TOR,2019-12-25,102,,BOS,L 102-118,240,38,80,.475,30,57,.526,8,23,.348,18,22,.818,102,46,92,.500,32,59,.542,14,33,.424,12,14,.857,118
868,NYK,2019-12-21,102,,MIL,L 102-123,240,39,97,.402,30,67,.448,9,30,.300,15,21,.714,102,41,85,.482,23,42,.548,18,43,.419,23,35,.657,123
869,GSW,2019-12-09,102,,MEM,L 102-110,240,35,93,.376,24,66,.364,11,27,.407,21,25,.840,102,41,82,.500,26,42,.619,15,40,.375,13,17,.765,110
870,CHO,2019-11-27,102,,DET,W 102-101,240,39,88,.443,32,58,.552,7,30,.233,17,20,.850,102,41,88,.466,31,56,.554,10,32,.313,9,15,.600,101
871,UTA,2019-11-18,102,,MIN,L 102-112,240,35,96,.365,23,65,.354,12,31,.387,20,26,.769,102,41,89,.461,27,51,.529,14,38,.368,16,19,.842,112
872,NYK,2019-11-16,102,,CHO,L 102-103,240,39,86,.453,33,66,.500,6,20,.300,18,23,.783,102,36,87,.414,19,39,.487,17,48,.354,14,19,.737,103
873,HOU,2019-11-13,102,,LAC,W 102-93,240,33,86,.384,19,44,.432,14,42,.333,22,27,.815,102,38,98,.388,28,65,.431,10,33,.303,7,14,.500,93
874,ORL,2019-11-10,102,,IND,L 102-109,240,41,89,.461,26,53,.491,15,36,.417,5,6,.833,102,48,91,.527,39,71,.549,9,20,.450,4,5,.800,109
875,DAL,2019-11-08,102,,NYK,L 102-106,240,37,90,.411,23,46,.500,14,44,.318,14,17,.824,102,37,89,.416,23,61,.377,14,28,.500,18,31,.581,106
876,OKC,2019-11-05,102,,ORL,W 102-94,240,37,86,.430,25,53,.472,12,33,.364,16,20,.800,102,32,82,.390,29,60,.483,3,22,.136,27,31,.871,94
877,SAC,2019-11-01,102,,UTA,W 102-101,240,41,84,.488,33,55,.600,8,29,.276,12,17,.706,102,35,73,.479,24,45,.533,11,28,.393,20,27,.741,101
878,IND,2019-11-01,102,,CLE,W 102-95,240,39,96,.406,34,69,.493,5,27,.185,19,21,.905,102,32,87,.368,21,55,.382,11,32,.344,20,25,.800,95
879,MEM,2019-10-25,102,,CHI,L 102-110,240,39,94,.415,29,65,.446,10,29,.345,14,20,.700,102,40,93,.430,28,51,.549,12,42,.286,18,24,.750,110
880,MEM,2020-02-28,101,,SAC,L 101-104,240,39,91,.429,31,61,.508,8,30,.267,15,20,.750,101,38,91,.418,27,53,.509,11,38,.289,17,21,.810,104
881,GSW,2020-02-23,101,,NOP,L 101-115,240,40,92,.435,29,57,.509,11,35,.314,10,15,.667,101,46,98,.469,29,56,.518,17,42,.405,6,13,.462,115
882,BRK,2020-02-12,101,,TOR,W 101-91,240,36,88,.409,27,53,.509,9,35,.257,20,25,.800,101,34,90,.378,21,47,.447,13,43,.302,10,13,.769,91
883,GSW,2020-02-10,101,,MIA,L 101-113,240,30,77,.390,19,43,.442,11,34,.324,30,34,.882,101,43,87,.494,31,54,.574,12,33,.364,15,21,.714,113
884,MIA,2020-01-28,101,,BOS,L 101-109,240,33,89,.371,24,52,.462,9,37,.243,26,31,.839,101,39,83,.470,26,47,.553,13,36,.361,18,24,.750,109
885,IND,2020-01-13,101,,PHI,W 101-95,240,33,86,.384,23,60,.383,10,26,.385,25,31,.806,101,37,89,.416,31,56,.554,6,33,.182,15,19,.789,95
886,POR,2020-01-11,101,,MIL,L 101-122,240,37,95,.389,27,59,.458,10,36,.278,17,21,.810,101,47,103,.456,33,65,.508,14,38,.368,14,20,.700,122
887,ORL,2020-01-06,101,,BRK,W 101-89,240,35,81,.432,27,55,.491,8,26,.308,23,31,.742,101,32,96,.333,22,49,.449,10,47,.213,15,19,.789,89
888,WAS,2020-01-01,101,,ORL,L 101-122,240,33,87,.379,24,56,.429,9,31,.290,26,31,.839,101,45,95,.474,33,63,.524,12,32,.375,20,27,.741,122
889,NOP,2019-12-17,101,,BRK,L 101-108 (OT),265,37,107,.346,26,67,.388,11,40,.275,16,24,.667,101,40,96,.417,29,57,.509,11,39,.282,17,23,.739,108
890,SAC,2019-12-13,101,,NYK,L 101-103,240,39,83,.470,22,44,.500,17,39,.436,6,8,.750,101,44,95,.463,35,65,.538,9,30,.300,6,10,.600,103
891,SAS,2019-11-27,101,,MIN,L 101-113,240,41,97,.423,36,68,.529,5,29,.172,14,17,.824,101,37,85,.435,19,45,.422,18,40,.450,21,27,.778,113
892,TOR,2019-11-25,101,,PHI,W 101-96,240,38,84,.452,27,50,.540,11,34,.324,14,22,.636,101,36,88,.409,21,48,.438,15,40,.375,9,16,.563,96
893,NYK,2019-11-24,101,,BRK,L 101-103,240,37,80,.463,19,45,.422,18,35,.514,9,16,.563,101,31,77,.403,17,39,.436,14,38,.368,27,34,.794,103
894,BRK,2019-11-20,101,,CHO,W 101-91,240,36,90,.400,26,51,.510,10,39,.256,19,23,.826,101,30,81,.370,19,48,.396,11,33,.333,20,26,.769,91
895,CHI,2019-11-18,101,,MIL,L 101-115,240,39,97,.402,27,63,.429,12,34,.353,11,14,.786,101,38,82,.463,23,41,.561,15,41,.366,24,35,.686,115
896,DEN,2019-11-14,101,,BRK,W 101-93,240,43,101,.426,33,68,.485,10,33,.303,5,10,.500,101,36,95,.379,28,57,.491,8,38,.211,13,16,.813,93
897,TOR,2020-08-07,100,,BOS,L 100-122,240,38,89,.427,28,51,.549,10,38,.263,14,17,.824,100,47,96,.490,31,50,.620,16,46,.348,12,16,.750,122
898,WAS,2020-08-03,100,,IND,L 100-111,240,41,94,.436,30,64,.469,11,30,.367,7,13,.538,100,44,92,.478,37,66,.561,7,26,.269,16,16,1.000,111
899,DEN,2020-03-03,100,,GSW,L 100-116,240,39,87,.448,36,67,.537,3,20,.150,19,26,.731,100,42,82,.512,24,41,.585,18,41,.439,14,22,.636,116
900,CHO,2020-02-08,100,,DAL,L 100-116,240,38,87,.437,27,51,.529,11,36,.306,13,18,.722,100,44,87,.506,27,52,.519,17,35,.486,11,11,1.000,116
901,CHO,2020-02-03,100,,ORL,L 100-112,240,41,89,.461,32,58,.552,9,31,.290,9,14,.643,100,43,80,.538,27,46,.587,16,34,.471,10,17,.588,112
902,SAC,2020-01-29,100,,OKC,L 100-120,240,42,91,.462,33,52,.635,9,39,.231,7,11,.636,100,44,88,.500,29,54,.537,15,34,.441,17,20,.850,120
903,DET,2020-01-27,100,,CLE,L 100-115,240,38,84,.452,26,49,.531,12,35,.343,12,17,.706,100,48,96,.500,39,72,.542,9,24,.375,10,13,.769,115
904,MIN,2020-01-20,100,,DEN,L 100-107,240,38,91,.418,25,49,.510,13,42,.310,11,14,.786,100,43,90,.478,32,59,.542,11,31,.355,10,12,.833,107
905,PHI,2020-01-17,100,,CHI,W 100-89,240,40,82,.488,31,53,.585,9,29,.310,11,11,1.000,100,35,81,.432,27,46,.587,8,35,.229,11,15,.733,89
906,DEN,2020-01-15,100,,CHO,W 100-86,240,38,79,.481,29,51,.569,9,28,.321,15,25,.600,100,33,81,.407,21,46,.457,12,35,.343,8,14,.571,86
907,PHO,2020-01-12,100,,CHO,W 100-92,240,41,82,.500,34,61,.557,7,21,.333,11,18,.611,100,36,86,.419,28,51,.549,8,35,.229,12,18,.667,92
908,WAS,2019-12-28,100,,NYK,L 100-107,240,33,96,.344,23,71,.324,10,25,.400,24,31,.774,100,38,85,.447,27,54,.500,11,31,.355,20,26,.769,107
909,DEN,2019-12-25,100,,NOP,L 100-112,240,37,92,.402,25,55,.455,12,37,.324,14,18,.778,100,41,90,.456,23,47,.489,18,43,.419,12,12,1.000,112
910,CLE,2019-12-18,100,,CHO,W 100-98,240,40,74,.541,33,48,.688,7,26,.269,13,17,.765,100,37,91,.407,24,54,.444,13,37,.351,11,18,.611,98
911,ATL,2019-12-13,100,,IND,L 100-110,240,39,94,.415,33,66,.500,6,28,.214,16,23,.696,100,46,92,.500,39,70,.557,7,22,.318,11,15,.733,110
912,OKC,2019-12-04,100,,IND,L 100-107,240,41,84,.488,32,58,.552,9,26,.346,9,10,.900,100,42,87,.483,33,63,.524,9,24,.375,14,17,.824,107
913,LAL,2019-12-01,100,,DAL,L 100-114,240,40,87,.460,33,60,.550,7,27,.259,13,16,.813,100,42,97,.433,25,48,.521,17,49,.347,13,18,.722,114
914,ORL,2019-12-01,100,,GSW,W 100-96,240,37,87,.425,26,54,.481,11,33,.333,15,22,.682,100,36,91,.396,30,68,.441,6,23,.261,18,23,.783,96
915,SAC,2019-11-30,100,,DEN,W 100-97 (OT),265,37,96,.385,29,63,.460,8,33,.242,18,21,.857,100,36,87,.414,25,55,.455,11,32,.344,14,21,.667,97
916,SAC,2019-11-17,100,,BOS,W 100-99,240,38,89,.427,24,54,.444,14,35,.400,10,12,.833,100,34,82,.415,24,52,.462,10,30,.333,21,24,.875,99
917,GSW,2019-11-15,100,,BOS,L 100-105,240,34,82,.415,29,54,.537,5,28,.179,27,34,.794,100,37,91,.407,24,58,.414,13,33,.394,18,23,.783,105
918,DEN,2019-11-08,100,,PHI,W 100-97,240,39,87,.448,30,65,.462,9,22,.409,13,17,.765,100,38,86,.442,25,60,.417,13,26,.500,8,17,.471,97
919,WAS,2019-11-08,100,,CLE,L 100-113,240,45,96,.469,38,65,.585,7,31,.226,3,6,.500,100,41,90,.456,35,63,.556,6,27,.222,25,29,.862,113
920,MEM,2019-11-04,100,,HOU,L 100-107,240,40,94,.426,37,69,.536,3,25,.120,17,21,.810,100,35,93,.376,18,43,.419,17,50,.340,20,29,.690,107
921,DET,2019-10-24,100,,ATL,L 100-117,240,35,85,.412,25,48,.521,10,37,.270,20,22,.909,100,44,86,.512,33,55,.600,11,31,.355,18,21,.857,117
922,POR,2019-10-23,100,,DEN,L 100-108,240,36,87,.414,29,59,.492,7,28,.250,21,23,.913,100,34,81,.420,16,49,.327,18,32,.563,22,27,.815,108
923,UTA,2019-10-23,100,,OKC,W 100-95,240,40,90,.444,34,66,.515,6,24,.250,14,20,.700,100,32,83,.386,22,56,.393,10,27,.370,21,31,.677,95
924,ORL,2020-08-05,99,,TOR,L 99-109,240,35,87,.402,24,46,.522,11,41,.268,18,26,.692,99,38,78,.487,26,45,.578,12,33,.364,21,30,.700,109
925,PHO,2020-02-29,99,,GSW,L 99-115,240,34,83,.410,22,54,.407,12,29,.414,19,23,.826,99,41,87,.471,32,57,.561,9,30,.300,24,32,.750,115
926,WAS,2020-02-09,99,,MEM,L 99-106,240,35,100,.350,28,67,.418,7,33,.212,22,29,.759,99,43,102,.422,38,70,.543,5,32,.156,15,25,.600,106
927,SAS,2020-01-24,99,,PHO,L 99-103,240,33,78,.423,28,53,.528,5,25,.200,28,33,.848,99,39,84,.464,31,55,.564,8,29,.276,17,21,.810,103
928,MIN,2020-01-15,99,,IND,L 99-104,240,38,88,.432,27,60,.450,11,28,.393,12,16,.750,99,44,85,.518,37,62,.597,7,23,.304,9,12,.750,104
929,DET,2020-01-11,99,,CHI,L 99-108,240,36,78,.462,27,50,.540,9,28,.321,18,27,.667,99,42,83,.506,31,48,.646,11,35,.314,13,14,.929,108
930,TOR,2020-01-07,99,,POR,L 99-101,240,35,96,.365,20,54,.370,15,42,.357,14,19,.737,99,38,88,.432,25,53,.472,13,35,.371,12,14,.857,101
931,WAS,2020-01-06,99,,BOS,W 99-94,240,39,84,.464,32,63,.508,7,21,.333,14,23,.609,99,33,95,.347,25,58,.431,8,37,.216,20,26,.769,94
932,MIN,2020-01-02,99,,GSW,W 99-84,240,38,95,.400,25,52,.481,13,43,.302,10,17,.588,99,33,77,.429,30,57,.526,3,20,.150,15,21,.714,84
933,MIN,2019-12-18,99,,NOP,L 99-107,240,36,95,.379,26,56,.464,10,39,.256,17,27,.630,99,38,86,.442,24,53,.453,14,33,.424,17,21,.810,107
934,DET,2019-12-18,99,,TOR,L 99-112,240,39,87,.448,33,52,.635,6,35,.171,15,22,.682,99,39,91,.429,26,56,.464,13,35,.371,21,24,.875,112
935,IND,2019-12-09,99,,LAC,L 99-110,240,34,97,.351,24,62,.387,10,35,.286,21,28,.750,99,40,97,.412,30,65,.462,10,32,.313,20,27,.741,110
936,DAL,2019-11-26,99,,LAC,L 99-114,240,30,79,.380,19,41,.463,11,38,.289,28,35,.800,99,41,97,.423,30,64,.469,11,33,.333,21,30,.700,114
937,LAL,2019-11-15,99,,SAC,W 99-97,240,34,81,.420,23,44,.523,11,37,.297,20,22,.909,99,36,82,.439,20,43,.465,16,39,.410,9,9,1.000,97
938,OKC,2019-10-30,99,,POR,L 99-102,240,33,84,.393,29,57,.509,4,27,.148,29,37,.784,99,34,86,.395,17,51,.333,17,35,.486,17,24,.708,102
939,CHO,2019-10-25,99,,MIN,L 99-121,240,37,84,.440,25,55,.455,12,29,.414,13,26,.500,99,43,91,.473,31,53,.585,12,38,.316,23,31,.742,121
940,WAS,2020-08-05,98,,PHI,L 98-107,240,36,85,.424,29,64,.453,7,21,.333,19,24,.792,98,38,82,.463,27,53,.509,11,29,.379,20,29,.690,107
941,MIA,2020-03-11,98,,CHO,L 98-109,240,39,84,.464,24,40,.600,15,44,.341,5,6,.833,98,37,82,.451,20,48,.417,17,34,.500,18,22,.818,109
942,NYK,2020-02-21,98,,IND,L 98-106,240,35,81,.432,24,56,.429,11,25,.440,17,25,.680,98,36,88,.409,28,60,.467,8,28,.286,26,33,.788,106
943,ORL,2020-01-24,98,,BOS,L 98-109,240,36,90,.400,24,53,.453,12,37,.324,14,19,.737,98,40,86,.465,26,51,.510,14,35,.400,15,18,.833,109
944,NYK,2020-01-16,98,,PHO,L 98-121,240,37,90,.411,29,64,.453,8,26,.308,16,24,.667,98,47,92,.511,35,62,.565,12,30,.400,15,18,.833,121
945,PHO,2020-01-10,98,,ORL,W 98-94,240,33,79,.418,24,51,.471,9,28,.321,23,26,.885,98,33,89,.371,24,56,.429,9,33,.273,19,24,.792,94
946,GSW,2020-01-08,98,,MIL,L 98-107,240,33,87,.379,18,49,.367,15,38,.395,17,20,.850,98,35,87,.402,26,46,.565,9,41,.220,28,32,.875,107
947,CHI,2020-01-02,98,,UTA,L 98-102,240,37,94,.394,26,58,.448,11,36,.306,13,17,.765,98,37,76,.487,26,46,.565,11,30,.367,17,22,.773,102
948,ORL,2019-12-27,98,,PHI,W 98-97,240,37,88,.420,27,58,.466,10,30,.333,14,23,.609,98,35,87,.402,25,58,.431,10,29,.345,17,21,.810,97
949,PHI,2019-12-20,98,,DAL,L 98-117,240,38,90,.422,28,56,.500,10,34,.294,12,18,.667,98,43,83,.518,29,50,.580,14,33,.424,17,22,.773,117
950,CHI,2019-12-06,98,,GSW,L 98-100,240,39,88,.443,22,47,.468,17,41,.415,3,5,.600,98,38,71,.535,29,47,.617,9,24,.375,15,22,.682,100
951,MIN,2019-11-23,98,,PHO,L 98-100,240,38,91,.418,26,49,.531,12,42,.286,10,17,.588,98,33,96,.344,23,61,.377,10,35,.286,24,26,.923,100
952,PHI,2019-11-12,98,,CLE,W 98-97,240,40,89,.449,32,51,.627,8,38,.211,10,13,.769,98,38,86,.442,33,65,.508,5,21,.238,16,20,.800,97
953,LAC,2019-11-11,98,,TOR,W 98-88,240,34,92,.370,26,56,.464,8,36,.222,22,30,.733,98,34,85,.400,23,55,.418,11,30,.367,9,15,.600,88
954,MIN,2019-11-10,98,,DEN,L 98-100 (OT),265,34,97,.351,28,52,.538,6,45,.133,24,33,.727,98,39,101,.386,28,73,.384,11,28,.393,11,17,.647,100
955,TOR,2020-02-25,97,,MIL,L 97-108,240,32,91,.352,14,39,.359,18,52,.346,15,21,.714,97,32,84,.381,18,42,.429,14,42,.333,30,36,.833,108
956,CHO,2020-01-28,97,,NYK,W 97-92,240,34,88,.386,26,56,.464,8,32,.250,21,27,.778,97,38,86,.442,29,54,.537,9,32,.281,7,11,.636,92
957,OKC,2020-01-27,97,,DAL,L 97-107,240,34,86,.395,22,56,.393,12,30,.400,17,19,.895,97,41,99,.414,22,48,.458,19,51,.373,6,9,.667,107
958,ORL,2020-01-26,97,,LAC,L 97-112,240,34,95,.358,27,63,.429,7,32,.219,22,32,.688,97,37,79,.468,24,49,.490,13,30,.433,25,29,.862,112
959,BRK,2020-01-18,97,,MIL,L 97-117,240,33,99,.333,18,50,.360,15,49,.306,16,17,.941,97,45,89,.506,28,52,.538,17,37,.459,10,16,.625,117
960,GSW,2020-01-14,97,,DAL,L 97-124,240,39,87,.448,30,55,.545,9,32,.281,10,13,.769,97,49,96,.510,36,59,.610,13,37,.351,13,21,.619,124
961,TOR,2019-12-29,97,,OKC,L 97-98,240,35,83,.422,20,43,.465,15,40,.375,12,12,1.000,97,34,78,.436,24,45,.533,10,33,.303,20,23,.870,98
962,BOS,2019-12-28,97,,TOR,L 97-113,240,31,78,.397,24,46,.522,7,32,.219,28,36,.778,97,44,84,.524,30,50,.600,14,34,.412,11,17,.647,113
963,OKC,2019-12-26,97,,MEM,L 97-110,240,38,92,.413,28,57,.491,10,35,.286,11,13,.846,97,46,84,.548,36,59,.610,10,25,.400,8,11,.727,110
964,PHI,2019-12-10,97,,DEN,W 97-92,240,37,89,.416,25,53,.472,12,36,.333,11,16,.688,97,37,85,.435,30,58,.517,7,27,.259,11,12,.917,92
965,NOP,2019-12-03,97,,DAL,L 97-118,240,38,94,.404,27,53,.509,11,41,.268,10,15,.667,97,38,88,.432,19,43,.442,19,45,.422,23,27,.852,118
966,PHI,2019-11-27,97,,SAC,W 97-91,240,36,77,.468,31,51,.608,5,26,.192,20,24,.833,97,39,95,.411,30,61,.492,9,34,.265,4,9,.444,91
967,GSW,2019-11-25,97,,OKC,L 97-100,240,37,89,.416,28,69,.406,9,20,.450,14,16,.875,97,40,85,.471,29,53,.547,11,32,.344,9,11,.818,100
968,CLE,2019-11-14,97,,MIA,L 97-108,240,36,85,.424,28,53,.528,8,32,.250,17,21,.810,97,43,79,.544,31,49,.633,12,30,.400,10,11,.909,108
969,ATL,2019-10-31,97,,MIA,L 97-106,240,36,88,.409,29,54,.537,7,34,.206,18,26,.692,97,40,84,.476,26,47,.553,14,37,.378,12,19,.632,106
970,HOU,2020-08-14,96,,PHI,L 96-134,240,35,80,.438,23,32,.719,12,48,.250,14,16,.875,96,49,87,.563,31,49,.633,18,38,.474,18,22,.818,134
971,ORL,2020-08-11,96,,BRK,L 96-108,240,32,83,.386,25,60,.417,7,23,.304,25,29,.862,96,38,89,.427,25,46,.543,13,43,.302,19,24,.792,108
972,NYK,2020-03-08,96,,DET,W 96-84,240,36,82,.439,30,63,.476,6,19,.316,18,25,.720,96,29,80,.363,18,42,.429,11,38,.289,15,22,.682,84
973,TOR,2020-02-28,96,,CHO,L 96-99,240,33,95,.347,23,52,.442,10,43,.233,20,29,.690,96,34,78,.436,21,48,.438,13,30,.433,18,25,.720,99
974,NYK,2020-02-12,96,,WAS,L 96-114,240,36,88,.409,33,65,.508,3,23,.130,21,29,.724,96,40,84,.476,30,56,.536,10,28,.357,24,33,.727,114
975,MEM,2020-02-03,96,,DET,W 96-82,240,42,90,.467,40,73,.548,2,17,.118,10,12,.833,96,34,98,.347,26,72,.361,8,26,.308,6,9,.667,82
976,GSW,2020-01-22,96,,UTA,L 96-129,240,35,88,.398,29,65,.446,6,23,.261,20,24,.833,96,50,93,.538,33,53,.623,17,40,.425,12,23,.522,129
977,ORL,2020-01-04,96,,UTA,L 96-109,240,38,85,.447,27,48,.563,11,37,.297,9,12,.750,96,42,93,.452,26,53,.491,16,40,.400,9,14,.643,109
978,ATL,2019-12-15,96,,LAL,L 96-101,240,31,86,.360,19,44,.432,12,42,.286,22,25,.880,96,36,84,.429,31,53,.585,5,31,.161,24,33,.727,101
979,POR,2019-12-08,96,,OKC,L 96-108,240,36,100,.360,27,67,.403,9,33,.273,15,18,.833,96,35,85,.412,24,53,.453,11,32,.344,27,34,.794,108
980,UTA,2019-12-04,96,,LAL,L 96-121,240,34,83,.410,20,52,.385,14,31,.452,14,19,.737,96,46,90,.511,32,61,.525,14,29,.483,15,25,.600,121
981,DEN,2019-12-03,96,,LAL,L 96-105,240,37,91,.407,31,62,.500,6,29,.207,16,17,.941,96,39,84,.464,32,60,.533,7,24,.292,20,30,.667,105
982,DEN,2019-11-22,96,,BOS,W 96-92,240,39,88,.443,32,60,.533,7,28,.250,11,13,.846,96,33,81,.407,26,54,.481,7,27,.259,19,23,.826,92
983,SAS,2019-11-03,96,,LAL,L 96-103,240,33,83,.398,27,58,.466,6,25,.240,24,29,.828,96,42,87,.483,36,63,.571,6,24,.250,13,19,.684,103
984,DET,2019-10-28,96,,IND,W 96-94,240,37,81,.457,24,57,.421,13,24,.542,9,10,.900,96,39,94,.415,33,73,.452,6,21,.286,10,13,.769,94
985,ORL,2020-02-08,95,,MIL,L 95-111,240,37,98,.378,27,58,.466,10,40,.250,11,14,.786,95,42,93,.452,27,54,.500,15,39,.385,12,16,.750,111
986,UTA,2020-02-05,95,,DEN,L 95-98,240,36,86,.419,22,47,.468,14,39,.359,9,14,.643,95,39,90,.433,32,60,.533,7,30,.233,13,18,.722,98
987,NYK,2019-11-29,95,,PHI,L 95-101,240,34,78,.436,26,58,.448,8,20,.400,19,33,.576,95,31,72,.431,24,46,.522,7,26,.269,32,40,.800,101
988,MIN,2019-11-20,95,,UTA,L 95-103,240,35,89,.393,21,44,.477,14,45,.311,11,21,.524,95,35,86,.407,21,53,.396,14,33,.424,19,27,.704,103
989,MEM,2019-11-19,95,,GSW,L 95-114,240,36,88,.409,27,63,.429,9,25,.360,14,19,.737,95,43,90,.478,34,61,.557,9,29,.310,19,22,.864,114
990,CLE,2019-11-17,95,,PHI,L 95-114,240,34,90,.378,28,65,.431,6,25,.240,21,24,.875,95,46,84,.548,37,61,.607,9,23,.391,13,17,.765,114
991,LAL,2019-11-08,95,,MIA,W 95-80,240,40,89,.449,32,57,.561,8,32,.250,7,8,.875,95,28,80,.350,22,45,.489,6,35,.171,18,24,.750,80
992,ORL,2019-10-30,95,,NYK,W 95-83,240,37,88,.420,25,56,.446,12,32,.375,9,12,.750,95,31,82,.378,24,51,.471,7,31,.226,14,20,.700,83
993,PHO,2019-10-28,95,,UTA,L 95-96,240,33,80,.413,20,46,.435,13,34,.382,16,23,.696,95,27,71,.380,17,40,.425,10,31,.323,32,39,.821,96
994,NYK,2019-10-26,95,,BOS,L 95-118,240,31,82,.378,24,55,.436,7,27,.259,26,34,.765,95,42,93,.452,27,52,.519,15,41,.366,19,29,.655,118
995,LAL,2019-10-25,95,,UTA,W 95-86,240,34,86,.395,26,60,.433,8,26,.308,19,24,.792,95,29,70,.414,21,45,.467,8,25,.320,20,21,.952,86
996,BOS,2020-03-06,94,,UTA,L 94-99,240,35,94,.372,25,58,.431,10,36,.278,14,18,.778,94,36,80,.450,19,35,.543,17,45,.378,10,12,.833,99
997,OKC,2020-03-03,94,,LAC,L 94-109,240,34,81,.420,25,53,.472,9,28,.321,17,26,.654,94,38,84,.452,27,48,.563,11,36,.306,22,26,.846,109
998,GSW,2020-02-25,94,,SAC,L 94-112,240,35,79,.443,31,51,.608,4,28,.143,20,24,.833,94,40,76,.526,27,46,.587,13,30,.433,19,34,.559,112
999,POR,2019-12-23,94,,NOP,L 94-102,240,37,91,.407,33,62,.532,4,29,.138,16,18,.889,94,38,93,.409,23,58,.397,15,35,.429,11,16,.688,102
1000,SAC,2019-12-11,94,,OKC,W 94-93,240,39,88,.443,29,57,.509,10,31,.323,6,10,.600,94,34,79,.430,21,46,.457,13,33,.394,12,18,.667,93
1001,CLE,2019-12-03,94,,DET,L 94-127,240,38,90,.422,30,63,.476,8,27,.296,10,14,.714,94,51,94,.543,33,59,.559,18,35,.514,7,11,.636,127
1002,MEM,2019-11-29,94,,UTA,L 94-103,240,37,94,.394,27,60,.450,10,34,.294,10,17,.588,94,38,95,.400,26,60,.433,12,35,.343,15,19,.789,103
1003,CHI,2019-11-25,94,,POR,L 94-117,240,36,86,.419,27,47,.574,9,39,.231,13,20,.650,94,46,89,.517,38,62,.613,8,27,.296,17,22,.773,117
1004,CHI,2019-11-09,94,,HOU,L 94-117,240,37,98,.378,33,66,.500,4,32,.125,16,18,.889,94,39,83,.470,20,39,.513,19,44,.432,20,28,.714,117
1005,SAC,2019-10-28,94,,DEN,L 94-101,240,36,91,.396,24,54,.444,12,37,.324,10,16,.625,94,36,98,.367,26,62,.419,10,36,.278,19,21,.905,101
1006,ORL,2019-10-23,94,,CLE,W 94-85,240,37,86,.430,28,56,.500,9,30,.300,11,19,.579,94,33,88,.375,24,54,.444,9,34,.265,10,15,.667,85
1007,CHI,2020-02-20,93,,CHO,L 93-103,240,37,87,.425,30,56,.536,7,31,.226,12,19,.632,93,35,74,.473,27,46,.587,8,28,.286,25,29,.862,103
1008,ORL,2019-12-30,93,,ATL,L 93-101,240,37,89,.416,32,64,.500,5,25,.200,14,24,.583,93,39,81,.481,30,52,.577,9,29,.310,14,17,.824,101
1009,ATL,2019-11-06,93,,CHI,L 93-113,240,30,74,.405,24,44,.545,6,30,.200,27,35,.771,93,41,82,.500,28,49,.571,13,33,.394,18,27,.667,113
1010,UTA,2020-03-09,92,,TOR,L 92-101,240,33,83,.398,17,40,.425,16,43,.372,10,14,.714,92,36,83,.434,23,47,.489,13,36,.361,16,18,.889,101
1011,PHO,2020-02-26,92,,LAC,L 92-102,240,34,87,.391,25,53,.472,9,34,.265,15,18,.833,92,37,84,.440,23,46,.500,14,38,.368,14,15,.933,102
1012,CLE,2020-02-09,92,,LAC,L 92-133,240,35,95,.368,28,62,.452,7,33,.212,15,22,.682,92,53,93,.570,41,57,.719,12,36,.333,15,20,.750,133
1013,DET,2020-02-08,92,,NYK,L 92-95,240,34,69,.493,21,40,.525,13,29,.448,11,16,.688,92,38,85,.447,30,63,.476,8,22,.364,11,17,.647,95
1014,DET,2020-01-31,92,,TOR,L 92-105,240,28,79,.354,17,43,.395,11,36,.306,25,34,.735,92,44,85,.518,35,58,.603,9,27,.333,8,11,.727,105
1015,NYK,2020-01-22,92,,LAL,L 92-100,240,36,88,.409,25,54,.463,11,34,.324,9,13,.692,92,36,82,.439,27,55,.491,9,27,.333,19,28,.679,100
1016,CHO,2019-12-31,92,,BOS,L 92-109,240,34,86,.395,22,52,.423,12,34,.353,12,16,.750,92,44,97,.454,30,59,.508,14,38,.368,7,10,.700,109
1017,TOR,2019-12-11,92,,LAC,L 92-112,240,31,88,.352,23,52,.442,8,36,.222,22,25,.880,92,38,86,.442,26,46,.565,12,40,.300,24,27,.889,112
1018,CHI,2019-12-09,92,,TOR,L 92-93,240,35,89,.393,23,43,.535,12,46,.261,10,14,.714,92,34,90,.378,27,61,.443,7,29,.241,18,26,.692,93
1019,NYK,2019-12-05,92,,DEN,L 92-129,240,34,83,.410,25,49,.510,9,34,.265,15,23,.652,92,49,87,.563,28,48,.583,21,39,.538,10,18,.556,129
1020,NYK,2019-11-03,92,,SAC,L 92-113,240,32,80,.400,24,49,.490,8,31,.258,20,31,.645,92,41,85,.482,26,46,.565,15,39,.385,16,25,.640,113
1021,MIN,2020-03-01,91,,DAL,L 91-111,240,36,99,.364,23,57,.404,13,42,.310,6,15,.400,91,44,94,.468,33,54,.611,11,40,.275,12,19,.632,111
1022,ORL,2019-11-01,91,,MIL,L 91-123,240,34,91,.374,22,54,.407,12,37,.324,11,17,.647,91,47,93,.505,30,46,.652,17,47,.362,12,18,.667,123
1023,BOS,2020-08-13,90,,WAS,L 90-96,240,35,88,.398,27,53,.509,8,35,.229,12,14,.857,90,34,88,.386,24,62,.387,10,26,.385,18,24,.750,96
1024,UTA,2019-12-09,90,,OKC,L 90-104,240,36,89,.404,28,58,.483,8,31,.258,10,12,.833,90,40,85,.471,32,57,.561,8,28,.286,16,19,.842,104
1025,LAC,2019-11-18,90,,OKC,W 90-88,240,35,87,.402,25,51,.490,10,36,.278,10,14,.714,90,28,75,.373,21,48,.438,7,27,.259,25,28,.893,88
1026,WAS,2020-03-08,89,,MIA,L 89-100,240,26,78,.333,7,31,.226,19,47,.404,18,21,.857,89,32,66,.485,19,38,.500,13,28,.464,23,28,.821,100
1027,ORL,2020-02-01,89,,MIA,L 89-102,240,33,83,.398,24,50,.480,9,33,.273,14,17,.824,89,33,77,.429,18,44,.409,15,33,.455,21,26,.808,102
1028,ATL,2020-03-02,88,,MEM,L 88-127,240,32,99,.323,23,64,.359,9,35,.257,15,16,.938,88,46,92,.500,32,60,.533,14,32,.438,21,31,.677,127
1029,MIN,2019-12-28,88,,CLE,L 88-94,240,33,93,.355,25,56,.446,8,37,.216,14,19,.737,88,32,77,.416,28,57,.491,4,20,.200,26,36,.722,94
1030,PHO,2020-01-22,87,,IND,L 87-112,240,30,84,.357,26,64,.406,4,20,.200,23,26,.885,87,45,84,.536,36,64,.563,9,20,.450,13,20,.650,112
1031,NYK,2020-01-18,87,,PHI,L 87-90,240,35,88,.398,29,63,.460,6,25,.240,11,18,.611,87,34,78,.436,24,46,.522,10,32,.313,12,19,.632,90
1032,SAC,2019-12-31,87,,LAC,L 87-105,240,33,80,.413,25,52,.481,8,28,.286,13,19,.684,87,36,88,.409,24,52,.462,12,36,.333,21,22,.955,105
1033,ORL,2019-12-11,87,,LAL,L 87-96,240,34,81,.420,26,55,.473,8,26,.308,11,17,.647,87,37,87,.425,25,56,.446,12,31,.387,10,19,.526,96
1034,CLE,2019-12-06,87,,ORL,L 87-93,240,35,83,.422,25,49,.510,10,34,.294,7,10,.700,87,32,82,.390,23,56,.411,9,26,.346,20,23,.870,93
1035,NYK,2019-11-10,87,,CLE,L 87-108,240,31,86,.360,22,55,.400,9,31,.290,16,25,.640,87,36,82,.439,28,54,.519,8,28,.286,28,31,.903,108
1036,CHO,2019-11-07,87,,BOS,L 87-108,240,33,86,.384,27,55,.491,6,31,.194,15,21,.714,87,40,93,.430,30,60,.500,10,33,.303,18,23,.783,108
1037,GSW,2019-11-02,87,,CHO,L 87-93,240,34,77,.442,25,49,.510,9,28,.321,10,13,.769,87,36,85,.424,31,56,.554,5,29,.172,16,23,.696,93
1038,ORL,2019-11-02,87,,DEN,L 87-91,240,37,86,.430,31,57,.544,6,29,.207,7,11,.636,87,27,73,.370,18,45,.400,9,28,.321,28,39,.718,91
1039,LAL,2020-08-05,86,,OKC,L 86-105,240,31,88,.352,26,51,.510,5,37,.135,19,29,.655,86,34,79,.430,29,55,.527,5,24,.208,32,36,.889,105
1040,GSW,2020-02-27,86,,LAL,L 86-116,240,34,80,.425,25,48,.521,9,32,.281,9,10,.900,86,45,88,.511,37,64,.578,8,24,.333,18,27,.667,116
1041,CHO,2020-02-22,86,,BRK,L 86-115,240,31,88,.352,19,53,.358,12,35,.343,12,21,.571,86,42,87,.483,25,40,.625,17,47,.362,14,19,.737,115
1042,CLE,2020-01-20,86,,NYK,L 86-106,240,32,94,.340,21,61,.344,11,33,.333,11,17,.647,86,41,85,.482,32,62,.516,9,23,.391,15,17,.882,106
1043,ATL,2019-12-27,86,,MIL,L 86-112,240,33,91,.363,21,50,.420,12,41,.293,8,14,.571,86,46,91,.505,35,63,.556,11,28,.393,9,13,.692,112
1044,BRK,2019-11-18,86,,IND,L 86-115,240,30,84,.357,19,50,.380,11,34,.324,15,24,.625,86,44,101,.436,30,68,.441,14,33,.424,13,17,.765,115
1045,CHO,2020-03-01,85,,MIL,L 85-93,240,34,96,.354,26,61,.426,8,35,.229,9,10,.900,85,35,87,.402,28,56,.500,7,31,.226,16,21,.762,93
1046,IND,2020-02-01,85,,NYK,L 85-92,240,32,76,.421,24,52,.462,8,24,.333,13,21,.619,85,34,82,.415,27,56,.482,7,26,.269,17,23,.739,92
1047,PHO,2019-11-18,85,,BOS,L 85-99,240,33,82,.402,23,46,.500,10,36,.278,9,12,.750,85,37,89,.416,25,48,.521,12,41,.293,13,17,.765,99
1048,OKC,2019-10-25,85,,WAS,L 85-97,240,33,83,.398,28,60,.467,5,23,.217,14,22,.636,85,39,97,.402,28,56,.500,11,41,.268,8,10,.800,97
1049,MIA,2020-01-02,84,,TOR,W 84-76,240,33,81,.407,21,44,.477,12,37,.324,6,11,.545,84,28,89,.315,22,47,.468,6,42,.143,14,17,.824,76
1050,CHI,2019-10-26,84,,TOR,L 84-108,240,29,97,.299,20,62,.323,9,35,.257,17,25,.680,84,38,82,.463,23,40,.575,15,42,.357,17,18,.944,108
1051,CHO,2020-01-20,83,,ORL,L 83-106,240,29,76,.382,19,43,.442,10,33,.303,15,20,.750,83,44,92,.478,30,64,.469,14,28,.500,4,9,.444,106
1052,ORL,2019-11-29,83,,TOR,L 83-90,240,27,78,.346,20,49,.408,7,29,.241,22,27,.815,83,31,84,.369,20,46,.435,11,38,.289,17,28,.607,90
1053,IND,2019-11-16,83,,MIL,L 83-102,240,32,100,.320,20,66,.303,12,34,.353,7,9,.778,83,43,96,.448,32,57,.561,11,39,.282,5,7,.714,102
1054,BRK,2019-12-26,82,,NYK,L 82-94,240,21,78,.269,8,28,.286,13,50,.260,27,36,.750,82,37,92,.402,28,63,.444,9,29,.310,11,15,.733,94
1055,CHI,2020-01-24,81,,SAC,L 81-98,240,31,79,.392,23,42,.548,8,37,.216,11,14,.786,81,35,81,.432,25,49,.510,10,32,.313,18,21,.857,98
1056,BRK,2020-03-04,79,,MEM,L 79-118,240,30,90,.333,23,48,.479,7,42,.167,12,17,.706,79,43,100,.430,23,56,.411,20,44,.455,12,14,.857,118
1057,GSW,2019-12-15,79,,SAC,L 79-100,240,30,76,.395,24,51,.471,6,25,.240,13,18,.722,79,38,63,.603,28,41,.683,10,22,.455,14,16,.875,100
1058,DET,2020-02-10,76,,CHO,L 76-87,240,29,82,.354,22,47,.468,7,35,.200,11,13,.846,76,33,88,.375,24,52,.462,9,36,.250,12,14,.857,87
1059,CHI,2019-12-13,73,,CHO,L 73-83,240,27,90,.300,20,56,.357,7,34,.206,12,14,.857,73,30,79,.380,24,48,.500,6,31,.194,17,21,.810,83