Rk,Team,Date,PTS,,Opp,Result,MP,FG,FGA,FG%,2P,2PA,2P%,3P,3PA,3P%,FT,FTA,FT%,PTS,FG,FGA,FG%,2P,2PA,2P%,3P,3PA,3P%,FT,FTA,FT%,PTS
1,IND,2024-04-14,157,,ATL,W 157-115,240,65,100,.650,46,64,.719,19,36,.528,8,10,.800,157,39,89,.438,27,53,.509,12,36,.333,25,27,.926,115
2,BOS,2023-11-01,155,,IND,W 155-104,240,54,95,.568,34,60,.567,20,35,.571,27,28,.964,155,46,101,.455,41,64,.641,5,37,.135,7,12,.583,104
3,UTA,2024-01-03,154,,DET,W 154-148 (OT),265,53,103,.515,37,71,.521,16,32,.500,32,35,.914,154,56,105,.533,37,64,.578,19,41,.463,17,22,.773,148
4,NOP,2024-01-23,153,,UTA,W 153-124,240,60,104,.577,37,58,.638,23,46,.500,10,15,.667,153,43,92,.467,31,56,.554,12,36,.333,26,32,.813,124
5,ATL,2023-11-21,152,,IND,L 152-157,240,57,95,.600,42,64,.656,15,31,.484,23,28,.821,152,57,94,.606,35,49,.714,22,45,.489,21,28,.750,157
6,IND,2023-11-06,152,,SAS,W 152-111,240,55,95,.579,35,57,.614,20,38,.526,22,23,.957,152,40,94,.426,32,68,.471,8,26,.308,23,30,.767,111
7,LAL,2024-03-24,150,,IND,W 150-145,240,50,89,.562,38,64,.594,12,25,.480,38,43,.884,150,59,107,.551,41,71,.577,18,36,.500,9,16,.563,145
8,IND,2024-01-05,150,,ATL,W 150-116,240,60,94,.638,41,55,.745,19,39,.487,11,13,.846,150,40,93,.430,30,51,.588,10,42,.238,26,30,.867,116
9,DAL,2024-04-07,147,,HOU,W 147-136 (OT),265,46,85,.541,31,46,.674,15,39,.385,40,45,.889,147,46,93,.495,29,52,.558,17,41,.415,27,35,.771,136
10,HOU,2024-03-23,147,,UTA,W 147-119,240,54,97,.557,27,48,.563,27,49,.551,12,14,.857,147,40,89,.449,29,52,.558,11,37,.297,28,33,.848,119
11,OKC,2024-02-23,147,,WAS,W 147-106,240,55,92,.598,35,52,.673,20,40,.500,17,21,.810,147,41,104,.394,32,66,.485,9,38,.237,15,21,.714,106
12,BRK,2024-01-29,147,,UTA,W 147-114,240,54,105,.514,33,60,.550,21,45,.467,18,19,.947,147,39,86,.453,30,59,.508,9,27,.333,27,34,.794,114
13,DAL,2023-12-06,147,,UTA,W 147-97,240,56,101,.554,34,52,.654,22,49,.449,13,19,.684,147,35,87,.402,23,54,.426,12,33,.364,15,18,.833,97
14,ATL,2023-11-22,147,,BRK,W 147-145 (OT),265,51,116,.440,33,67,.493,18,49,.367,27,29,.931,147,55,113,.487,40,78,.513,15,35,.429,20,24,.833,145
15,DAL,2024-02-10,146,,OKC,W 146-111,240,53,91,.582,38,53,.717,15,38,.395,25,33,.758,146,38,98,.388,21,51,.412,17,47,.362,18,21,.857,111
16,MIL,2023-12-16,146,,DET,W 146-114,240,50,88,.568,31,46,.674,19,42,.452,27,32,.844,146,43,96,.448,37,68,.544,6,28,.214,22,26,.846,114
17,PHI,2023-12-11,146,,WAS,W 146-101,240,52,95,.547,32,49,.653,20,46,.435,22,25,.880,146,36,85,.424,27,54,.500,9,31,.290,20,31,.645,101
18,MIL,2023-12-05,146,,NYK,W 146-122,240,55,91,.604,32,53,.604,23,38,.605,13,19,.684,146,43,87,.494,36,64,.563,7,23,.304,29,33,.879,122
19,PHI,2023-11-06,146,,WAS,W 146-128,240,51,91,.560,39,60,.650,12,31,.387,32,36,.889,146,49,96,.510,35,62,.565,14,34,.412,16,20,.800,128
20,BOS,2024-01-13,145,,HOU,W 145-113,240,51,95,.537,27,48,.563,24,47,.511,19,25,.760,145,40,99,.404,33,69,.478,7,30,.233,26,30,.867,113
21,UTA,2024-01-12,145,,TOR,W 145-113,240,52,93,.559,31,50,.620,21,43,.488,20,26,.769,145,35,81,.432,18,47,.383,17,34,.500,26,37,.703,113
22,ATL,2024-02-05,144,,LAC,L 144-149,240,51,95,.537,31,56,.554,20,39,.513,22,27,.815,144,52,89,.584,31,54,.574,21,35,.600,24,31,.774,149
23,GSW,2024-01-27,144,,LAL,L 144-145 (2OT),290,55,119,.462,32,61,.525,23,58,.397,11,16,.688,144,49,101,.485,40,74,.541,9,27,.333,38,43,.884,145
24,DAL,2023-12-23,144,,SAS,W 144-119,240,52,100,.520,29,55,.527,23,45,.511,17,21,.810,144,44,98,.449,30,53,.566,14,45,.311,17,24,.708,119
25,IND,2023-12-20,144,,CHO,W 144-113,240,49,80,.613,31,41,.756,18,39,.462,28,30,.933,144,45,95,.474,37,64,.578,8,31,.258,15,19,.789,113
26,LAC,2023-12-16,144,,NYK,W 144-122,240,50,88,.568,34,55,.618,16,33,.485,28,34,.824,144,44,94,.468,33,59,.559,11,35,.314,23,26,.885,122
27,DAL,2023-11-10,144,,LAC,W 144-126,240,51,98,.520,32,56,.571,19,42,.452,23,26,.885,144,43,88,.489,35,61,.574,8,27,.296,32,36,.889,126
28,ATL,2024-01-26,143,,DAL,L 143-148,240,51,97,.526,36,63,.571,15,34,.441,26,30,.867,143,51,85,.600,32,50,.640,19,35,.543,27,32,.844,148
29,MIL,2024-01-14,143,,SAC,W 143-142 (OT),265,48,92,.522,28,49,.571,20,43,.465,27,32,.844,143,55,105,.524,38,64,.594,17,41,.415,15,20,.750,142
30,SAC,2023-12-18,143,,WAS,W 143-131,240,53,100,.530,36,57,.632,17,43,.395,20,26,.769,143,44,85,.518,26,47,.553,18,38,.474,25,30,.833,131
31,IND,2023-10-25,143,,WAS,W 143-120,240,56,107,.523,36,64,.563,20,43,.465,11,12,.917,143,44,96,.458,35,72,.486,9,24,.375,23,29,.793,120
32,DEN,2024-04-06,142,,ATL,W 142-110,240,53,88,.602,30,47,.638,23,41,.561,13,16,.813,142,37,87,.425,25,50,.500,12,37,.324,24,29,.828,110
33,MIA,2024-03-29,142,,POR,W 142-82,240,54,92,.587,33,53,.623,21,39,.538,13,18,.722,142,35,87,.402,30,57,.526,5,30,.167,7,11,.636,82
34,DEN,2024-03-09,142,,UTA,W 142-121,240,55,83,.663,36,51,.706,19,32,.594,13,16,.813,142,47,94,.500,39,68,.574,8,26,.308,19,25,.760,121
35,IND,2024-01-03,142,,MIL,W 142-130,240,50,90,.556,36,55,.655,14,35,.400,28,34,.824,142,46,92,.500,32,55,.582,14,37,.378,24,32,.750,130
36,DEN,2023-12-28,142,,MEM,W 142-105,240,55,96,.573,35,55,.636,20,41,.488,12,14,.857,142,37,89,.416,24,54,.444,13,35,.371,18,25,.720,105
37,MIA,2023-11-30,142,,IND,W 142-132,240,48,86,.558,40,65,.615,8,21,.381,38,45,.844,142,50,98,.510,39,55,.709,11,43,.256,21,32,.656,132
38,TOR,2023-11-19,142,,DET,W 142-113,240,55,102,.539,41,66,.621,14,36,.389,18,29,.621,142,39,83,.470,30,57,.526,9,26,.346,26,35,.743,113
39,ATL,2024-02-03,141,,GSW,W 141-134 (OT),265,55,114,.482,41,71,.577,14,43,.326,17,22,.773,141,50,112,.446,32,56,.571,18,56,.321,16,20,.800,134
40,MIL,2024-01-27,141,,NOP,W 141-117,240,51,91,.560,31,46,.674,20,45,.444,19,25,.760,141,40,85,.471,31,62,.500,9,23,.391,28,36,.778,117
41,LAL,2024-01-25,141,,CHI,W 141-132,240,53,87,.609,33,56,.589,20,31,.645,15,20,.750,141,47,88,.534,35,51,.686,12,37,.324,26,29,.897,132
42,ATL,2024-01-03,141,,OKC,W 141-138,240,48,95,.505,34,56,.607,14,39,.359,31,33,.939,141,50,91,.549,32,55,.582,18,36,.500,20,26,.769,138
43,MIL,2024-03-17,140,,PHO,W 140-129,240,51,94,.543,27,53,.509,24,41,.585,14,14,1.000,140,51,87,.586,37,54,.685,14,33,.424,13,15,.867,129
44,BOS,2024-03-03,140,,GSW,W 140-88,240,53,96,.552,28,47,.596,25,49,.510,9,11,.818,140,36,92,.391,29,51,.569,7,41,.171,9,13,.692,88
45,LAC,2024-03-01,140,,WAS,W 140-115,240,54,94,.574,41,62,.661,13,32,.406,19,25,.760,140,46,98,.469,34,64,.531,12,34,.353,11,15,.733,115
46,CLE,2024-01-03,140,,WAS,W 140-101,240,54,101,.535,34,59,.576,20,42,.476,12,16,.750,140,42,101,.416,30,66,.455,12,35,.343,5,11,.455,101
47,IND,2023-12-30,140,,NYK,W 140-126,240,50,85,.588,27,42,.643,23,43,.535,17,21,.810,140,45,95,.474,28,58,.483,17,37,.459,19,27,.704,126
48,MIL,2023-12-13,140,,IND,W 140-126,240,48,89,.539,41,62,.661,7,27,.259,37,48,.771,140,45,100,.450,34,64,.531,11,36,.306,25,32,.781,126
49,LAL,2024-02-09,139,,NOP,W 139-122,240,49,88,.557,35,57,.614,14,31,.452,27,32,.844,139,46,89,.517,35,60,.583,11,29,.379,19,23,.826,122
50,OKC,2024-01-11,139,,POR,W 139-77,240,53,93,.570,39,58,.672,14,35,.400,19,22,.864,139,28,101,.277,17,52,.327,11,49,.224,10,16,.625,77
51,ATL,2024-01-10,139,,PHI,W 139-132 (OT),265,48,102,.471,36,68,.529,12,34,.353,31,42,.738,139,46,102,.451,34,68,.500,12,34,.353,28,33,.848,132
52,DAL,2024-01-05,139,,POR,W 139-103,240,56,96,.583,39,58,.672,17,38,.447,10,15,.667,139,39,95,.411,26,55,.473,13,40,.325,12,17,.706,103
53,ORL,2023-11-29,139,,WAS,W 139-120,240,51,84,.607,34,57,.596,17,27,.630,20,24,.833,139,41,87,.471,30,58,.517,11,29,.379,27,35,.771,120
54,OKC,2023-11-03,139,,GSW,L 139-141,240,50,83,.602,35,54,.648,15,29,.517,24,30,.800,139,49,92,.533,31,52,.596,18,40,.450,25,30,.833,141
55,BOS,2024-03-01,138,,DAL,W 138-110,240,52,94,.553,31,51,.608,21,43,.488,13,13,1.000,138,44,94,.468,35,60,.583,9,34,.265,13,18,.722,110
56,NOP,2024-02-05,138,,TOR,W 138-100,240,53,104,.510,34,59,.576,19,45,.422,13,13,1.000,138,40,84,.476,30,53,.566,10,31,.323,10,15,.667,100
57,ATL,2024-01-30,138,,LAL,W 138-122,240,53,101,.525,37,63,.587,16,38,.421,16,18,.889,138,48,90,.533,36,57,.632,12,33,.364,14,25,.560,122
58,LAC,2024-01-08,138,,PHO,W 138-111,240,53,85,.624,38,56,.679,15,29,.517,17,23,.739,138,38,77,.494,28,47,.596,10,30,.333,25,29,.862,111
59,SAC,2024-01-03,138,,ORL,W 138-135 (2OT),290,51,105,.486,36,65,.554,15,40,.375,21,31,.677,138,44,90,.489,19,46,.413,25,44,.568,22,27,.815,135
60,OKC,2023-12-08,138,,GSW,W 138-136 (OT),265,51,98,.520,46,69,.667,5,29,.172,31,36,.861,138,49,104,.471,30,56,.536,19,48,.396,19,23,.826,136
61,PHI,2023-11-27,138,,LAL,W 138-94,240,47,93,.505,25,47,.532,22,46,.478,22,26,.846,138,39,83,.470,32,55,.582,7,28,.250,9,13,.692,94
62,GSW,2024-03-20,137,,MEM,W 137-116,240,58,100,.580,39,61,.639,19,39,.487,2,6,.333,137,42,96,.438,24,47,.511,18,49,.367,14,18,.778,116
63,UTA,2024-02-15,137,,GSW,L 137-140,240,43,93,.462,21,44,.477,22,49,.449,29,32,.906,137,49,92,.533,29,50,.580,20,42,.476,22,28,.786,140
64,WAS,2023-12-15,137,,IND,W 137-123,240,52,92,.565,39,65,.600,13,27,.481,20,26,.769,137,48,107,.449,33,67,.493,15,40,.375,12,16,.750,123
65,UTA,2023-11-19,137,,PHO,L 137-140 (2OT),290,48,115,.417,33,69,.478,15,46,.326,26,32,.813,137,50,102,.490,32,57,.561,18,45,.400,22,26,.846,140
66,PHI,2023-11-12,137,,IND,W 137-126,240,53,105,.505,39,72,.542,14,33,.424,17,20,.850,137,47,90,.522,31,51,.608,16,39,.410,16,19,.842,126
67,LAL,2024-03-18,136,,ATL,W 136-105,240,52,90,.578,37,54,.685,15,36,.417,17,20,.850,136,42,98,.429,33,57,.579,9,41,.220,12,15,.800,105
68,BOS,2024-02-14,136,,BRK,W 136-86,240,52,91,.571,30,46,.652,22,45,.489,10,12,.833,136,31,81,.383,21,50,.420,10,31,.323,14,15,.933,86
69,CLE,2024-02-05,136,,SAC,W 136-110,240,51,88,.580,28,47,.596,23,41,.561,11,17,.647,136,43,93,.462,26,49,.531,17,44,.386,7,12,.583,110
70,HOU,2024-01-01,136,,DET,W 136-113,240,51,91,.560,36,56,.643,15,35,.429,19,24,.792,136,40,83,.482,27,54,.500,13,29,.448,20,27,.741,113
71,NYK,2023-12-11,136,,TOR,W 136-130,240,52,86,.605,35,57,.614,17,29,.586,15,23,.652,136,47,96,.490,33,57,.579,14,39,.359,22,30,.733,130
72,IND,2023-11-24,136,,DET,W 136-113,240,49,102,.480,33,64,.516,16,38,.421,22,24,.917,136,43,90,.478,36,72,.500,7,18,.389,20,24,.833,113
73,OKC,2024-04-14,135,,DAL,W 135-86,240,54,97,.557,40,63,.635,14,34,.412,13,16,.813,135,32,97,.330,24,58,.414,8,39,.205,14,17,.824,86
74,BOS,2024-04-03,135,,OKC,W 135-100,240,50,92,.543,33,52,.635,17,40,.425,18,19,.947,135,35,81,.432,30,57,.526,5,24,.208,25,28,.893,100
75,HOU,2024-03-14,135,,WAS,W 135-119,240,51,87,.586,39,59,.661,12,28,.429,21,24,.875,135,46,93,.495,34,55,.618,12,38,.316,15,19,.789,119
76,SAC,2024-02-09,135,,DEN,W 135-106,240,51,87,.586,34,53,.642,17,34,.500,16,18,.889,135,38,82,.463,28,53,.528,10,29,.345,20,28,.714,106
77,OKC,2024-02-04,135,,TOR,W 135-127 (2OT),290,52,110,.473,29,47,.617,23,63,.365,8,8,1.000,135,48,101,.475,34,66,.515,14,35,.400,17,21,.810,127
78,HOU,2024-02-02,135,,TOR,W 135-106,240,55,93,.591,44,62,.710,11,31,.355,14,17,.824,135,40,91,.440,29,58,.500,11,33,.333,15,20,.750,106
79,HOU,2024-01-29,135,,LAL,W 135-119,240,52,98,.531,40,62,.645,12,36,.333,19,25,.760,135,45,91,.495,32,56,.571,13,35,.371,16,26,.615,119
80,DET,2024-01-20,135,,MIL,L 135-141,240,44,94,.468,23,57,.404,21,37,.568,26,32,.813,135,47,85,.553,35,53,.660,12,32,.375,35,49,.714,141
81,CLE,2024-01-17,135,,MIL,W 135-95,240,55,93,.591,43,65,.662,12,28,.429,13,19,.684,135,38,95,.400,26,53,.491,12,42,.286,7,10,.700,95
82,SAS,2024-01-12,135,,CHO,W 135-99,240,45,87,.517,27,49,.551,18,38,.474,27,34,.794,135,32,89,.360,22,55,.400,10,34,.294,25,28,.893,99
83,MIL,2024-01-11,135,,BOS,W 135-102,240,52,92,.565,34,50,.680,18,42,.429,13,16,.813,135,34,91,.374,25,56,.446,9,35,.257,25,30,.833,102
84,SAC,2024-01-05,135,,TOR,W 135-130,240,52,100,.520,31,62,.500,21,38,.553,10,15,.667,135,47,87,.540,34,50,.680,13,37,.351,23,27,.852,130
85,CLE,2023-12-18,135,,HOU,W 135-130 (OT),265,47,97,.485,28,49,.571,19,48,.396,22,34,.647,135,47,102,.461,35,69,.507,12,33,.364,24,27,.889,130
86,TOR,2023-12-13,135,,ATL,W 135-128,240,50,87,.575,32,53,.604,18,34,.529,17,24,.708,135,48,100,.480,30,59,.508,18,41,.439,14,19,.737,128
87,SAS,2023-11-30,135,,ATL,L 135-137,240,48,89,.539,30,48,.625,18,41,.439,21,23,.913,135,49,96,.510,35,63,.556,14,33,.424,25,29,.862,137
88,LAL,2024-02-29,134,,WAS,W 134-131 (OT),265,53,101,.525,45,78,.577,8,23,.348,20,24,.833,134,52,102,.510,35,61,.574,17,41,.415,10,12,.833,131
89,IND,2024-01-25,134,,PHI,W 134-122,240,53,93,.570,41,65,.631,12,28,.429,16,21,.762,134,42,87,.483,35,58,.603,7,29,.241,31,43,.721,122
90,GSW,2024-01-24,134,,ATL,W 134-112,240,51,91,.560,35,58,.603,16,33,.485,16,22,.727,134,39,94,.415,25,51,.490,14,43,.326,20,26,.769,112
91,LAL,2024-01-21,134,,POR,W 134-110,240,47,86,.547,34,53,.642,13,33,.394,27,29,.931,134,42,90,.467,33,61,.541,9,29,.310,17,20,.850,110
92,POR,2023-12-29,134,,SAS,W 134-128,240,48,95,.505,32,68,.471,16,27,.593,22,27,.815,134,48,94,.511,34,61,.557,14,33,.424,18,25,.720,128
93,OKC,2023-12-21,134,,LAC,W 134-115,240,51,87,.586,35,53,.660,16,34,.471,16,18,.889,134,44,93,.473,27,50,.540,17,43,.395,10,12,.833,115
94,OKC,2023-12-11,134,,UTA,W 134-120,240,50,96,.521,32,58,.552,18,38,.474,16,17,.941,134,44,92,.478,32,54,.593,12,38,.316,20,21,.952,120
95,DEN,2023-11-29,134,,HOU,W 134-124,240,48,95,.505,29,52,.558,19,43,.442,19,26,.731,134,47,86,.547,31,45,.689,16,41,.390,14,19,.737,124
96,LAL,2023-11-14,134,,MEM,W 134-107,240,47,81,.580,25,46,.543,22,35,.629,18,24,.750,134,39,106,.368,19,53,.358,20,53,.377,9,12,.750,107
97,IND,2023-11-08,134,,UTA,W 134-118,240,52,101,.515,39,60,.650,13,41,.317,17,20,.850,134,45,96,.469,34,69,.493,11,27,.407,17,18,.944,118
98,DEN,2023-11-06,134,,NOP,W 134-116,240,51,95,.537,36,56,.643,15,39,.385,17,23,.739,134,45,90,.500,32,60,.533,13,30,.433,13,15,.867,116
99,MIN,2024-04-03,133,,TOR,W 133-85,240,49,96,.510,29,53,.547,20,43,.465,15,22,.682,133,33,90,.367,26,60,.433,7,30,.233,12,14,.857,85
100,IND,2024-04-01,133,,BRK,W 133-111,240,53,103,.515,40,72,.556,13,31,.419,14,17,.824,133,41,87,.471,31,61,.508,10,26,.385,19,28,.679,111
101,IND,2024-02-25,133,,DAL,W 133-111,240,52,93,.559,38,57,.667,14,36,.389,15,17,.882,133,41,87,.471,27,56,.482,14,31,.452,15,21,.714,111
102,NOP,2024-02-14,133,,WAS,W 133-126,240,50,89,.562,40,57,.702,10,32,.313,23,29,.793,133,44,92,.478,23,47,.489,21,45,.467,17,20,.850,126
103,BOS,2024-02-09,133,,WAS,W 133-129,240,48,92,.522,37,58,.638,11,34,.324,26,28,.929,133,45,95,.474,25,48,.521,20,47,.426,19,21,.905,129
104,IND,2024-01-26,133,,PHO,W 133-131,240,58,109,.532,50,83,.602,8,26,.308,9,15,.600,133,51,89,.573,38,59,.644,13,30,.433,16,18,.889,131
105,GSW,2024-01-25,133,,SAC,L 133-134,240,48,86,.558,29,49,.592,19,37,.514,18,23,.783,133,48,91,.527,26,43,.605,22,48,.458,16,19,.842,134
106,PHI,2024-01-22,133,,SAS,W 133-123,240,48,97,.495,43,77,.558,5,20,.250,32,40,.800,133,43,93,.462,30,52,.577,13,41,.317,24,27,.889,123
107,IND,2024-01-08,133,,BOS,W 133-131,240,48,91,.527,29,51,.569,19,40,.475,18,22,.818,133,47,90,.522,30,55,.545,17,35,.486,20,29,.690,131
108,PHO,2023-12-29,133,,CHO,W 133-119,240,46,74,.622,28,44,.636,18,30,.600,23,24,.958,133,44,92,.478,21,46,.457,23,46,.500,8,8,1.000,119
109,LAL,2023-12-28,133,,CHO,W 133-112,240,52,97,.536,37,67,.552,15,30,.500,14,14,1.000,133,40,85,.471,25,52,.481,15,33,.455,17,28,.607,112
110,MIL,2023-12-11,133,,CHI,W 133-129 (OT),265,44,86,.512,29,49,.592,15,37,.405,30,37,.811,133,47,114,.412,32,80,.400,15,34,.441,20,25,.800,129
111,BOS,2023-12-08,133,,NYK,W 133-123,240,48,91,.527,29,44,.659,19,47,.404,18,21,.857,133,44,88,.500,29,51,.569,15,37,.405,20,27,.741,123
112,LAL,2023-12-07,133,,NOP,W 133-89,240,47,86,.547,30,51,.588,17,35,.486,22,29,.759,133,34,95,.358,27,64,.422,7,31,.226,14,20,.700,89
113,OKC,2023-11-30,133,,LAL,W 133-110,240,50,94,.532,36,52,.692,14,42,.333,19,22,.864,133,36,81,.444,25,48,.521,11,33,.333,27,32,.844,110
114,PHO,2023-11-15,133,,MIN,W 133-115,240,51,85,.600,34,54,.630,17,31,.548,14,15,.933,133,42,92,.457,37,65,.569,5,27,.185,26,28,.929,115
115,UTA,2023-11-01,133,,MEM,W 133-109,240,47,87,.540,25,44,.568,22,43,.512,17,24,.708,133,35,96,.365,21,42,.500,14,54,.259,25,32,.781,109
116,BOS,2024-04-14,132,,WAS,W 132-122,240,51,89,.573,35,57,.614,16,32,.500,14,21,.667,132,49,103,.476,35,65,.538,14,38,.368,10,10,1.000,122
117,ATL,2024-03-23,132,,CHO,W 132-91,240,50,90,.556,30,48,.625,20,42,.476,12,14,.857,132,35,84,.417,24,45,.533,11,39,.282,10,14,.714,91
118,SAS,2024-02-29,132,,OKC,W 132-118,240,48,91,.527,29,52,.558,19,39,.487,17,20,.850,132,44,89,.494,35,58,.603,9,31,.290,21,22,.955,118
119,CHI,2024-02-28,132,,CLE,W 132-123 (2OT),290,44,110,.400,31,73,.425,13,37,.351,31,38,.816,132,45,104,.433,23,50,.460,22,54,.407,11,19,.579,123
120,IND,2024-02-06,132,,HOU,W 132-129,240,54,86,.628,39,54,.722,15,32,.469,9,14,.643,132,50,97,.515,38,72,.528,12,25,.480,17,23,.739,129
121,NOP,2024-01-17,132,,CHO,W 132-112,240,44,88,.500,19,41,.463,25,47,.532,19,23,.826,132,39,90,.433,20,45,.444,19,45,.422,15,18,.833,112
122,UTA,2024-01-15,132,,IND,W 132-105,240,45,81,.556,34,56,.607,11,25,.440,31,35,.886,132,38,95,.400,29,64,.453,9,31,.290,20,25,.800,105
123,UTA,2024-01-13,132,,LAL,W 132-125,240,42,93,.452,30,56,.536,12,37,.324,36,39,.923,132,46,92,.500,33,63,.524,13,29,.448,20,24,.833,125
124,LAL,2024-01-09,132,,TOR,W 132-131,240,44,81,.543,28,45,.622,16,36,.444,28,36,.778,132,53,94,.564,36,59,.610,17,35,.486,8,13,.615,131
125,GSW,2023-12-19,132,,BOS,W 132-126 (OT),265,50,109,.459,30,59,.508,20,50,.400,12,14,.857,132,47,114,.412,30,56,.536,17,58,.293,15,17,.882,126
126,MIL,2023-12-19,132,,SAS,W 132-119,240,50,106,.472,32,57,.561,18,49,.367,14,18,.778,132,46,96,.479,37,66,.561,9,30,.300,18,21,.857,119
127,LAC,2023-12-11,132,,POR,W 132-127,240,49,89,.551,36,55,.655,13,34,.382,21,22,.955,132,43,90,.478,24,50,.480,19,40,.475,22,26,.846,127
128,MIL,2023-12-02,132,,ATL,W 132-121,240,53,89,.596,39,56,.696,14,33,.424,12,15,.800,132,45,101,.446,30,63,.476,15,38,.395,16,21,.762,121
129,DEN,2023-11-26,132,,SAS,W 132-120,240,50,89,.562,38,61,.623,12,28,.429,20,25,.800,132,42,93,.452,28,56,.500,14,37,.378,22,26,.846,120
130,MIL,2023-11-18,132,,DAL,W 132-125,240,49,94,.521,32,49,.653,17,45,.378,17,20,.850,132,51,103,.495,35,56,.625,16,47,.340,7,10,.700,125
131,SAC,2023-11-13,132,,CLE,W 132-120,240,49,83,.590,29,41,.707,20,42,.476,14,22,.636,132,45,91,.495,29,56,.518,16,35,.457,14,17,.824,120
132,SAC,2023-10-29,132,,LAL,W 132-127 (OT),265,49,104,.471,32,56,.571,17,48,.354,17,24,.708,132,43,98,.439,28,53,.528,15,45,.333,26,34,.765,127
133,BOS,2024-04-12,131,,CHO,W 131-98,240,54,104,.519,40,63,.635,14,41,.341,9,13,.692,131,32,76,.421,17,41,.415,15,35,.429,19,22,.864,98
134,LAC,2024-04-05,131,,UTA,W 131-102,240,51,91,.560,38,56,.679,13,35,.371,16,18,.889,131,35,91,.385,26,61,.426,9,30,.300,23,29,.793,102
135,SAC,2024-03-07,131,,SAS,W 131-129,240,52,102,.510,42,70,.600,10,32,.313,17,18,.944,131,46,91,.505,30,58,.517,16,33,.485,21,21,1.000,129
136,BOS,2024-02-04,131,,MEM,W 131-91,240,48,99,.485,29,48,.604,19,51,.373,16,18,.889,131,35,92,.380,24,54,.444,11,38,.289,10,12,.833,91
137,DAL,2024-01-29,131,,ORL,W 131-129,240,43,69,.623,30,42,.714,13,27,.481,32,43,.744,131,45,88,.511,27,50,.540,18,38,.474,21,28,.750,129
138,HOU,2024-01-24,131,,POR,L 131-137 (OT),265,50,94,.532,38,58,.655,12,36,.333,19,22,.864,131,50,98,.510,35,63,.556,15,35,.429,22,24,.917,137
139,CHI,2024-01-12,131,,GSW,L 131-140,240,50,86,.581,32,46,.696,18,40,.450,13,16,.813,131,49,94,.521,29,47,.617,20,47,.426,22,30,.733,140
140,DEN,2024-01-07,131,,DET,W 131-114,240,47,80,.588,37,53,.698,10,27,.370,27,31,.871,131,42,89,.472,33,65,.508,9,24,.375,21,30,.700,114
141,SAC,2023-12-11,131,,BRK,W 131-118,240,48,94,.511,23,49,.469,25,45,.556,10,14,.714,131,42,88,.477,28,59,.475,14,29,.483,20,21,.952,118
142,MIL,2023-11-24,131,,WAS,W 131-128,240,48,92,.522,39,61,.639,9,31,.290,26,33,.788,131,48,100,.480,33,63,.524,15,37,.405,17,21,.810,128
143,IND,2023-11-22,131,,TOR,L 131-132,240,50,91,.549,32,52,.615,18,39,.462,13,16,.813,131,48,90,.533,37,63,.587,11,27,.407,25,30,.833,132
144,LAL,2023-11-21,131,,UTA,W 131-99,240,49,86,.570,38,57,.667,11,29,.379,22,27,.815,131,38,98,.388,27,54,.500,11,44,.250,12,16,.750,99
145,NOP,2023-11-14,131,,DAL,W 131-110,240,49,94,.521,35,56,.625,14,38,.368,19,26,.731,131,38,90,.422,24,48,.500,14,42,.333,20,26,.769,110
146,MIN,2024-04-09,130,,WAS,W 130-121,240,43,90,.478,25,49,.510,18,41,.439,26,32,.813,130,44,89,.494,24,46,.522,20,43,.465,13,17,.765,121
147,TOR,2024-04-07,130,,WAS,W 130-122,240,49,96,.510,38,65,.585,11,31,.355,21,28,.750,130,42,89,.472,26,49,.531,16,40,.400,22,30,.733,122
148,DEN,2024-03-31,130,,CLE,W 130-101,240,50,87,.575,29,54,.537,21,33,.636,9,13,.692,130,38,82,.463,30,57,.526,8,25,.320,17,21,.810,101
149,SAS,2024-03-29,130,,NYK,W 130-126 (OT),265,44,82,.537,28,42,.667,16,40,.400,26,32,.813,130,51,110,.464,37,73,.507,14,37,.378,10,12,.833,126
150,DEN,2024-02-22,130,,WAS,W 130-110,240,56,101,.554,49,70,.700,7,31,.226,11,15,.733,130,40,104,.385,23,66,.348,17,38,.447,13,23,.565,110
151,PHO,2024-02-13,130,,SAC,W 130-125,240,44,85,.518,31,54,.574,13,31,.419,29,36,.806,130,49,95,.516,40,64,.625,9,31,.290,18,24,.750,125
152,POR,2024-01-29,130,,PHI,W 130-104,240,46,84,.548,34,56,.607,12,28,.429,26,29,.897,130,37,83,.446,32,54,.593,5,29,.172,25,28,.893,104
153,POR,2023-12-26,130,,SAC,W 130-113,240,49,98,.500,33,58,.569,16,40,.400,16,20,.800,130,45,93,.484,35,51,.686,10,42,.238,13,16,.813,113
154,ATL,2023-12-18,130,,DET,W 130-124,240,46,85,.541,30,49,.612,16,36,.444,22,27,.815,130,48,94,.511,39,72,.542,9,22,.409,19,27,.704,124
155,DEN,2023-12-18,130,,DAL,W 130-104,240,49,87,.563,35,61,.574,14,26,.538,18,22,.818,130,41,92,.446,28,54,.519,13,38,.342,9,19,.474,104
156,ORL,2023-12-01,130,,WAS,W 130-125,240,46,89,.517,34,58,.586,12,31,.387,26,33,.788,130,45,89,.506,32,61,.525,13,28,.464,22,31,.710,125
157,ORL,2023-11-26,130,,CHO,W 130-117,240,47,87,.540,37,60,.617,10,27,.370,26,33,.788,130,44,83,.530,31,53,.585,13,30,.433,16,25,.640,117
158,CHI,2023-11-06,130,,UTA,W 130-113,240,48,93,.516,30,59,.508,18,34,.529,16,19,.842,130,41,86,.477,25,43,.581,16,43,.372,15,17,.882,113
159,ATL,2023-11-01,130,,WAS,W 130-121,240,46,92,.500,37,60,.617,9,32,.281,29,32,.906,130,51,101,.505,41,61,.672,10,40,.250,9,14,.643,121
160,LAL,2023-11-01,130,,LAC,W 130-125 (OT),265,46,90,.511,35,58,.603,11,32,.344,27,36,.750,130,47,99,.475,33,65,.508,14,34,.412,17,27,.630,125
161,TOR,2023-11-01,130,,MIL,W 130-111,240,51,91,.560,36,53,.679,15,38,.395,13,14,.929,130,35,76,.461,22,42,.524,13,34,.382,28,38,.737,111
162,CLE,2024-04-12,129,,IND,W 129-120,240,50,95,.526,37,63,.587,13,32,.406,16,23,.696,129,46,89,.517,37,57,.649,9,32,.281,19,22,.864,120
163,IND,2024-03-13,129,,CHI,L 129-132 (OT),265,46,99,.465,32,54,.593,14,45,.311,23,28,.821,129,48,92,.522,38,64,.594,10,28,.357,26,32,.813,132
164,SAC,2024-03-12,129,,MIL,W 129-94,240,49,92,.533,31,52,.596,18,40,.450,13,16,.813,129,30,82,.366,23,43,.535,7,39,.179,27,35,.771,94
165,NOP,2024-03-01,129,,IND,W 129-102,240,48,86,.558,33,54,.611,15,32,.469,18,26,.692,129,40,95,.421,30,63,.476,10,32,.313,12,18,.667,102
166,IND,2024-02-22,129,,DET,W 129-115,240,50,94,.532,37,64,.578,13,30,.433,16,19,.842,129,47,89,.528,35,59,.593,12,30,.400,9,18,.500,115
167,OKC,2024-02-22,129,,LAC,W 129-107,240,50,90,.556,33,55,.600,17,35,.486,12,17,.706,129,42,93,.452,30,61,.492,12,32,.375,11,13,.846,107
168,PHO,2024-02-08,129,,UTA,W 129-115,240,52,88,.591,38,59,.644,14,29,.483,11,16,.688,129,41,94,.436,29,59,.492,12,35,.343,21,31,.677,115
169,CHI,2024-02-06,129,,MIN,W 129-123 (OT),265,45,93,.484,33,63,.524,12,30,.400,27,32,.844,129,42,92,.457,22,47,.468,20,45,.444,19,26,.731,123
170,ATL,2024-02-02,129,,PHO,W 129-120,240,49,95,.516,32,51,.627,17,44,.386,14,18,.778,129,47,88,.534,33,51,.647,14,37,.378,12,14,.857,120
171,BOS,2024-01-30,129,,IND,W 129-124,240,47,87,.540,30,51,.588,17,36,.472,18,22,.818,129,50,108,.463,38,69,.551,12,39,.308,12,15,.800,124
172,UTA,2024-01-18,129,,OKC,L 129-134,240,43,89,.483,30,57,.526,13,32,.406,30,36,.833,129,48,86,.558,34,54,.630,14,32,.438,24,28,.857,134
173,MIL,2024-01-13,129,,GSW,W 129-118,240,51,94,.543,38,63,.603,13,31,.419,14,17,.824,129,47,98,.480,32,62,.516,15,36,.417,9,14,.643,118
174,NOP,2023-12-31,129,,LAL,W 129-109,240,45,87,.517,28,53,.528,17,34,.500,22,27,.815,129,39,82,.476,29,50,.580,10,32,.313,21,25,.840,109
175,DET,2023-12-30,129,,TOR,W 129-127,240,41,82,.500,29,54,.537,12,28,.429,35,40,.875,129,46,91,.505,34,67,.507,12,24,.500,23,28,.821,127
176,OKC,2023-12-27,129,,NYK,W 129-120,240,49,90,.544,35,58,.603,14,32,.438,17,22,.773,129,41,82,.500,27,48,.563,14,34,.412,24,30,.800,120
177,OKC,2023-12-26,129,,MIN,W 129-106,240,49,81,.605,31,42,.738,18,39,.462,13,16,.813,129,34,73,.466,22,46,.478,12,27,.444,26,32,.813,106
178,NYK,2023-12-25,129,,MIL,W 129-122,240,50,92,.543,42,66,.636,8,26,.308,21,26,.808,129,45,95,.474,32,53,.604,13,42,.310,19,24,.792,122
179,GSW,2023-12-22,129,,WAS,W 129-118,240,47,97,.485,29,52,.558,18,45,.400,17,20,.850,129,44,97,.454,33,62,.532,11,35,.314,19,24,.792,118
180,SAS,2023-12-15,129,,LAL,W 129-115,240,47,95,.495,29,53,.547,18,42,.429,17,19,.895,129,43,89,.483,32,53,.604,11,36,.306,18,28,.643,115
181,BRK,2023-12-02,129,,ORL,W 129-101,240,46,91,.505,32,57,.561,14,34,.412,23,31,.742,129,35,88,.398,26,59,.441,9,29,.310,22,27,.815,101
182,MIA,2023-12-02,129,,IND,L 129-144,240,48,89,.539,36,64,.563,12,25,.480,21,24,.875,129,56,85,.659,40,53,.755,16,32,.500,16,20,.800,144
183,WAS,2023-11-20,129,,MIL,L 129-142,240,55,99,.556,45,70,.643,10,29,.345,9,11,.818,129,55,94,.585,44,65,.677,11,29,.379,21,28,.750,142
184,NOP,2023-11-20,129,,SAC,W 129-93,240,50,92,.543,38,64,.594,12,28,.429,17,21,.810,129,33,87,.379,22,42,.524,11,45,.244,16,24,.667,93
185,NYK,2023-11-12,129,,CHO,W 129-107,240,47,87,.540,32,51,.627,15,36,.417,20,30,.667,129,44,94,.468,32,59,.542,12,35,.343,7,11,.636,107
186,OKC,2024-03-29,128,,PHO,W 128-103,240,49,87,.563,33,57,.579,16,30,.533,14,14,1.000,128,39,87,.448,26,46,.565,13,41,.317,12,15,.800,103
187,DEN,2024-03-25,128,,MEM,W 128-103,240,48,90,.533,33,58,.569,15,32,.469,17,18,.944,128,37,94,.394,26,50,.520,11,44,.250,18,27,.667,103
188,PHO,2024-03-21,128,,ATL,W 128-115,240,41,74,.554,19,33,.576,22,41,.537,24,27,.889,128,40,91,.440,28,56,.500,12,35,.343,23,29,.793,115
189,POR,2024-03-09,128,,TOR,W 128-118 (OT),265,49,103,.476,33,63,.524,16,40,.400,14,15,.933,128,43,91,.473,27,48,.563,16,43,.372,16,19,.842,118
190,UTA,2024-02-25,128,,SAS,W 128-109,240,46,90,.511,29,55,.527,17,35,.486,19,22,.864,128,42,91,.462,29,60,.483,13,31,.419,12,19,.632,109
191,GSW,2024-02-22,128,,LAL,W 128-110,240,50,107,.467,34,66,.515,16,41,.390,12,14,.857,128,43,88,.489,33,53,.623,10,35,.286,14,21,.667,110
192,CLE,2024-01-31,128,,DET,W 128-121,240,47,89,.528,35,54,.648,12,35,.343,22,23,.957,128,45,81,.556,29,50,.580,16,31,.516,15,19,.789,121
193,LAC,2024-01-16,128,,OKC,W 128-117,240,47,87,.540,27,44,.614,20,43,.465,14,23,.609,128,42,83,.506,26,49,.531,16,34,.471,17,20,.850,117
194,DAL,2024-01-11,128,,NYK,W 128-124,240,44,88,.500,27,47,.574,17,41,.415,23,30,.767,128,44,89,.494,30,47,.638,14,42,.333,22,28,.786,124
195,WAS,2024-01-08,128,,OKC,L 128-136,240,44,89,.494,29,57,.509,15,32,.469,25,29,.862,128,52,88,.591,38,60,.633,14,28,.500,18,24,.750,136
196,BOS,2023-12-28,128,,DET,W 128-122 (OT),265,48,99,.485,37,60,.617,11,39,.282,21,25,.840,128,48,101,.475,34,58,.586,14,43,.326,12,19,.632,122
197,MIL,2023-12-17,128,,HOU,W 128-119,240,45,90,.500,32,54,.593,13,36,.361,25,32,.781,128,45,85,.529,34,58,.586,11,27,.407,18,21,.857,119
198,BOS,2023-12-15,128,,ORL,W 128-111,240,48,92,.522,30,50,.600,18,42,.429,14,20,.700,128,42,87,.483,28,52,.538,14,35,.400,13,18,.722,111
199,SAC,2023-12-14,128,,OKC,W 128-123,240,47,95,.495,29,50,.580,18,45,.400,16,21,.762,128,44,102,.431,33,66,.500,11,36,.306,24,27,.889,123
200,BRK,2023-11-30,128,,CHO,L 128-129,240,52,105,.495,38,69,.551,14,36,.389,10,15,.667,128,46,91,.505,25,55,.455,21,36,.583,16,16,1.000,129
201,CLE,2023-11-28,128,,ATL,W 128-105,240,50,93,.538,37,57,.649,13,36,.361,15,17,.882,128,35,101,.347,22,57,.386,13,44,.295,22,24,.917,105
202,UTA,2023-11-17,128,,PHO,L 128-131,240,43,85,.506,27,49,.551,16,36,.444,26,31,.839,128,45,86,.523,27,53,.509,18,33,.545,23,26,.885,131
203,OKC,2023-11-08,128,,CLE,W 128-120,240,44,86,.512,32,58,.552,12,28,.429,28,30,.933,128,42,83,.506,33,54,.611,9,29,.310,27,37,.730,120
204,HOU,2023-11-08,128,,LAL,W 128-94,240,51,93,.548,37,60,.617,14,33,.424,12,19,.632,128,36,85,.424,29,60,.483,7,25,.280,15,24,.625,94
205,HOU,2023-11-01,128,,CHO,W 128-119,240,44,84,.524,23,47,.489,21,37,.568,19,23,.826,128,45,90,.500,34,63,.540,11,27,.407,18,25,.720,119
206,WAS,2024-04-12,127,,CHI,L 127-129,240,45,86,.523,27,43,.628,18,43,.419,19,29,.655,127,48,98,.490,34,63,.540,14,35,.400,19,28,.679,129
207,OKC,2024-04-10,127,,SAS,W 127-89,240,47,101,.465,31,63,.492,16,38,.421,17,21,.810,127,32,96,.333,23,56,.411,9,40,.225,16,20,.800,89
208,SAC,2024-03-31,127,,UTA,W 127-106,240,45,84,.536,25,44,.568,20,40,.500,17,23,.739,127,34,83,.410,18,42,.429,16,41,.390,22,28,.786,106
209,HOU,2024-03-21,127,,CHI,W 127-117,240,47,93,.505,30,48,.625,17,45,.378,16,20,.800,127,42,93,.452,30,62,.484,12,31,.387,21,25,.840,117
210,CHI,2024-03-16,127,,WAS,W 127-98,240,49,85,.576,41,61,.672,8,24,.333,21,29,.724,127,36,84,.429,23,52,.442,13,32,.406,13,22,.591,98
211,BOS,2024-03-14,127,,PHO,W 127-112,240,47,89,.528,22,39,.564,25,50,.500,8,11,.727,127,47,99,.475,36,68,.529,11,31,.355,7,10,.700,112
212,UTA,2024-03-04,127,,WAS,W 127-115,240,49,101,.485,33,61,.541,16,40,.400,13,15,.867,127,40,94,.426,24,56,.429,16,38,.421,19,23,.826,115
213,SAC,2024-02-22,127,,SAS,W 127-122,240,52,93,.559,39,60,.650,13,33,.394,10,14,.714,127,50,98,.510,39,73,.534,11,25,.440,11,16,.688,122
214,NOP,2024-02-22,127,,HOU,W 127-105,240,50,96,.521,34,55,.618,16,41,.390,11,18,.611,127,36,82,.439,21,41,.512,15,41,.366,18,28,.643,105
215,OKC,2024-02-11,127,,SAC,W 127-113,240,46,85,.541,33,58,.569,13,27,.481,22,27,.815,127,44,90,.489,28,48,.583,16,42,.381,9,13,.692,113
216,ORL,2024-02-08,127,,SAS,W 127-111,240,49,82,.598,33,55,.600,16,27,.593,13,20,.650,127,42,81,.519,31,46,.674,11,35,.314,16,17,.941,111
217,LAC,2024-01-23,127,,LAL,W 127-116,240,52,88,.591,38,61,.623,14,27,.519,9,12,.750,127,45,92,.489,34,60,.567,11,32,.344,15,22,.682,116
218,WAS,2024-01-20,127,,SAS,L 127-131,240,49,103,.476,40,74,.541,9,29,.310,20,23,.870,127,51,96,.531,39,65,.600,12,31,.387,17,23,.739,131
219,HOU,2024-01-20,127,,UTA,W 127-126 (OT),265,50,117,.427,37,78,.474,13,39,.333,14,22,.636,127,48,105,.457,35,62,.565,13,43,.302,17,22,.773,126
220,LAL,2024-01-17,127,,DAL,W 127-110,240,49,91,.538,37,63,.587,12,28,.429,17,24,.708,127,42,91,.462,31,51,.608,11,40,.275,15,18,.833,110
221,BOS,2024-01-10,127,,MIN,W 127-120 (OT),265,39,90,.433,20,43,.465,19,47,.404,30,31,.968,127,44,95,.463,30,61,.492,14,34,.412,18,20,.900,120
222,BRK,2024-01-07,127,,POR,L 127-134 (OT),265,46,91,.505,32,54,.593,14,37,.378,21,25,.840,127,45,95,.474,25,57,.439,20,38,.526,24,30,.800,134
223,GSW,2024-01-04,127,,DEN,L 127-130,240,49,90,.544,34,54,.630,15,36,.417,14,16,.875,127,48,85,.565,39,59,.661,9,26,.346,25,29,.862,130
224,OKC,2024-01-02,127,,BOS,W 127-123,240,48,91,.527,30,51,.588,18,40,.450,13,17,.765,127,42,92,.457,27,52,.519,15,40,.375,24,29,.828,123
225,UTA,2024-01-01,127,,DAL,W 127-90,240,49,96,.510,37,52,.712,12,44,.273,17,18,.944,127,37,93,.398,26,53,.491,11,40,.275,5,10,.500,90
226,HOU,2023-12-29,127,,PHI,L 127-131,240,49,91,.538,35,61,.574,14,30,.467,15,21,.714,127,45,86,.523,33,53,.623,12,33,.364,29,33,.879,131
227,HOU,2023-12-20,127,,ATL,L 127-134,240,44,89,.494,28,55,.509,16,34,.471,23,23,1.000,127,47,91,.516,30,51,.588,17,40,.425,23,28,.821,134
228,PHI,2023-12-20,127,,MIN,W 127-113,240,45,84,.536,37,62,.597,8,22,.364,29,32,.906,127,42,82,.512,33,57,.579,9,25,.360,20,24,.833,113
229,IND,2023-12-18,127,,LAC,L 127-151,240,49,95,.516,37,62,.597,12,33,.364,17,21,.810,127,56,98,.571,37,60,.617,19,38,.500,20,23,.870,151
230,MIN,2023-12-16,127,,IND,W 127-109,240,48,86,.558,30,56,.536,18,30,.600,13,16,.813,127,45,90,.500,39,69,.565,6,21,.286,13,16,.813,109
231,CLE,2023-12-16,127,,ATL,W 127-119,240,49,101,.485,33,59,.559,16,42,.381,13,15,.867,127,41,85,.482,26,49,.531,15,36,.417,22,25,.880,119
232,DAL,2023-12-12,127,,LAL,W 127-125,240,44,89,.494,23,46,.500,21,43,.488,18,21,.857,127,49,91,.538,34,62,.548,15,29,.517,12,18,.667,125
233,ATL,2023-10-30,127,,MIN,W 127-113,240,48,86,.558,34,56,.607,14,30,.467,17,18,.944,127,44,90,.489,28,57,.491,16,33,.485,9,15,.600,113
234,SAS,2024-04-07,126,,PHI,L 126-133 (2OT),290,44,98,.449,28,54,.519,16,44,.364,22,26,.846,126,52,114,.456,40,75,.533,12,39,.308,17,19,.895,133
235,IND,2024-04-05,126,,OKC,W 126-112,240,46,88,.523,31,53,.585,15,35,.429,19,21,.905,126,42,86,.488,34,56,.607,8,30,.267,20,24,.833,112
236,OKC,2024-03-27,126,,HOU,L 126-132 (OT),265,47,96,.490,33,58,.569,14,38,.368,18,24,.750,126,50,104,.481,35,61,.574,15,43,.349,17,23,.739,132
237,NOP,2024-03-16,126,,POR,W 126-107,240,52,97,.536,39,64,.609,13,33,.394,9,10,.900,126,42,84,.500,30,51,.588,12,33,.364,11,12,.917,107
238,OKC,2024-03-14,126,,DAL,W 126-119,240,45,86,.523,29,47,.617,16,39,.410,20,23,.870,126,43,84,.512,31,55,.564,12,29,.414,21,26,.808,119
239,MIA,2024-03-02,126,,UTA,W 126-120,240,46,88,.523,33,54,.611,13,34,.382,21,25,.840,126,42,87,.483,28,52,.538,14,35,.400,22,26,.846,120
240,ATL,2024-02-12,126,,CHI,L 126-136,240,44,94,.468,30,51,.588,14,43,.326,24,29,.828,126,51,92,.554,38,64,.594,13,28,.464,21,29,.724,136
241,OKC,2024-02-02,126,,CHO,W 126-106,240,44,75,.587,27,39,.692,17,36,.472,21,27,.778,126,41,92,.446,27,61,.443,14,31,.452,10,14,.714,106
242,ATL,2024-01-28,126,,TOR,W 126-125,240,44,95,.463,38,68,.559,6,27,.222,32,40,.800,126,41,89,.461,26,58,.448,15,31,.484,28,32,.875,125
243,MIL,2024-01-24,126,,CLE,W 126-116,240,45,90,.500,34,61,.557,11,29,.379,25,28,.893,126,46,91,.505,33,53,.623,13,38,.342,11,15,.733,116
244,NYK,2024-01-20,126,,TOR,W 126-100,240,48,88,.545,34,49,.694,14,39,.359,16,20,.800,126,38,92,.413,27,58,.466,11,34,.324,13,23,.565,100
245,PHI,2024-01-16,126,,DEN,W 126-121,240,43,76,.566,28,45,.622,15,31,.484,25,34,.735,126,45,89,.506,33,60,.550,12,29,.414,19,25,.760,121
246,LAC,2024-01-10,126,,TOR,W 126-120,240,49,93,.527,34,59,.576,15,34,.441,13,13,1.000,126,46,84,.548,34,54,.630,12,30,.400,16,18,.889,120
247,BOS,2024-01-05,126,,UTA,W 126-97,240,39,90,.433,22,41,.537,17,49,.347,31,36,.861,126,34,94,.362,28,60,.467,6,34,.176,23,34,.676,97
248,DAL,2024-01-03,126,,POR,W 126-97,240,42,84,.500,29,54,.537,13,30,.433,29,41,.707,126,34,87,.391,21,47,.447,13,40,.325,16,22,.727,97
249,WAS,2023-12-31,126,,ATL,L 126-130,240,46,98,.469,29,45,.644,17,53,.321,17,21,.810,126,47,95,.495,35,63,.556,12,32,.375,24,37,.649,130
250,GSW,2023-12-23,126,,POR,W 126-106,240,48,83,.578,38,50,.760,10,33,.303,20,24,.833,126,38,84,.452,25,49,.510,13,35,.371,17,25,.680,106
251,BRK,2023-12-23,126,,DET,W 126-115,240,45,86,.523,35,62,.565,10,24,.417,26,32,.813,126,39,79,.494,24,44,.545,15,35,.429,22,29,.759,115
252,WAS,2023-12-06,126,,PHI,L 126-131,240,52,92,.565,38,57,.667,14,35,.400,8,8,1.000,126,47,92,.511,39,65,.600,8,27,.296,29,34,.853,131
253,ORL,2023-11-21,126,,TOR,W 126-107,240,50,100,.500,38,69,.551,12,31,.387,14,20,.700,126,38,75,.507,24,47,.511,14,28,.500,17,22,.773,107
254,PHI,2023-11-14,126,,IND,L 126-132,240,43,86,.500,37,64,.578,6,22,.273,34,35,.971,126,48,93,.516,35,56,.625,13,37,.351,23,33,.697,132
255,IND,2023-11-09,126,,MIL,W 126-124,240,44,92,.478,24,44,.545,20,48,.417,18,20,.900,126,46,87,.529,37,60,.617,9,27,.333,23,26,.885,124
256,NYK,2023-11-08,126,,SAS,W 126-105,240,46,100,.460,27,58,.466,19,42,.452,15,22,.682,126,44,90,.489,35,56,.625,9,34,.265,8,13,.615,105
257,OKC,2023-11-06,126,,ATL,W 126-117,240,45,94,.479,31,59,.525,14,35,.400,22,23,.957,126,38,102,.373,24,60,.400,14,42,.333,27,32,.844,117
258,PHI,2023-10-29,126,,POR,W 126-98,240,40,82,.488,29,54,.537,11,28,.393,35,40,.875,126,36,94,.383,29,63,.460,7,31,.226,19,22,.864,98
259,PHO,2023-10-28,126,,UTA,W 126-104,240,45,85,.529,35,48,.729,10,37,.270,26,28,.929,126,40,91,.440,28,54,.519,12,37,.324,12,14,.857,104
260,SAS,2023-10-27,126,,HOU,W 126-122 (OT),265,46,94,.489,33,52,.635,13,42,.310,21,28,.750,126,52,100,.520,44,68,.647,8,32,.250,10,20,.500,122
261,OKC,2024-04-12,125,,MIL,W 125-107,240,47,89,.528,34,51,.667,13,38,.342,18,20,.900,125,42,85,.494,31,55,.564,11,30,.367,12,13,.923,107
262,MIA,2024-04-12,125,,TOR,W 125-103,240,45,86,.523,28,45,.622,17,41,.415,18,23,.783,125,37,77,.481,27,46,.587,10,31,.323,19,22,.864,103
263,PHI,2024-04-12,125,,ORL,W 125-113,240,42,88,.477,24,51,.471,18,37,.486,23,28,.821,125,43,95,.453,35,68,.515,8,27,.296,19,25,.760,113
264,BRK,2024-03-29,125,,CHI,W 125-108,240,43,91,.473,18,47,.383,25,44,.568,14,22,.636,125,38,75,.507,29,45,.644,9,30,.300,23,29,.793,108
265,CHI,2024-03-27,125,,IND,W 125-99,240,49,98,.500,37,71,.521,12,27,.444,15,18,.833,125,34,85,.400,21,43,.488,13,42,.310,18,23,.783,99
266,DEN,2024-03-11,125,,TOR,W 125-119,240,52,95,.547,42,66,.636,10,29,.345,11,18,.611,125,47,93,.505,36,63,.571,11,30,.367,14,17,.824,119
267,GSW,2024-03-06,125,,MIL,W 125-90,240,51,91,.560,32,52,.615,19,39,.487,4,7,.571,125,34,89,.382,23,50,.460,11,39,.282,11,15,.733,90
268,TOR,2024-02-28,125,,DAL,L 125-136,240,46,98,.469,33,63,.524,13,35,.371,20,30,.667,125,52,96,.542,37,53,.698,15,43,.349,17,21,.810,136
269,GSW,2024-02-14,125,,LAC,L 125-130,240,47,103,.456,29,56,.518,18,47,.383,13,18,.722,125,44,88,.500,31,50,.620,13,38,.342,29,37,.784,130
270,TOR,2024-02-14,125,,IND,L 125-127,240,50,98,.510,44,72,.611,6,26,.231,19,26,.731,125,47,97,.485,30,56,.536,17,41,.415,16,23,.696,127
271,LAL,2024-02-13,125,,DET,W 125-111,240,43,84,.512,29,49,.592,14,35,.400,25,30,.833,125,45,108,.417,37,80,.463,8,28,.286,13,17,.765,111
272,BOS,2024-02-07,125,,ATL,W 125-117,240,49,93,.527,32,44,.727,17,49,.347,10,11,.909,125,43,102,.422,30,61,.492,13,41,.317,18,20,.900,117
273,DET,2024-02-02,125,,LAC,L 125-136,240,45,89,.506,28,49,.571,17,40,.425,18,24,.750,125,53,89,.596,39,60,.650,14,29,.483,16,19,.842,136
274,NYK,2024-01-27,125,,MIA,W 125-109,240,45,87,.517,28,54,.519,17,33,.515,18,26,.692,125,41,88,.466,27,51,.529,14,37,.378,13,16,.813,109
275,MIN,2024-01-22,125,,CHO,L 125-128,240,44,84,.524,26,43,.605,18,41,.439,19,25,.760,125,50,88,.568,36,51,.706,14,37,.378,14,18,.778,128
276,LAC,2024-01-21,125,,BRK,W 125-114,240,42,83,.506,29,57,.509,13,26,.500,28,33,.848,125,44,90,.489,30,51,.588,14,39,.359,12,16,.750,114
277,CHI,2024-01-20,125,,MEM,W 125-96,240,47,91,.516,33,58,.569,14,33,.424,17,21,.810,125,32,75,.427,19,33,.576,13,42,.310,19,23,.826,96
278,DAL,2024-01-15,125,,NOP,W 125-120,240,39,85,.459,21,42,.500,18,43,.419,29,35,.829,125,41,81,.506,34,58,.586,7,23,.304,31,41,.756,120
279,DEN,2024-01-12,125,,NOP,W 125-113,240,50,90,.556,36,57,.632,14,33,.424,11,15,.733,125,42,89,.472,29,56,.518,13,33,.394,16,22,.727,113
280,UTA,2023-12-18,125,,BRK,W 125-108,240,45,91,.495,31,57,.544,14,34,.412,21,24,.875,125,39,90,.433,23,51,.451,16,39,.410,14,20,.700,108
281,SAC,2023-12-16,125,,UTA,W 125-104,240,46,85,.541,24,40,.600,22,45,.489,11,15,.733,125,38,86,.442,26,49,.531,12,37,.324,16,21,.762,104
282,PHI,2023-12-08,125,,ATL,W 125-114,240,42,87,.483,31,57,.544,11,30,.367,30,37,.811,125,41,104,.394,28,65,.431,13,39,.333,19,21,.905,114
283,BOS,2023-12-01,125,,PHI,W 125-119,240,39,77,.506,23,44,.523,16,33,.485,31,36,.861,125,43,94,.457,27,59,.458,16,35,.457,17,23,.739,119
284,BRK,2023-11-06,125,,MIL,L 125-129,240,49,101,.485,33,56,.589,16,45,.356,11,13,.846,125,46,96,.479,30,48,.625,16,48,.333,21,24,.875,129
285,DEN,2023-11-03,125,,DAL,W 125-114,240,49,93,.527,36,63,.571,13,30,.433,14,19,.737,125,41,86,.477,24,44,.545,17,42,.405,15,17,.882,114
286,NOP,2023-11-02,125,,DET,W 125-116,240,39,80,.488,25,48,.521,14,32,.438,33,35,.943,125,41,94,.436,28,56,.500,13,38,.342,21,26,.808,116
287,DAL,2023-10-27,125,,BRK,W 125-120,240,44,91,.484,29,55,.527,15,36,.417,22,28,.786,125,45,92,.489,24,49,.490,21,43,.488,9,10,.900,120
288,UTA,2024-04-11,124,,HOU,W 124-121,240,44,87,.506,30,48,.625,14,39,.359,22,27,.815,124,40,95,.421,19,48,.396,21,47,.447,20,22,.909,121
289,BOS,2024-04-07,124,,POR,W 124-107,240,49,87,.563,33,49,.673,16,38,.421,10,13,.769,124,40,102,.392,26,64,.406,14,38,.368,13,13,1.000,107
290,CHO,2024-04-05,124,,ORL,W 124-115,240,43,72,.597,28,42,.667,15,30,.500,23,23,1.000,124,42,94,.447,33,56,.589,9,38,.237,22,26,.846,115
291,MEM,2024-03-27,124,,LAL,L 124-136,240,46,97,.474,29,54,.537,17,43,.395,15,19,.789,124,45,81,.556,27,48,.563,18,33,.545,28,35,.800,136
292,MIL,2024-03-26,124,,LAL,L 124-128 (2OT),290,49,119,.412,34,68,.500,15,51,.294,11,17,.647,124,42,108,.389,28,64,.438,14,44,.318,30,32,.938,128
293,NYK,2024-03-25,124,,DET,W 124-99,240,45,89,.506,26,43,.605,19,46,.413,15,22,.682,124,34,88,.386,24,54,.444,10,34,.294,21,22,.955,99
294,UTA,2024-03-15,124,,ATL,W 124-122,240,46,90,.511,32,54,.593,14,36,.389,18,20,.900,124,41,92,.446,21,53,.396,20,39,.513,20,27,.741,122
295,OKC,2024-03-10,124,,MEM,W 124-93,240,49,93,.527,28,46,.609,21,47,.447,5,5,1.000,124,32,78,.410,21,45,.467,11,33,.333,18,27,.667,93
296,DET,2024-03-09,124,,DAL,L 124-142,240,45,99,.455,32,62,.516,13,37,.351,21,25,.840,124,51,92,.554,37,54,.685,14,38,.368,26,32,.813,142
297,BRK,2024-02-29,124,,ATL,W 124-97,240,46,90,.511,24,44,.545,22,46,.478,10,13,.769,124,37,86,.430,29,58,.500,8,28,.286,15,21,.714,97
298,ATL,2024-02-27,124,,UTA,W 124-97,240,46,93,.495,34,61,.557,12,32,.375,20,23,.870,124,35,94,.372,24,56,.429,11,38,.289,16,19,.842,97
299,UTA,2024-02-06,124,,OKC,W 124-117,240,46,89,.517,32,54,.593,14,35,.400,18,20,.900,124,43,90,.478,24,53,.453,19,37,.514,12,18,.667,117
300,UTA,2024-02-01,124,,PHI,L 124-127,240,45,87,.517,33,51,.647,12,36,.333,22,25,.880,124,47,94,.500,33,62,.532,14,32,.438,19,21,.905,127
301,CHO,2024-01-19,124,,SAS,W 124-120,240,47,84,.560,31,55,.564,16,29,.552,14,16,.875,124,47,84,.560,32,52,.615,15,32,.469,11,17,.647,120
302,PHI,2024-01-15,124,,HOU,W 124-115,240,40,83,.482,25,52,.481,15,31,.484,29,34,.853,124,44,88,.500,36,61,.590,8,27,.296,19,32,.594,115
303,CHI,2024-01-10,124,,HOU,W 124-119 (OT),265,42,95,.442,23,48,.479,19,47,.404,21,25,.840,124,48,101,.475,37,56,.661,11,45,.244,12,20,.600,119
304,UTA,2024-01-10,124,,DEN,W 124-111,240,46,83,.554,33,50,.660,13,33,.394,19,23,.826,124,37,81,.457,24,48,.500,13,33,.394,24,28,.857,111
305,BRK,2024-01-05,124,,OKC,W 124-115,240,41,91,.451,27,52,.519,14,39,.359,28,33,.848,124,45,84,.536,36,53,.679,9,31,.290,16,24,.667,115
306,TOR,2024-01-01,124,,CLE,W 124-121,240,42,87,.483,31,57,.544,11,30,.367,29,40,.725,124,43,89,.483,31,53,.585,12,36,.333,23,26,.885,121
307,OKC,2023-12-31,124,,BRK,W 124-108,240,45,83,.542,27,50,.540,18,33,.545,16,20,.800,124,38,100,.380,26,54,.481,12,46,.261,20,31,.645,108
308,CLE,2023-12-20,124,,UTA,W 124-116,240,45,96,.469,22,45,.489,23,51,.451,11,16,.688,124,40,78,.513,27,48,.563,13,30,.433,23,28,.821,116
309,CHI,2023-12-20,124,,LAL,W 124-108,240,48,88,.545,30,54,.556,18,34,.529,10,11,.909,124,42,94,.447,30,57,.526,12,37,.324,12,15,.800,108
310,GSW,2023-12-16,124,,BRK,W 124-120,240,44,91,.484,27,59,.458,17,32,.531,19,20,.950,124,45,93,.484,28,50,.560,17,43,.395,13,15,.867,120
311,PHI,2023-12-15,124,,DET,W 124-92,240,41,98,.418,27,61,.443,14,37,.378,28,31,.903,124,35,81,.432,31,60,.517,4,21,.190,18,23,.783,92
312,DEN,2023-12-14,124,,BRK,W 124-101,240,47,99,.475,35,63,.556,12,36,.333,18,21,.857,124,39,95,.411,31,65,.477,8,30,.267,15,20,.750,101
313,BRK,2023-12-08,124,,WAS,W 124-97,240,50,104,.481,40,71,.563,10,33,.303,14,18,.778,124,38,91,.418,32,58,.552,6,33,.182,15,21,.714,97
314,CHI,2023-12-02,124,,NOP,W 124-118,240,48,88,.545,31,48,.646,17,40,.425,11,15,.733,124,41,82,.500,33,57,.579,8,25,.320,28,35,.800,118
315,NOP,2023-11-29,124,,PHI,W 124-114,240,42,78,.538,32,48,.667,10,30,.333,30,34,.882,124,42,81,.519,28,47,.596,14,34,.412,16,18,.889,114
316,SAC,2023-11-28,124,,GSW,W 124-123,240,41,91,.451,26,47,.553,15,44,.341,27,42,.643,124,40,83,.482,23,42,.548,17,41,.415,26,30,.867,123
317,MIA,2023-11-28,124,,MIL,L 124-131,240,48,94,.511,34,64,.531,14,30,.467,14,21,.667,124,47,88,.534,34,53,.642,13,35,.371,24,27,.889,131
318,BOS,2023-11-28,124,,CHI,W 124-97,240,47,90,.522,26,41,.634,21,49,.429,9,12,.750,124,39,90,.433,30,62,.484,9,28,.321,10,18,.556,97
319,ORL,2023-11-22,124,,DEN,W 124-119,240,44,81,.543,34,52,.654,10,29,.345,26,30,.867,124,44,93,.473,29,58,.500,15,35,.429,16,21,.762,119
320,BRK,2023-11-14,124,,ORL,W 124-104,240,46,85,.541,27,46,.587,19,39,.487,13,20,.650,124,36,82,.439,20,36,.556,16,46,.348,16,21,.762,104
321,NOP,2023-11-12,124,,DAL,L 124-136,240,47,92,.511,30,56,.536,17,36,.472,13,22,.591,124,50,102,.490,30,49,.612,20,53,.377,16,21,.762,136
322,DAL,2023-11-05,124,,CHO,W 124-118,240,43,91,.473,29,49,.592,14,42,.333,24,32,.750,124,49,99,.495,41,69,.594,8,30,.267,12,21,.571,118
323,IND,2023-11-04,124,,CHO,L 124-125,240,45,93,.484,23,48,.479,22,45,.489,12,16,.750,124,47,88,.534,39,68,.574,8,20,.400,23,23,1.000,125
324,OKC,2023-10-30,124,,DET,W 124-112,240,44,83,.530,31,54,.574,13,29,.448,23,28,.821,124,39,91,.429,24,63,.381,15,28,.536,19,24,.792,112
325,GSW,2024-04-14,123,,UTA,W 123-116,240,45,94,.479,31,51,.608,14,43,.326,19,23,.826,123,46,89,.517,32,55,.582,14,34,.412,10,16,.625,116
326,SAS,2024-04-14,123,,DET,W 123-95,240,49,91,.538,34,57,.596,15,34,.441,10,14,.714,123,36,92,.391,28,59,.475,8,33,.242,15,20,.750,95
327,SAC,2024-04-11,123,,NOP,L 123-135,240,46,84,.548,30,46,.652,16,38,.421,15,20,.750,123,49,86,.570,27,46,.587,22,40,.550,15,18,.833,135
328,TOR,2024-04-09,123,,IND,L 123-140,240,47,94,.500,42,73,.575,5,21,.238,24,33,.727,123,54,99,.545,38,54,.704,16,45,.356,16,23,.696,140
329,ATL,2024-03-28,123,,BOS,W 123-122 (OT),265,51,104,.490,36,60,.600,15,44,.341,6,10,.600,123,45,94,.479,31,58,.534,14,36,.389,18,21,.857,122
330,LAL,2024-03-08,123,,MIL,W 123-122,240,47,90,.522,31,56,.554,16,34,.471,13,19,.684,123,46,93,.495,30,52,.577,16,41,.390,14,17,.824,122
331,IND,2024-02-28,123,,NOP,W 123-114,240,50,102,.490,36,64,.563,14,38,.368,9,9,1.000,123,42,90,.467,31,61,.508,11,29,.379,19,23,.826,114
332,MIL,2024-02-27,123,,CHO,W 123-85,240,46,89,.517,30,49,.612,16,40,.400,15,18,.833,123,30,81,.370,19,41,.463,11,40,.275,14,17,.824,85
333,PHO,2024-02-25,123,,LAL,W 123-113,240,44,93,.473,27,53,.509,17,40,.425,18,19,.947,123,47,90,.522,32,55,.582,15,35,.429,4,8,.500,113
334,LAL,2024-02-23,123,,SAS,W 123-118,240,49,95,.516,38,68,.559,11,27,.407,14,18,.778,123,42,96,.438,27,58,.466,15,38,.395,19,23,.826,118
335,DAL,2024-02-22,123,,PHO,W 123-113,240,43,90,.478,24,46,.522,19,44,.432,18,21,.857,123,40,83,.482,25,47,.532,15,36,.417,18,24,.750,113
336,BRK,2024-02-10,123,,SAS,W 123-103,240,49,87,.563,32,53,.604,17,34,.500,8,11,.727,123,36,91,.396,25,57,.439,11,34,.324,20,21,.952,103
337,NYK,2024-02-06,123,,MEM,W 123-113,240,48,86,.558,37,59,.627,11,27,.407,16,20,.800,123,41,80,.513,20,43,.465,21,37,.568,10,16,.625,113
338,UTA,2024-02-04,123,,MIL,W 123-108,240,43,89,.483,26,45,.578,17,44,.386,20,24,.833,123,39,84,.464,24,43,.558,15,41,.366,15,25,.600,108
339,DET,2023-12-11,123,,IND,L 123-131,240,45,81,.556,35,52,.673,10,29,.345,23,30,.767,123,52,92,.565,39,61,.639,13,31,.419,14,19,.737,131
340,ORL,2023-12-08,123,,DET,W 123-91,240,49,89,.551,39,63,.619,10,26,.385,15,19,.789,123,34,81,.420,28,51,.549,6,30,.200,17,24,.708,91
341,SAC,2023-12-02,123,,DEN,W 123-117,240,48,99,.485,32,65,.492,16,34,.471,11,15,.733,123,49,99,.495,43,74,.581,6,25,.240,13,20,.650,117
342,OKC,2023-11-25,123,,PHI,L 123-127,240,43,98,.439,27,55,.491,16,43,.372,21,26,.808,123,38,83,.458,24,42,.571,14,41,.341,37,45,.822,127
343,PHO,2023-11-22,123,,GSW,W 123-115,240,34,76,.447,23,48,.479,11,28,.393,44,52,.846,123,43,90,.478,33,58,.569,10,32,.313,19,29,.655,115
344,GSW,2023-11-18,123,,OKC,L 123-130 (OT),265,44,97,.454,26,51,.510,18,46,.391,17,21,.810,123,52,100,.520,44,77,.571,8,23,.348,18,20,.900,130
345,OKC,2023-11-14,123,,SAS,W 123-87,240,46,89,.517,31,50,.620,15,39,.385,16,20,.800,123,36,93,.387,27,63,.429,9,30,.300,6,9,.667,87
346,MIN,2023-11-04,123,,UTA,W 123-95,240,45,81,.556,36,57,.632,9,24,.375,24,31,.774,123,35,91,.385,23,48,.479,12,43,.279,13,17,.765,95
347,DEN,2023-11-04,123,,CHI,W 123-101,240,42,81,.519,26,45,.578,16,36,.444,23,30,.767,123,39,86,.453,32,60,.533,7,26,.269,16,23,.696,101
348,LAC,2023-10-29,123,,SAS,W 123-83,240,47,91,.516,31,49,.633,16,42,.381,13,21,.619,123,30,80,.375,19,47,.404,11,33,.333,12,16,.750,83
349,LAC,2023-10-25,123,,POR,W 123-111,240,47,90,.522,31,56,.554,16,34,.471,13,16,.813,123,44,93,.473,34,61,.557,10,32,.313,13,17,.765,111
350,PHO,2024-04-03,122,,CLE,W 122-101,240,44,87,.506,26,54,.481,18,33,.545,16,17,.941,122,39,83,.470,32,57,.561,7,26,.269,16,19,.842,101
351,BOS,2024-03-20,122,,MIL,W 122-119,240,40,85,.471,22,45,.489,18,40,.450,24,29,.828,122,45,84,.536,28,49,.571,17,35,.486,12,14,.857,119
352,SAS,2024-03-17,122,,BRK,W 122-115 (OT),265,46,99,.465,37,62,.597,9,37,.243,21,23,.913,122,47,102,.461,39,71,.549,8,31,.258,13,19,.684,115
353,GSW,2024-03-07,122,,CHI,L 122-125,240,44,97,.454,33,55,.600,11,42,.262,23,28,.821,122,46,87,.529,30,51,.588,16,36,.444,17,23,.739,125
354,IND,2024-02-26,122,,TOR,L 122-130,240,46,100,.460,33,58,.569,13,42,.310,17,23,.739,122,53,96,.552,41,68,.603,12,28,.429,12,17,.706,130
355,UTA,2024-02-14,122,,LAL,L 122-138,240,49,101,.485,35,56,.625,14,45,.311,10,13,.769,122,52,91,.571,38,60,.633,14,31,.452,20,24,.833,138
356,CHO,2024-02-14,122,,ATL,W 122-99,240,44,89,.494,29,52,.558,15,37,.405,19,20,.950,122,36,89,.404,27,51,.529,9,38,.237,18,20,.900,99
357,ATL,2024-02-10,122,,HOU,W 122-113,240,40,88,.455,26,47,.553,14,41,.341,28,37,.757,122,44,100,.440,31,57,.544,13,43,.302,12,19,.632,113
358,POR,2024-02-08,122,,DET,L 122-128 (OT),265,41,89,.461,30,59,.508,11,30,.367,29,33,.879,122,45,93,.484,29,66,.439,16,27,.593,22,31,.710,128
359,IND,2024-02-02,122,,SAC,L 122-133,240,46,85,.541,36,56,.643,10,29,.345,20,24,.833,122,51,90,.567,38,56,.679,13,34,.382,18,28,.643,133
360,CHO,2024-01-27,122,,UTA,L 122-134,240,47,92,.511,34,60,.567,13,32,.406,15,21,.714,122,52,93,.559,35,52,.673,17,41,.415,13,17,.765,134
361,NYK,2024-01-25,122,,DEN,W 122-84,240,45,85,.529,30,47,.638,15,38,.395,17,20,.850,122,34,84,.405,29,58,.500,5,26,.192,11,13,.846,84
362,SAC,2024-01-22,122,,ATL,W 122-107,240,43,93,.462,31,55,.564,12,38,.316,24,27,.889,122,36,93,.387,22,53,.415,14,40,.350,21,27,.778,107
363,PHO,2024-01-03,122,,LAC,L 122-131,240,42,79,.532,27,44,.614,15,35,.429,23,26,.885,122,42,76,.553,24,42,.571,18,34,.529,29,32,.906,131
364,GSW,2023-12-30,122,,DAL,L 122-132,240,47,103,.456,28,55,.509,19,48,.396,9,13,.692,122,49,88,.557,33,48,.688,16,40,.400,18,22,.818,132
365,BRK,2023-12-27,122,,MIL,L 122-144,240,45,101,.446,38,69,.551,7,32,.219,25,29,.862,122,52,89,.584,29,38,.763,23,51,.451,17,23,.739,144
366,MIA,2023-12-22,122,,ATL,W 122-113,240,40,86,.465,23,47,.489,17,39,.436,25,30,.833,122,42,96,.438,23,42,.548,19,54,.352,10,14,.714,113
367,HOU,2023-12-22,122,,DAL,W 122-96,240,46,95,.484,35,57,.614,11,38,.289,19,23,.826,122,35,101,.347,28,61,.459,7,40,.175,19,26,.731,96
368,PHO,2023-12-15,122,,NYK,L 122-139,240,47,90,.522,36,62,.581,11,28,.393,17,21,.810,122,49,82,.598,32,53,.604,17,29,.586,24,28,.857,139
369,WAS,2023-12-13,122,,NOP,L 122-142,240,42,82,.512,23,38,.605,19,44,.432,19,24,.792,122,50,96,.521,34,62,.548,16,34,.471,26,30,.867,142
370,ATL,2023-12-11,122,,DEN,L 122-129,240,44,96,.458,27,52,.519,17,44,.386,17,18,.944,122,47,88,.534,35,59,.593,12,29,.414,23,29,.793,129
371,IND,2023-12-04,122,,BOS,W 122-112,240,43,94,.457,24,54,.444,19,40,.475,17,21,.810,122,46,97,.474,34,56,.607,12,41,.293,8,12,.667,112
372,MIA,2023-11-16,122,,BRK,W 122-115,240,42,81,.519,27,46,.587,15,35,.429,23,24,.958,122,40,85,.471,26,49,.531,14,36,.389,21,27,.778,115
373,MIN,2023-11-08,122,,NOP,W 122-101,240,45,82,.549,30,45,.667,15,37,.405,17,24,.708,122,36,93,.387,28,65,.431,8,28,.286,21,22,.955,101
374,HOU,2023-11-06,122,,SAC,W 122-97,240,43,75,.573,28,44,.636,15,31,.484,21,27,.778,122,36,81,.444,22,41,.537,14,40,.350,11,20,.550,97
375,MIL,2023-10-30,122,,MIA,W 122-114,240,44,87,.506,32,50,.640,12,37,.324,22,30,.733,122,41,86,.477,28,52,.538,13,34,.382,19,20,.950,114
376,SAC,2024-04-14,121,,POR,W 121-82,240,43,87,.494,30,53,.566,13,34,.382,22,27,.815,121,31,98,.316,24,53,.453,7,45,.156,13,17,.765,82
377,SAS,2024-04-12,121,,DEN,W 121-120,240,45,85,.529,30,52,.577,15,33,.455,16,23,.696,121,49,97,.505,36,61,.590,13,36,.361,9,10,.900,120
378,ATL,2024-04-03,121,,DET,W 121-113,240,49,90,.544,36,52,.692,13,38,.342,10,15,.667,121,43,94,.457,33,64,.516,10,30,.333,17,21,.810,113
379,MIA,2024-03-24,121,,CLE,W 121-84,240,43,83,.518,28,45,.622,15,38,.395,20,23,.870,121,30,72,.417,21,43,.488,9,29,.310,15,20,.750,84
380,ORL,2024-03-21,121,,NOP,W 121-106,240,47,86,.547,33,50,.660,14,36,.389,13,19,.684,121,42,78,.538,36,58,.621,6,20,.300,16,21,.762,106
381,SAC,2024-03-18,121,,MEM,W 121-111 (OT),265,42,94,.447,31,59,.525,11,35,.314,26,32,.813,121,37,98,.378,24,60,.400,13,38,.342,24,30,.800,111
382,LAL,2024-03-16,121,,GSW,L 121-128,240,47,92,.511,35,58,.603,12,34,.353,15,18,.833,121,51,97,.526,37,63,.587,14,34,.412,12,15,.800,128
383,IND,2024-03-16,121,,BRK,W 121-100,240,50,105,.476,44,75,.587,6,30,.200,15,16,.938,121,33,77,.429,23,52,.442,10,25,.400,24,31,.774,100
384,PHI,2024-03-01,121,,CHO,W 121-114,240,46,96,.479,27,52,.519,19,44,.432,10,11,.909,121,43,84,.512,29,51,.569,14,33,.424,14,17,.824,114
385,CLE,2024-02-27,121,,DAL,W 121-119,240,44,83,.530,24,43,.558,20,40,.500,13,18,.722,121,48,91,.527,34,58,.586,14,33,.424,9,15,.600,119
386,ATL,2024-02-23,121,,TOR,L 121-123,240,46,106,.434,34,67,.507,12,39,.308,17,24,.708,121,50,102,.490,35,63,.556,15,39,.385,8,8,1.000,123
387,TOR,2024-02-22,121,,BRK,W 121-93,240,41,84,.488,27,53,.509,14,31,.452,25,30,.833,121,33,80,.413,22,43,.512,11,37,.297,16,22,.727,93
388,MEM,2024-02-14,121,,HOU,W 121-113,240,39,79,.494,24,44,.545,15,35,.429,28,41,.683,121,42,102,.412,31,66,.470,11,36,.306,18,28,.643,113
389,CLE,2024-02-12,121,,PHI,L 121-123,240,44,92,.478,31,55,.564,13,37,.351,20,25,.800,121,48,88,.545,37,62,.597,11,26,.423,16,19,.842,123
390,PHI,2024-02-09,121,,ATL,L 121-127,240,42,98,.429,27,53,.509,15,45,.333,22,29,.759,121,42,81,.519,26,45,.578,16,36,.444,27,33,.818,127
391,MIA,2024-02-06,121,,ORL,W 121-95,240,47,87,.540,34,51,.667,13,36,.361,14,18,.778,121,35,80,.438,25,45,.556,10,35,.286,15,21,.714,95
392,PHI,2024-02-03,121,,BRK,L 121-136,240,44,96,.458,32,67,.478,12,29,.414,21,27,.778,121,49,95,.516,29,44,.659,20,51,.392,18,23,.783,136
393,MIN,2024-01-31,121,,DAL,W 121-87,240,45,80,.563,32,50,.640,13,30,.433,18,30,.600,121,31,76,.408,25,47,.532,6,29,.207,19,26,.731,87
394,SAC,2024-01-18,121,,IND,L 121-126,240,44,85,.518,29,48,.604,15,37,.405,18,32,.563,121,49,89,.551,36,56,.643,13,33,.394,15,19,.789,126
395,TOR,2024-01-17,121,,MIA,W 121-97,240,45,88,.511,25,50,.500,20,38,.526,11,18,.611,121,41,90,.456,35,62,.565,6,28,.214,9,12,.750,97
396,SAS,2024-01-04,121,,MIL,L 121-125,240,46,95,.484,32,55,.582,14,40,.350,15,17,.882,121,49,92,.533,37,58,.638,12,34,.353,15,19,.789,125
397,GSW,2024-01-02,121,,ORL,W 121-115,240,42,78,.538,29,43,.674,13,35,.371,24,37,.649,121,41,92,.446,27,56,.482,14,36,.389,19,23,.826,115
398,LAC,2024-01-01,121,,MIA,W 121-104,240,47,80,.588,33,51,.647,14,29,.483,13,14,.929,121,35,83,.422,24,49,.490,11,34,.324,23,29,.793,104
399,PHI,2023-12-22,121,,TOR,W 121-111,240,44,83,.530,30,52,.577,14,31,.452,19,21,.905,121,39,87,.448,30,54,.556,9,33,.273,24,28,.857,111
400,LAC,2023-12-14,121,,GSW,W 121-113,240,41,81,.506,28,49,.571,13,32,.406,26,30,.867,121,40,92,.435,24,47,.511,16,45,.356,17,19,.895,113
401,NOP,2023-12-11,121,,MIN,W 121-107,240,40,82,.488,30,55,.545,10,27,.370,31,40,.775,121,40,91,.440,27,55,.491,13,36,.361,14,19,.737,107
402,CLE,2023-12-06,121,,ORL,W 121-111,240,46,86,.535,32,52,.615,14,34,.412,15,20,.750,121,41,84,.488,39,61,.639,2,23,.087,27,37,.730,111
403,NOP,2023-12-01,121,,SAS,W 121-106,240,42,85,.494,32,54,.593,10,31,.323,27,29,.931,121,38,83,.458,22,44,.500,16,39,.410,14,17,.824,106
404,DAL,2023-11-28,121,,HOU,W 121-115,240,42,89,.472,30,55,.545,12,34,.353,25,29,.862,121,42,85,.494,34,56,.607,8,29,.276,23,29,.793,115
405,TOR,2023-11-24,121,,CHI,W 121-108,240,44,83,.530,31,44,.705,13,39,.333,20,27,.741,121,42,82,.512,30,55,.545,12,27,.444,12,19,.632,108
406,POR,2023-11-22,121,,UTA,W 121-105,240,47,92,.511,30,53,.566,17,39,.436,10,15,.667,121,37,79,.468,27,48,.563,10,31,.323,21,26,.808,105
407,GSW,2023-11-20,121,,HOU,W 121-116,240,36,77,.468,15,34,.441,21,43,.488,28,33,.848,121,44,95,.463,31,54,.574,13,41,.317,15,19,.789,116
408,CHO,2023-11-20,121,,BOS,W 121-118 (OT),265,46,104,.442,33,65,.508,13,39,.333,16,17,.941,121,42,97,.433,26,47,.553,16,50,.320,18,28,.643,118
409,CLE,2023-11-19,121,,DEN,W 121-109,240,45,82,.549,34,55,.618,11,27,.407,20,26,.769,121,39,82,.476,25,53,.472,14,29,.483,17,23,.739,109
410,BOS,2023-11-10,121,,BRK,W 121-107,240,41,94,.436,22,42,.524,19,52,.365,20,28,.714,121,38,85,.447,23,48,.479,15,37,.405,16,18,.889,107
411,MEM,2023-11-10,121,,UTA,L 121-127,240,46,101,.455,27,53,.509,19,48,.396,10,13,.769,121,41,76,.539,23,39,.590,18,37,.486,27,29,.931,127
412,SAC,2023-11-08,121,,POR,W 121-118 (OT),265,41,89,.461,30,52,.577,11,37,.297,28,38,.737,121,44,87,.506,36,65,.554,8,22,.364,22,29,.759,118
413,IND,2023-11-03,121,,CLE,W 121-116,240,45,86,.523,30,55,.545,15,31,.484,16,24,.667,121,44,84,.524,36,56,.643,8,28,.286,20,25,.800,116
414,MIA,2023-11-03,121,,WAS,W 121-114,240,48,80,.600,35,53,.660,13,27,.481,12,14,.857,121,46,81,.568,33,53,.623,13,28,.464,9,17,.529,114
415,PHO,2023-11-02,121,,SAS,L 121-132,240,43,80,.538,27,48,.563,16,32,.500,19,26,.731,121,51,98,.520,33,61,.541,18,37,.486,12,13,.923,132
416,CHO,2023-10-30,121,,BRK,L 121-133,240,47,96,.490,39,65,.600,8,31,.258,19,20,.950,121,49,87,.563,37,54,.685,12,33,.364,23,32,.719,133
417,NYK,2024-04-14,120,,CHI,W 120-119 (OT),265,46,91,.505,34,59,.576,12,32,.375,16,21,.762,120,49,101,.485,41,70,.586,8,31,.258,13,16,.813,119
418,MEM,2024-04-12,120,,LAL,L 120-123,240,43,95,.453,26,56,.464,17,39,.436,17,21,.810,120,42,81,.519,29,44,.659,13,37,.351,26,34,.765,123
419,PHI,2024-04-09,120,,DET,W 120-102,240,44,98,.449,31,61,.508,13,37,.351,19,23,.826,120,34,84,.405,20,54,.370,14,30,.467,20,24,.833,102
420,LAL,2024-04-09,120,,GSW,L 120-134,240,44,96,.458,32,61,.525,12,35,.343,20,24,.833,120,47,80,.588,21,39,.538,26,41,.634,14,21,.667,134
421,LAC,2024-04-07,120,,CLE,W 120-118,240,41,84,.488,27,49,.551,14,35,.400,24,24,1.000,120,42,88,.477,31,58,.534,11,30,.367,23,27,.852,118
422,NYK,2024-04-04,120,,SAC,W 120-109,240,44,80,.550,32,52,.615,12,28,.429,20,29,.690,120,42,86,.488,24,44,.545,18,42,.429,7,12,.583,109
423,WAS,2024-04-03,120,,LAL,L 120-125,240,45,91,.495,27,49,.551,18,42,.429,12,13,.923,120,46,91,.505,38,63,.603,8,28,.286,25,29,.862,125
424,TOR,2024-03-31,120,,PHI,L 120-135,240,47,90,.522,36,60,.600,11,30,.367,15,20,.750,120,49,83,.590,25,40,.625,24,43,.558,13,16,.813,135
425,ATL,2024-03-27,120,,POR,W 120-106,240,44,85,.518,28,44,.636,16,41,.390,16,20,.800,120,43,85,.506,29,54,.537,14,31,.452,6,10,.600,106
426,ATL,2024-03-25,120,,BOS,W 120-118,240,46,87,.529,28,51,.549,18,36,.500,10,17,.588,120,47,95,.495,36,57,.632,11,38,.289,13,19,.684,118
427,SAC,2024-03-13,120,,LAL,W 120-107,240,46,88,.523,27,47,.574,19,41,.463,9,12,.750,120,38,78,.487,24,46,.522,14,32,.438,17,22,.773,107
428,LAL,2024-03-10,120,,MIN,W 120-109,240,44,83,.530,34,59,.576,10,24,.417,22,29,.759,120,41,97,.423,25,51,.490,16,46,.348,11,13,.846,109
429,PHO,2024-03-07,120,,TOR,W 120-113,240,44,86,.512,29,51,.569,15,35,.429,17,20,.850,120,43,94,.457,27,50,.540,16,44,.364,11,15,.733,113
430,POR,2024-03-06,120,,OKC,L 120-128,240,41,81,.506,27,47,.574,14,34,.412,24,27,.889,120,43,74,.581,34,52,.654,9,22,.409,33,39,.846,128
431,LAL,2024-03-06,120,,SAC,L 120-130,240,42,81,.519,27,49,.551,15,32,.469,21,25,.840,120,54,97,.557,42,66,.636,12,31,.387,10,12,.833,130
432,DAL,2024-03-05,120,,IND,L 120-137,240,45,93,.484,32,54,.593,13,39,.333,17,21,.810,120,50,93,.538,32,54,.593,18,39,.462,19,24,.792,137
433,MIN,2024-03-01,120,,SAC,L 120-124 (OT),265,42,85,.494,30,54,.556,12,31,.387,24,32,.750,120,50,100,.500,39,71,.549,11,29,.379,13,24,.542,124
434,MIL,2024-02-09,120,,CHO,W 120-84,240,41,94,.436,23,42,.548,18,52,.346,20,24,.833,120,27,79,.342,20,50,.400,7,29,.241,23,29,.793,84
435,SAC,2024-02-07,120,,DET,L 120-133,240,45,95,.474,30,51,.588,15,44,.341,15,22,.682,120,47,84,.560,30,53,.566,17,31,.548,22,22,1.000,133
436,DEN,2024-02-02,120,,POR,W 120-108,240,46,91,.505,34,55,.618,12,36,.333,16,17,.941,120,37,80,.463,27,52,.519,10,28,.357,24,30,.800,108
437,BRK,2024-01-31,120,,PHO,L 120-136,240,47,94,.500,31,55,.564,16,39,.410,10,13,.769,120,49,79,.620,35,51,.686,14,28,.500,24,32,.750,136
438,DET,2024-01-28,120,,OKC,W 120-104,240,47,95,.495,36,69,.522,11,26,.423,15,19,.789,120,44,92,.478,36,64,.563,8,28,.286,8,12,.667,104
439,MIA,2024-01-10,120,,OKC,L 120-128,240,41,89,.461,26,53,.491,15,36,.417,23,28,.821,120,51,86,.593,37,53,.698,14,33,.424,12,16,.750,128
440,MIA,2024-01-08,120,,HOU,W 120-113,240,41,82,.500,26,46,.565,15,36,.417,23,32,.719,120,37,88,.420,23,47,.489,14,41,.341,25,28,.893,113
441,DEN,2024-01-05,120,,ORL,L 120-122,240,48,95,.505,39,62,.629,9,33,.273,15,19,.789,120,41,82,.500,24,46,.522,17,36,.472,23,34,.676,122
442,BOS,2023-12-29,120,,TOR,W 120-118,240,43,88,.489,26,49,.531,17,39,.436,17,20,.850,120,44,95,.463,27,51,.529,17,44,.386,13,20,.650,118
443,DEN,2023-12-25,120,,GSW,W 120-114,240,40,82,.488,26,48,.542,14,34,.412,26,32,.813,120,40,87,.460,26,47,.553,14,40,.350,20,23,.870,114
444,OKC,2023-12-23,120,,LAL,L 120-129,240,46,95,.484,33,54,.611,13,41,.317,15,19,.789,120,47,90,.522,31,58,.534,16,32,.500,19,23,.826,129
445,SAC,2023-12-22,120,,PHO,W 120-105,240,44,83,.530,32,45,.711,12,38,.316,20,26,.769,120,39,88,.443,34,63,.540,5,25,.200,22,28,.786,105
446,POR,2023-12-16,120,,DAL,L 120-131,240,47,94,.500,40,62,.645,7,32,.219,19,22,.864,120,48,97,.495,32,50,.640,16,47,.340,19,21,.905,131
447,BOS,2023-12-12,120,,CLE,W 120-113,240,38,84,.452,20,40,.500,18,44,.409,26,26,1.000,120,44,92,.478,25,47,.532,19,45,.422,6,9,.667,113
448,DAL,2023-12-02,120,,OKC,L 120-126,240,39,87,.448,20,35,.571,19,52,.365,23,35,.657,120,44,100,.440,24,56,.429,20,44,.455,18,22,.818,126
449,GSW,2023-11-30,120,,LAC,W 120-114,240,41,82,.500,26,43,.605,15,39,.385,23,31,.742,120,42,95,.442,30,63,.476,12,32,.375,18,24,.750,114
450,CHI,2023-11-30,120,,MIL,W 120-113 (OT),265,45,98,.459,32,61,.525,13,37,.351,17,22,.773,120,44,98,.449,28,50,.560,16,48,.333,9,13,.692,113
451,PHO,2023-11-21,120,,POR,W 120-107,240,43,76,.566,36,59,.610,7,17,.412,27,28,.964,120,38,87,.437,24,56,.429,14,31,.452,17,20,.850,107
452,NOP,2023-11-18,120,,MIN,L 120-121,240,44,86,.512,32,57,.561,12,29,.414,20,23,.870,120,43,80,.538,30,49,.612,13,31,.419,22,27,.815,121
453,SAS,2023-11-17,120,,SAC,L 120-129,240,43,92,.467,28,56,.500,15,36,.417,19,23,.826,120,46,85,.541,28,43,.651,18,42,.429,19,24,.792,129
454,DET,2023-11-14,120,,ATL,L 120-126,240,47,90,.522,37,61,.607,10,29,.345,16,23,.696,120,45,87,.517,33,54,.611,12,33,.364,24,26,.923,126
455,MIL,2023-11-08,120,,DET,W 120-118,240,41,90,.456,30,53,.566,11,37,.297,27,32,.844,120,48,98,.490,41,69,.594,7,29,.241,15,16,.938,118
456,ORL,2023-11-04,120,,LAL,W 120-101,240,46,101,.455,34,68,.500,12,33,.364,16,19,.842,120,37,84,.440,29,54,.537,8,30,.267,19,21,.905,101
457,UTA,2023-10-27,120,,LAC,W 120-118,240,42,96,.438,26,55,.473,16,41,.390,20,22,.909,120,41,77,.532,27,42,.643,14,35,.400,22,28,.786,118
458,ATL,2023-10-27,120,,NYK,L 120-126,240,42,87,.483,30,55,.545,12,32,.375,24,30,.800,120,43,90,.478,23,46,.500,20,44,.455,20,28,.714,126
459,WAS,2024-03-27,119,,BRK,L 119-122 (OT),265,46,91,.505,32,57,.561,14,34,.412,13,17,.765,119,47,98,.480,37,65,.569,10,33,.303,18,23,.783,122
460,OKC,2024-03-20,119,,UTA,W 119-107,240,43,88,.489,33,54,.611,10,34,.294,23,29,.793,119,40,90,.444,30,54,.556,10,36,.278,17,18,.944,107
461,BOS,2024-03-18,119,,DET,W 119-94,240,43,95,.453,21,46,.457,22,49,.449,11,13,.846,119,36,84,.429,27,55,.491,9,29,.310,13,15,.867,94
462,MIN,2024-03-04,119,,POR,W 119-114,240,40,79,.506,29,51,.569,11,28,.393,28,37,.757,119,45,92,.489,29,53,.547,16,39,.410,8,11,.727,114
463,POR,2024-01-31,119,,MIL,W 119-116,240,49,92,.533,37,64,.578,12,28,.429,9,9,1.000,119,45,92,.489,32,47,.681,13,45,.289,13,18,.722,116
464,GSW,2024-01-30,119,,PHI,W 119-107,240,44,79,.557,30,47,.638,14,32,.438,17,19,.895,119,39,85,.459,26,55,.473,13,30,.433,16,21,.762,107
465,PHO,2024-01-16,119,,SAC,W 119-117,240,42,85,.494,25,48,.521,17,37,.459,18,20,.900,119,46,92,.500,28,52,.538,18,40,.450,7,12,.583,117
466,MEM,2024-01-12,119,,LAC,L 119-128,240,41,95,.432,23,51,.451,18,44,.409,19,27,.704,119,49,89,.551,34,58,.586,15,31,.484,15,20,.750,128
467,WAS,2023-12-26,119,,ORL,L 119-127,240,43,87,.494,27,45,.600,16,42,.381,17,21,.810,119,49,93,.527,37,67,.552,12,26,.462,17,25,.680,127
468,MIA,2023-12-25,119,,PHI,W 119-113,240,40,84,.476,28,52,.538,12,32,.375,27,35,.771,119,40,94,.426,23,49,.469,17,45,.378,16,25,.640,113
469,ATL,2023-12-23,119,,MEM,L 119-125,240,45,96,.469,32,53,.604,13,43,.302,16,20,.800,119,50,97,.515,39,64,.609,11,33,.333,14,22,.636,125
470,TOR,2023-12-23,119,,UTA,L 119-126,240,45,94,.479,32,62,.516,13,32,.406,16,19,.842,119,48,91,.527,31,53,.585,17,38,.447,13,14,.929,126
471,SAC,2023-12-20,119,,BOS,L 119-144,240,43,91,.473,22,47,.468,21,44,.477,12,23,.522,119,51,92,.554,29,50,.580,22,42,.524,20,24,.833,144
472,SAS,2023-12-13,119,,LAL,L 119-122,240,45,96,.469,29,59,.492,16,37,.432,13,18,.722,119,49,91,.538,35,56,.625,14,35,.400,10,17,.588,122
473,LAC,2023-12-12,119,,SAC,W 119-99,240,44,84,.524,33,55,.600,11,29,.379,20,21,.952,119,36,86,.419,26,49,.531,10,37,.270,17,24,.708,99
474,PHO,2023-12-12,119,,GSW,W 119-116,240,38,84,.452,24,45,.533,14,39,.359,29,34,.853,119,41,92,.446,25,46,.543,16,46,.348,18,27,.667,116
475,CHO,2023-12-08,119,,TOR,W 119-116,240,44,79,.557,31,54,.574,13,25,.520,18,20,.900,119,47,93,.505,41,61,.672,6,32,.188,16,21,.762,116
476,MIL,2023-12-07,119,,IND,L 119-128,240,43,96,.448,31,63,.492,12,33,.364,21,28,.750,119,50,102,.490,43,69,.623,7,33,.212,21,25,.840,128
477,BOS,2023-11-22,119,,MIL,W 119-116,240,44,84,.524,27,42,.643,17,42,.405,14,17,.824,119,45,101,.446,32,67,.478,13,34,.382,13,17,.765,116
478,PHI,2023-11-21,119,,CLE,L 119-122 (OT),265,40,96,.417,29,61,.475,11,35,.314,28,34,.824,119,46,94,.489,37,69,.536,9,25,.360,21,25,.840,122
479,CHI,2023-11-12,119,,DET,W 119-108,240,44,91,.484,33,61,.541,11,30,.367,20,25,.800,119,38,88,.432,27,56,.482,11,32,.344,21,26,.808,108
480,PHO,2023-11-10,119,,LAL,L 119-122,240,42,94,.447,27,57,.474,15,37,.405,20,27,.741,119,42,84,.500,30,57,.526,12,27,.444,26,34,.765,122
481,ORL,2023-11-09,119,,ATL,L 119-120,240,42,90,.467,32,63,.508,10,27,.370,25,35,.714,119,41,85,.482,26,46,.565,15,39,.385,23,30,.767,120
482,BOS,2023-10-27,119,,MIA,W 119-111,240,45,95,.474,29,56,.518,16,39,.410,13,19,.684,119,38,89,.427,22,56,.393,16,33,.485,19,23,.826,111
483,SAS,2023-10-25,119,,DAL,L 119-126,240,46,89,.517,35,54,.648,11,35,.314,16,22,.727,119,47,99,.475,32,52,.615,15,47,.319,17,23,.739,126
484,DEN,2023-10-24,119,,LAL,W 119-107,240,48,91,.527,34,57,.596,14,34,.412,9,12,.750,119,41,90,.456,31,61,.508,10,29,.345,15,20,.750,107
485,MIA,2024-04-14,118,,TOR,W 118-103,240,46,87,.529,37,51,.725,9,36,.250,17,19,.895,118,38,90,.422,29,56,.518,9,34,.265,18,21,.857,103
486,HOU,2024-04-09,118,,ORL,W 118-106,240,45,86,.523,30,51,.588,15,35,.429,13,18,.722,118,39,86,.453,32,62,.516,7,24,.292,21,23,.913,106
487,GSW,2024-04-07,118,,UTA,W 118-110,240,49,92,.533,35,57,.614,14,35,.400,6,6,1.000,118,39,83,.470,24,48,.500,15,35,.429,17,21,.810,110
488,CHO,2024-04-07,118,,OKC,L 118-121,240,45,83,.542,28,43,.651,17,40,.425,11,14,.786,118,45,87,.517,27,51,.529,18,36,.500,13,17,.765,121
489,CHO,2024-03-31,118,,LAC,L 118-130,240,44,88,.500,21,36,.583,23,52,.442,7,11,.636,118,43,75,.573,29,46,.630,14,29,.483,30,34,.882,130
490,ORL,2024-03-30,118,,MEM,W 118-88,240,38,78,.487,16,34,.471,22,44,.500,20,23,.870,118,31,86,.360,19,50,.380,12,36,.333,14,17,.824,88
491,CHO,2024-03-27,118,,CLE,W 118-111,240,44,76,.579,31,43,.721,13,33,.394,17,22,.773,118,42,85,.494,23,41,.561,19,44,.432,8,14,.571,111
492,MIL,2024-03-24,118,,OKC,W 118-93,240,49,92,.533,38,58,.655,11,34,.324,9,14,.643,118,33,89,.371,23,46,.500,10,43,.233,17,22,.773,93
493,DET,2024-03-07,118,,BRK,W 118-112,240,43,82,.524,31,52,.596,12,30,.400,20,21,.952,118,41,84,.488,24,43,.558,17,41,.415,13,18,.722,112
494,MIA,2024-03-05,118,,DET,W 118-110,240,42,85,.494,28,54,.519,14,31,.452,20,23,.870,118,39,89,.438,27,47,.574,12,42,.286,20,22,.909,110
495,ORL,2024-02-14,118,,NYK,W 118-100,240,48,76,.632,36,50,.720,12,26,.462,10,11,.909,118,35,84,.417,24,55,.436,11,29,.379,19,24,.792,100
496,CHO,2024-02-05,118,,LAL,L 118-124,240,47,96,.490,34,64,.531,13,32,.406,11,14,.786,118,50,89,.562,42,55,.764,8,34,.235,16,19,.842,124
497,NYK,2024-01-30,118,,UTA,W 118-103,240,44,94,.468,31,60,.517,13,34,.382,17,18,.944,118,39,86,.453,27,50,.540,12,36,.333,13,17,.765,103
498,BOS,2024-01-29,118,,NOP,W 118-112,240,43,85,.506,26,39,.667,17,46,.370,15,20,.750,118,46,91,.505,36,56,.643,10,35,.286,10,13,.769,112
499,CLE,2024-01-29,118,,LAC,W 118-108,240,42,86,.488,29,46,.630,13,40,.325,21,26,.808,118,38,80,.475,27,46,.587,11,34,.324,21,28,.750,108
500,POR,2024-01-19,118,,IND,W 118-115,240,42,84,.500,38,72,.528,4,12,.333,30,35,.857,118,39,91,.429,19,44,.432,20,47,.426,17,25,.680,115
501,MIN,2024-01-18,118,,MEM,W 118-103,240,45,82,.549,33,54,.611,12,28,.429,16,21,.762,118,39,85,.459,25,51,.490,14,34,.412,11,17,.647,103
502,GSW,2024-01-07,118,,TOR,L 118-133,240,45,100,.450,31,54,.574,14,46,.304,14,15,.933,118,55,94,.585,40,61,.656,15,33,.455,8,14,.571,133
503,MIN,2023-12-28,118,,DAL,W 118-110,240,38,74,.514,21,41,.512,17,33,.515,25,34,.735,118,40,90,.444,26,57,.456,14,33,.424,16,19,.842,110
504,SAS,2023-12-26,118,,UTA,L 118-130,240,44,98,.449,28,63,.444,16,35,.457,14,21,.667,118,47,95,.495,31,52,.596,16,43,.372,20,22,.909,130
505,CHI,2023-12-26,118,,ATL,W 118-113,240,42,92,.457,35,67,.522,7,25,.280,27,31,.871,118,41,89,.461,28,44,.636,13,45,.289,18,21,.857,113
506,MIN,2023-12-21,118,,LAL,W 118-111,240,42,87,.483,28,51,.549,14,36,.389,20,25,.800,118,41,83,.494,31,59,.525,10,24,.417,19,24,.792,111
507,MIL,2023-12-21,118,,ORL,W 118-114,240,38,90,.422,27,53,.509,11,37,.297,31,35,.886,118,45,99,.455,37,66,.561,8,33,.242,16,23,.696,114
508,MIA,2023-12-16,118,,CHI,W 118-116,240,43,83,.518,30,48,.625,13,35,.371,19,25,.760,118,37,77,.481,21,39,.538,16,38,.421,26,29,.897,116
509,UTA,2023-12-02,118,,POR,W 118-113 (OT),265,46,94,.489,39,60,.650,7,34,.206,19,24,.792,118,38,95,.400,25,55,.455,13,40,.325,24,27,.889,113
510,NYK,2023-11-30,118,,DET,W 118-112,240,41,88,.466,25,47,.532,16,41,.390,20,28,.714,118,43,81,.531,28,46,.609,15,35,.429,11,17,.647,112
511,BRK,2023-11-26,118,,CHI,W 118-109,240,41,83,.494,16,30,.533,25,53,.472,11,15,.733,118,40,83,.482,28,51,.549,12,32,.375,17,22,.773,109
512,GSW,2023-11-24,118,,SAS,W 118-112,240,40,81,.494,21,39,.538,19,42,.452,19,24,.792,118,45,100,.450,33,53,.623,12,47,.255,10,12,.833,112
513,MIL,2023-11-13,118,,CHI,W 118-109,240,42,89,.472,27,42,.643,15,47,.319,19,27,.704,118,38,100,.380,24,58,.414,14,42,.333,19,21,.905,109
514,LAC,2023-10-31,118,,ORL,W 118-102,240,44,89,.494,30,58,.517,14,31,.452,16,23,.696,118,38,81,.469,31,51,.608,7,30,.233,19,33,.576,102
515,DET,2023-10-28,118,,CHI,W 118-102,240,45,86,.523,33,58,.569,12,28,.429,16,20,.800,118,39,93,.419,28,65,.431,11,28,.393,13,16,.813,102
516,MIL,2023-10-26,118,,PHI,W 118-117,240,41,81,.506,30,51,.588,11,30,.367,25,36,.694,118,41,80,.513,25,45,.556,16,35,.457,19,28,.679,117
517,MIL,2024-04-10,117,,ORL,W 117-99,240,43,84,.512,28,44,.636,15,40,.375,16,20,.800,117,36,78,.462,25,48,.521,11,30,.367,16,23,.696,99
518,CHI,2024-04-09,117,,NYK,L 117-128,240,47,88,.534,37,60,.617,10,28,.357,13,19,.684,117,46,83,.554,29,47,.617,17,36,.472,19,20,.950,128
519,IND,2024-04-07,117,,MIA,W 117-115,240,44,86,.512,35,54,.648,9,32,.281,20,21,.952,117,39,84,.464,31,57,.544,8,27,.296,29,32,.906,115
520,LAL,2024-04-07,117,,MIN,L 117-127,240,39,84,.464,28,53,.528,11,31,.355,28,32,.875,117,50,97,.515,35,58,.603,15,39,.385,12,14,.857,127
521,WAS,2024-04-02,117,,MIL,W 117-113,240,47,93,.505,38,55,.691,9,38,.237,14,17,.824,117,45,103,.437,34,55,.618,11,48,.229,12,18,.667,113
522,CLE,2024-03-29,117,,PHI,W 117-114,240,45,82,.549,29,45,.644,16,37,.432,11,13,.846,117,42,94,.447,26,54,.481,16,40,.400,14,17,.824,114
523,POR,2024-03-22,117,,LAC,L 117-125,240,45,93,.484,33,60,.550,12,33,.364,15,25,.600,117,44,77,.571,30,44,.682,14,33,.424,23,27,.852,125
524,HOU,2024-03-16,117,,CLE,W 117-103,240,47,98,.480,32,56,.571,15,42,.357,8,12,.667,117,37,82,.451,25,44,.568,12,38,.316,17,20,.850,103
525,LAC,2024-03-10,117,,MIL,L 117-124,240,47,104,.452,33,57,.579,14,47,.298,9,10,.900,117,43,87,.494,26,49,.531,17,38,.447,21,27,.778,124
526,UTA,2024-03-06,117,,CHI,L 117-119,240,44,96,.458,29,49,.592,15,47,.319,14,16,.875,117,45,90,.500,28,51,.549,17,39,.436,12,15,.800,119
527,SAS,2024-03-03,117,,IND,W 117-105,240,46,85,.541,36,60,.600,10,25,.400,15,19,.789,117,41,93,.441,35,63,.556,6,30,.200,17,21,.810,105
528,DEN,2024-02-28,117,,SAC,W 117-96,240,46,86,.535,31,51,.608,15,35,.429,10,11,.909,117,38,95,.400,26,60,.433,12,35,.343,8,13,.615,96
529,BOS,2024-02-27,117,,PHI,W 117-99,240,39,74,.527,34,52,.654,5,22,.227,34,37,.919,117,37,94,.394,23,52,.442,14,42,.333,11,12,.917,99
530,CHO,2024-02-07,117,,TOR,L 117-123,240,44,90,.489,28,51,.549,16,39,.410,13,20,.650,117,43,81,.531,26,48,.542,17,33,.515,20,24,.833,123
531,DAL,2024-02-03,117,,MIL,L 117-129,240,40,81,.494,24,42,.571,16,39,.410,21,23,.913,117,50,88,.568,38,58,.655,12,30,.400,17,25,.680,129
532,PHO,2024-01-21,117,,IND,W 117-110,240,47,82,.573,39,57,.684,8,25,.320,15,18,.833,117,41,94,.436,27,63,.429,14,31,.452,14,23,.609,110
533,BOS,2024-01-17,117,,SAS,W 117-98,240,42,90,.467,24,52,.462,18,38,.474,15,19,.789,117,39,93,.419,32,59,.542,7,34,.206,13,16,.813,98
534,DET,2024-01-17,117,,MIN,L 117-124,240,46,89,.517,34,58,.586,12,31,.387,13,19,.684,117,47,93,.505,32,63,.508,15,30,.500,15,21,.714,124
535,WAS,2024-01-15,117,,DET,L 117-129,240,44,95,.463,25,54,.463,19,41,.463,10,11,.909,117,50,90,.556,38,59,.644,12,31,.387,17,23,.739,129
536,DEN,2024-01-14,117,,IND,W 117-109,240,46,71,.648,36,51,.706,10,20,.500,15,23,.652,117,43,92,.467,35,63,.556,8,29,.276,15,22,.682,109
537,ORL,2024-01-07,117,,ATL,W 117-110 (OT),265,43,98,.439,26,57,.456,17,41,.415,14,22,.636,117,42,91,.462,33,61,.541,9,30,.300,17,29,.586,110
538,CLE,2024-01-07,117,,SAS,W 117-115,240,43,88,.489,27,45,.600,16,43,.372,15,21,.714,117,41,86,.477,27,49,.551,14,37,.378,19,22,.864,115
539,UTA,2023-12-30,117,,MIA,W 117-109,240,43,93,.462,32,52,.615,11,41,.268,20,28,.714,117,34,78,.436,25,47,.532,9,31,.290,32,40,.800,109
540,ORL,2023-12-29,117,,NYK,W 117-108,240,40,89,.449,33,56,.589,7,33,.212,30,40,.750,117,38,86,.442,32,56,.571,6,30,.200,26,29,.897,108
541,LAC,2023-12-29,117,,MEM,W 117-106,240,43,87,.494,32,48,.667,11,39,.282,20,25,.800,117,38,87,.437,25,47,.532,13,40,.325,17,20,.850,106
542,HOU,2023-12-26,117,,IND,L 117-123,240,47,97,.485,42,73,.575,5,24,.208,18,22,.818,117,43,82,.524,24,39,.615,19,43,.442,18,21,.857,123
543,BRK,2023-12-22,117,,DEN,L 117-122,240,43,89,.483,30,56,.536,13,33,.394,18,26,.692,117,45,87,.517,34,61,.557,11,26,.423,21,25,.840,122
544,POR,2023-12-21,117,,WAS,L 117-118,240,43,95,.453,29,65,.446,14,30,.467,17,23,.739,117,42,84,.500,30,54,.556,12,30,.400,22,32,.688,118
545,DEN,2023-12-16,117,,OKC,L 117-118,240,42,93,.452,30,61,.492,12,32,.375,21,24,.875,117,43,84,.512,36,63,.571,7,21,.333,25,30,.833,118
546,HOU,2023-12-13,117,,MEM,W 117-104,240,39,86,.453,27,54,.500,12,32,.375,27,37,.730,117,35,82,.427,25,44,.568,10,38,.263,24,34,.706,104
547,UTA,2023-12-13,117,,NYK,W 117-113,240,43,98,.439,27,56,.482,16,42,.381,15,21,.714,117,41,94,.436,32,55,.582,9,39,.231,22,32,.688,113
548,SAC,2023-12-04,117,,NOP,L 117-127,240,38,85,.447,24,44,.545,14,41,.341,27,33,.818,117,47,87,.540,33,56,.589,14,31,.452,19,23,.826,127
549,CHO,2023-12-02,117,,MIN,L 117-123,240,44,91,.484,32,66,.485,12,25,.480,17,19,.895,117,43,84,.512,32,53,.604,11,31,.355,26,30,.867,123
550,SAC,2023-11-29,117,,LAC,L 117-131,240,40,86,.465,27,45,.600,13,41,.317,24,28,.857,117,50,93,.538,36,65,.554,14,28,.500,17,22,.773,131
551,NOP,2023-11-22,117,,SAC,W 117-112,240,41,87,.471,34,57,.596,7,30,.233,28,37,.757,117,34,76,.447,19,32,.594,15,44,.341,29,35,.829,112
552,CHO,2023-11-22,117,,WAS,W 117-114,240,43,91,.473,27,54,.500,16,37,.432,15,21,.714,117,44,97,.454,33,65,.508,11,32,.344,15,18,.833,114
553,MIN,2023-11-20,117,,NYK,W 117-100,240,41,80,.513,30,46,.652,11,34,.324,24,32,.750,117,32,92,.348,23,54,.426,9,38,.237,27,34,.794,100
554,WAS,2023-11-15,117,,DAL,L 117-130,240,43,89,.483,31,53,.585,12,36,.333,19,23,.826,117,48,92,.522,31,50,.620,17,42,.405,17,29,.586,130
555,BOS,2023-11-11,117,,TOR,W 117-94,240,47,86,.547,32,42,.762,15,44,.341,8,13,.615,117,35,91,.385,25,54,.463,10,37,.270,14,16,.875,94
556,WAS,2023-11-10,117,,CHO,L 117-124,240,43,88,.489,29,50,.580,14,38,.368,17,20,.850,117,50,110,.455,44,82,.537,6,28,.214,18,28,.643,124
557,DEN,2024-04-10,116,,MIN,W 116-107,240,46,83,.554,35,58,.603,11,25,.440,13,23,.565,116,41,82,.500,28,52,.538,13,30,.433,12,21,.571,107
558,LAL,2024-04-06,116,,CLE,W 116-97,240,45,80,.563,29,43,.674,16,37,.432,10,16,.625,116,39,90,.433,28,55,.509,11,35,.314,8,12,.667,97
559,LAC,2024-03-25,116,,IND,L 116-133,240,46,85,.541,40,65,.615,6,20,.300,18,22,.818,116,50,86,.581,33,58,.569,17,28,.607,16,22,.727,133
560,HOU,2024-03-06,116,,LAC,L 116-122,240,45,94,.479,29,57,.509,16,37,.432,10,17,.588,116,44,80,.550,32,51,.627,12,29,.414,22,26,.846,122
561,LAL,2024-03-04,116,,OKC,W 116-104,240,41,80,.513,25,46,.543,16,34,.471,18,25,.720,116,37,94,.394,22,55,.400,15,39,.385,15,16,.938,104
562,DAL,2024-03-03,116,,PHI,L 116-120,240,40,86,.465,24,45,.533,16,41,.390,20,23,.870,116,40,88,.455,29,51,.569,11,37,.297,29,31,.935,120
563,DAL,2024-02-14,116,,SAS,W 116-93,240,49,92,.533,38,62,.613,11,30,.367,7,10,.700,116,36,100,.360,26,60,.433,10,40,.250,11,15,.733,93
564,PHO,2024-02-14,116,,DET,W 116-100,240,35,77,.455,25,46,.543,10,31,.323,36,44,.818,116,38,99,.384,28,62,.452,10,37,.270,14,22,.636,100
565,MIA,2024-02-07,116,,SAS,W 116-104,240,43,87,.494,31,49,.633,12,38,.316,18,23,.783,116,41,90,.456,29,53,.547,12,37,.324,10,17,.588,104
566,IND,2024-01-28,116,,MEM,W 116-110,240,44,90,.489,31,55,.564,13,35,.371,15,16,.938,116,38,82,.463,27,52,.519,11,30,.367,23,31,.742,110
567,SAS,2024-01-26,116,,POR,W 116-100,240,42,92,.457,32,58,.552,10,34,.294,22,26,.846,116,38,90,.422,28,53,.528,10,37,.270,14,19,.737,100
568,MEM,2024-01-15,116,,GSW,W 116-107,240,32,86,.372,12,32,.375,20,54,.370,32,40,.800,116,44,90,.489,34,59,.576,10,31,.323,9,10,.900,107
569,POR,2024-01-14,116,,PHO,L 116-127,240,40,89,.449,20,47,.426,20,42,.476,16,22,.727,116,46,76,.605,33,48,.688,13,28,.464,22,27,.815,127
570,SAS,2024-01-13,116,,CHI,L 116-122,240,39,95,.411,21,49,.429,18,46,.391,20,23,.870,116,46,90,.511,31,56,.554,15,34,.441,15,20,.750,122
571,MIN,2024-01-12,116,,POR,W 116-93,240,44,80,.550,33,49,.673,11,31,.355,17,24,.708,116,30,77,.390,20,49,.408,10,28,.357,23,34,.676,93
572,MIL,2024-01-08,116,,UTA,L 116-132,240,42,94,.447,25,58,.431,17,36,.472,15,19,.789,116,47,90,.522,27,46,.587,20,44,.455,18,22,.818,132
573,NYK,2024-01-03,116,,CHI,W 116-100,240,46,89,.517,31,51,.608,15,38,.395,9,11,.818,116,37,89,.416,24,57,.421,13,32,.406,13,16,.813,100
574,MEM,2023-12-21,116,,IND,W 116-103,240,43,84,.512,27,49,.551,16,35,.457,14,21,.667,116,38,90,.422,20,38,.526,18,52,.346,9,11,.818,103
575,OKC,2023-12-18,116,,MEM,W 116-97,240,42,92,.457,31,56,.554,11,36,.306,21,23,.913,116,30,85,.353,11,31,.355,19,54,.352,18,21,.857,97
576,BOS,2023-12-14,116,,CLE,W 116-107,240,43,85,.506,30,49,.612,13,36,.361,17,20,.850,116,40,83,.482,29,50,.580,11,33,.333,16,17,.941,107
577,MIA,2023-12-14,116,,CHI,L 116-124,240,37,80,.463,22,46,.478,15,34,.441,27,35,.771,116,45,93,.484,31,57,.544,14,36,.389,20,30,.667,124
578,PHO,2023-12-02,116,,MEM,W 116-109,240,36,83,.434,27,57,.474,9,26,.346,35,43,.814,116,39,86,.453,30,55,.545,9,31,.290,22,24,.917,109
579,OKC,2023-11-22,116,,CHI,W 116-102,240,37,75,.493,26,46,.565,11,29,.379,31,38,.816,116,34,88,.386,17,44,.386,17,44,.386,17,17,1.000,102
580,IND,2023-11-19,116,,ORL,L 116-128,240,42,95,.442,34,64,.531,8,31,.258,24,31,.774,116,43,87,.494,36,67,.537,7,20,.350,35,42,.833,128
581,ATL,2023-11-17,116,,PHI,L 116-126,240,40,89,.449,28,56,.500,12,33,.364,24,30,.800,116,43,88,.489,30,58,.517,13,30,.433,27,28,.964,126
582,LAL,2023-11-12,116,,POR,W 116-110,240,41,84,.488,37,65,.569,4,19,.211,30,37,.811,116,45,90,.500,32,53,.604,13,37,.351,7,9,.778,110
583,CHO,2023-11-08,116,,WAS,L 116-132,240,41,79,.519,33,54,.611,8,25,.320,26,35,.743,116,47,97,.485,29,54,.537,18,43,.419,20,25,.800,132
584,DAL,2023-11-08,116,,TOR,L 116-127,240,40,84,.476,23,43,.535,17,41,.415,19,31,.613,116,49,99,.495,38,63,.603,11,36,.306,18,27,.667,127
585,SAS,2023-11-05,116,,TOR,L 116-123 (OT),265,48,96,.500,38,64,.594,10,32,.313,10,13,.769,116,44,97,.454,25,49,.510,19,48,.396,16,26,.615,123
586,ORL,2023-10-25,116,,HOU,W 116-86,240,42,87,.483,33,53,.623,9,34,.265,23,26,.885,116,32,79,.405,20,45,.444,12,34,.353,10,16,.625,86
587,CHO,2023-10-25,116,,ATL,W 116-110,240,43,86,.500,32,49,.653,11,37,.297,19,26,.731,116,39,93,.419,34,64,.531,5,29,.172,27,33,.818,110
588,BRK,2024-04-03,115,,IND,W 115-111,240,42,87,.483,30,55,.545,12,32,.375,19,27,.704,115,46,103,.447,36,65,.554,10,38,.263,9,11,.818,111
589,CLE,2024-03-25,115,,CHO,W 115-92,240,46,86,.535,29,45,.644,17,41,.415,6,10,.600,115,34,80,.425,25,52,.481,9,28,.321,15,18,.833,92
590,MIL,2024-03-21,115,,BRK,W 115-108,240,43,91,.473,27,50,.540,16,41,.390,13,15,.867,115,41,92,.446,28,48,.583,13,44,.295,13,16,.813,108
591,PHO,2024-03-20,115,,PHI,W 115-102,240,45,90,.500,26,51,.510,19,39,.487,6,8,.750,115,41,95,.432,28,58,.483,13,37,.351,7,18,.389,102
592,DEN,2024-03-07,115,,BOS,W 115-109,240,45,90,.500,41,69,.594,4,21,.190,21,22,.955,115,41,91,.451,30,53,.566,11,38,.289,16,25,.640,109
593,ORL,2024-02-29,115,,UTA,W 115-107,240,42,77,.545,32,47,.681,10,30,.333,21,31,.677,115,34,80,.425,18,43,.419,16,37,.432,23,28,.821,107
594,CHO,2024-02-10,115,,MEM,W 115-106,240,47,82,.573,31,51,.608,16,31,.516,5,7,.714,115,43,92,.467,27,48,.563,16,44,.364,4,8,.500,106
595,CHI,2024-02-03,115,,SAC,L 115-123,240,42,91,.462,31,57,.544,11,34,.324,20,22,.909,115,42,84,.500,27,45,.600,15,39,.385,24,29,.828,123
596,MIA,2024-01-31,115,,SAC,W 115-106,240,42,84,.500,29,56,.518,13,28,.464,18,23,.783,115,41,93,.441,29,53,.547,12,40,.300,12,18,.667,106
597,DAL,2024-01-27,115,,SAC,L 115-120,240,43,98,.439,27,52,.519,16,46,.348,13,18,.722,115,43,80,.538,32,50,.640,11,30,.367,23,30,.767,120
598,PHO,2024-01-22,115,,CHI,W 115-113,240,44,85,.518,30,51,.588,14,34,.412,13,17,.765,115,45,93,.484,31,56,.554,14,37,.378,9,14,.643,113
599,DAL,2024-01-07,115,,MIN,W 115-108,240,43,95,.453,28,55,.509,15,40,.375,14,20,.700,115,41,94,.436,28,53,.528,13,41,.317,13,21,.619,108
600,PHO,2024-01-07,115,,MEM,L 115-121,240,46,102,.451,38,74,.514,8,28,.286,15,22,.682,115,43,97,.443,26,48,.542,17,49,.347,18,24,.750,121
601,NOP,2023-12-26,115,,MEM,L 115-116 (OT),265,42,97,.433,32,66,.485,10,31,.323,21,33,.636,115,39,90,.433,28,44,.636,11,46,.239,27,32,.844,116
602,LAL,2023-12-25,115,,BOS,L 115-126,240,43,90,.478,30,58,.517,13,32,.406,16,21,.762,115,46,91,.505,33,49,.673,13,42,.310,21,28,.750,126
603,MIA,2023-12-13,115,,CHO,W 115-104,240,41,86,.477,26,56,.464,15,30,.500,18,19,.947,115,41,77,.532,29,46,.630,12,31,.387,10,11,.909,104
604,NYK,2023-11-28,115,,CHO,W 115-91,240,41,88,.466,26,50,.520,15,38,.395,18,20,.900,115,37,89,.416,24,58,.414,13,31,.419,4,7,.571,91
605,BRK,2023-11-28,115,,TOR,W 115-103,240,40,89,.449,27,51,.529,13,38,.342,22,26,.846,115,39,101,.386,26,65,.400,13,36,.361,12,19,.632,103
606,CLE,2023-11-25,115,,LAL,L 115-121,240,43,91,.473,34,63,.540,9,28,.321,20,23,.870,115,47,90,.522,38,63,.603,9,27,.333,18,21,.857,121
607,NOP,2023-11-17,115,,DEN,W 115-110,240,46,88,.523,34,65,.523,12,23,.522,11,21,.524,115,47,96,.490,37,56,.661,10,40,.250,6,12,.500,110
608,UTA,2023-11-14,115,,POR,W 115-99,240,44,95,.463,31,52,.596,13,43,.302,14,15,.933,115,37,88,.420,26,53,.491,11,35,.314,14,20,.700,99
609,CHI,2023-11-08,115,,PHO,L 115-116 (OT),265,42,96,.438,28,63,.444,14,33,.424,17,23,.739,115,38,90,.422,19,42,.452,19,48,.396,21,25,.840,116
610,CLE,2023-11-05,115,,GSW,W 115-104,240,41,83,.494,30,46,.652,11,37,.297,22,28,.786,115,34,94,.362,18,53,.340,16,41,.390,20,30,.667,104
611,POR,2023-11-03,115,,MEM,W 115-113 (OT),265,39,96,.406,30,64,.469,9,32,.281,28,36,.778,115,47,96,.490,37,61,.607,10,35,.286,9,13,.692,113
612,ATL,2024-04-10,114,,CHO,L 114-115,240,43,82,.524,25,42,.595,18,40,.450,10,16,.625,114,40,79,.506,26,43,.605,14,36,.389,21,22,.955,115
613,MIN,2024-03-24,114,,GSW,W 114-110,240,40,84,.476,19,44,.432,21,40,.525,13,18,.722,114,38,85,.447,24,49,.490,14,36,.389,20,26,.769,110
614,WAS,2024-03-19,114,,HOU,L 114-137,240,42,98,.429,27,59,.458,15,39,.385,15,20,.750,114,47,91,.516,34,52,.654,13,39,.333,30,36,.833,137
615,MIL,2024-03-14,114,,PHI,W 114-105,240,39,72,.542,23,36,.639,16,36,.444,20,24,.833,114,39,79,.494,22,44,.500,17,35,.486,10,14,.714,105
616,ORL,2024-03-13,114,,BRK,W 114-106,240,40,77,.519,26,45,.578,14,32,.438,20,26,.769,114,38,81,.469,31,55,.564,7,26,.269,23,27,.852,106
617,DET,2024-03-11,114,,CHO,W 114-97,240,41,86,.477,31,44,.705,10,42,.238,22,24,.917,114,34,88,.386,21,48,.438,13,40,.325,16,23,.696,97
618,DAL,2024-03-07,114,,MIA,W 114-108,240,40,87,.460,24,46,.522,16,41,.390,18,23,.783,114,40,82,.488,23,44,.523,17,38,.447,11,17,.647,108
619,HOU,2024-03-05,114,,SAS,W 114-101,240,49,105,.467,40,71,.563,9,34,.265,7,11,.636,114,38,87,.437,26,51,.510,12,36,.333,13,16,.813,101
620,LAL,2024-03-02,114,,DEN,L 114-124,240,47,89,.528,35,60,.583,12,29,.414,8,11,.727,114,54,92,.587,43,66,.652,11,26,.423,5,7,.714,124
621,BRK,2024-03-02,114,,ATL,W 114-102,240,41,88,.466,26,56,.464,15,32,.469,17,22,.773,114,37,87,.425,26,53,.491,11,34,.324,17,23,.739,102
622,MIN,2024-02-27,114,,SAS,W 114-105,240,43,93,.462,30,62,.484,13,31,.419,15,17,.882,114,39,82,.476,23,41,.561,16,41,.390,11,15,.733,105
623,HOU,2024-02-23,114,,PHO,W 114-110,240,37,93,.398,22,48,.458,15,45,.333,25,34,.735,114,38,95,.400,31,64,.484,7,31,.226,27,35,.771,110
624,ORL,2024-02-10,114,,CHI,W 114-108 (OT),265,41,88,.466,28,49,.571,13,39,.333,19,26,.731,114,43,99,.434,31,62,.500,12,37,.324,10,14,.714,108
625,PHO,2024-02-06,114,,MIL,W 114-106,240,44,87,.506,36,59,.610,8,28,.286,18,27,.667,114,39,90,.433,26,50,.520,13,40,.325,15,25,.600,106
626,SAS,2024-01-24,114,,OKC,L 114-140,240,43,86,.500,34,54,.630,9,32,.281,19,25,.760,114,54,96,.563,36,56,.643,18,40,.450,14,16,.875,140
627,CLE,2024-01-05,114,,WAS,W 114-90,240,41,77,.532,25,44,.568,16,33,.485,16,23,.696,114,35,84,.417,26,54,.481,9,30,.300,11,15,.733,90
628,PHO,2023-12-25,114,,DAL,L 114-128,240,40,90,.444,26,49,.531,14,41,.341,20,25,.800,114,45,84,.536,29,40,.725,16,44,.364,22,30,.733,128
629,CHI,2023-12-21,114,,SAS,W 114-95,240,49,90,.544,42,62,.677,7,28,.250,9,11,.818,114,37,81,.457,27,51,.529,10,30,.333,11,16,.688,95
630,TOR,2023-12-18,114,,CHO,W 114-99,240,44,86,.512,36,57,.632,8,29,.276,18,22,.818,114,39,89,.438,31,57,.544,8,32,.250,13,13,1.000,99
631,POR,2023-12-17,114,,GSW,L 114-118,240,40,85,.471,27,50,.540,13,35,.371,21,23,.913,114,46,87,.529,33,49,.673,13,38,.342,13,19,.684,118
632,BOS,2023-12-17,114,,ORL,W 114-97,240,45,95,.474,28,59,.475,17,36,.472,7,8,.875,114,34,89,.382,23,53,.434,11,36,.306,18,24,.750,97
633,POR,2023-12-14,114,,UTA,L 114-122,240,43,103,.417,27,58,.466,16,45,.356,12,18,.667,114,49,92,.533,38,59,.644,11,33,.333,13,14,.929,122
634,CHO,2023-12-11,114,,MIA,L 114-116,240,40,84,.476,23,43,.535,17,41,.415,17,22,.773,114,37,77,.481,22,42,.524,15,35,.429,27,34,.794,116
635,UTA,2023-11-27,114,,NOP,W 114-112,240,37,88,.420,20,40,.500,17,48,.354,23,28,.821,114,44,88,.500,37,66,.561,7,22,.318,17,25,.680,112
636,ATL,2023-11-15,114,,NYK,L 114-116,240,41,75,.547,29,44,.659,12,31,.387,20,26,.769,114,45,94,.479,29,60,.483,16,34,.471,10,11,.909,116
637,BOS,2023-11-13,114,,NYK,W 114-98,240,40,79,.506,21,36,.583,19,43,.442,15,16,.938,114,33,79,.418,18,44,.409,15,35,.429,17,24,.708,98
638,MIN,2023-11-06,114,,BOS,W 114-109 (OT),265,44,85,.518,31,48,.646,13,37,.351,13,25,.520,114,36,92,.391,25,53,.472,11,39,.282,26,34,.765,109
639,BRK,2023-11-04,114,,BOS,L 114-124,240,43,100,.430,26,48,.542,17,52,.327,11,17,.647,114,43,90,.478,28,45,.622,15,45,.333,23,27,.852,124
640,PHI,2023-11-02,114,,TOR,W 114-99,240,42,92,.457,33,67,.493,9,25,.360,21,25,.840,114,38,79,.481,28,51,.549,10,28,.357,13,19,.684,99
641,DAL,2023-11-01,114,,CHI,W 114-105,240,37,81,.457,17,33,.515,20,48,.417,20,28,.714,114,42,89,.472,31,56,.554,11,33,.333,10,11,.909,105
642,PHO,2023-10-31,114,,SAS,L 114-115,240,42,83,.506,24,44,.545,18,39,.462,12,15,.800,114,43,92,.467,29,55,.527,14,37,.378,15,20,.750,115
643,SAC,2023-10-27,114,,GSW,L 114-122,240,41,94,.436,29,54,.537,12,40,.300,20,29,.690,114,48,87,.552,34,55,.618,14,32,.438,12,14,.857,122
644,UTA,2023-10-25,114,,SAC,L 114-130,240,41,91,.451,32,63,.508,9,28,.321,23,31,.742,114,47,102,.461,28,51,.549,19,51,.373,17,20,.850,130
645,ORL,2024-04-14,113,,MIL,W 113-88,240,42,85,.494,31,50,.620,11,35,.314,18,19,.947,113,30,75,.400,23,48,.479,7,27,.259,21,23,.913,88
646,ORL,2024-04-07,113,,CHI,W 113-98,240,42,90,.467,31,56,.554,11,34,.324,18,19,.947,113,38,75,.507,32,55,.582,6,20,.300,16,22,.727,98
647,BRK,2024-04-06,113,,DET,W 113-103,240,38,73,.521,27,46,.587,11,27,.407,26,33,.788,113,42,92,.457,25,53,.472,17,39,.436,2,4,.500,103
648,UTA,2024-04-02,113,,CLE,L 113-129,240,41,85,.482,25,48,.521,16,37,.432,15,18,.833,113,46,85,.541,30,46,.652,16,39,.410,21,24,.875,129
649,MIN,2024-04-02,113,,HOU,W 113-106,240,41,77,.532,30,51,.588,11,26,.423,20,22,.909,113,41,92,.446,27,44,.614,14,48,.292,10,14,.714,106
650,SAS,2024-03-31,113,,GSW,L 113-117,240,40,89,.449,23,46,.500,17,43,.395,16,18,.889,113,45,92,.489,29,53,.547,16,39,.410,11,13,.846,117
651,ATL,2024-03-30,113,,MIL,L 113-122,240,42,92,.457,28,57,.491,14,35,.400,15,18,.833,113,43,78,.551,35,50,.700,8,28,.286,28,35,.800,122
652,CHI,2024-03-23,113,,BOS,L 113-124,240,47,82,.573,38,58,.655,9,24,.375,10,11,.909,113,44,86,.512,23,38,.605,21,48,.438,15,17,.882,124
653,DEN,2024-03-21,113,,NYK,W 113-100,240,45,84,.536,39,64,.609,6,20,.300,17,20,.850,113,38,79,.481,27,48,.563,11,31,.355,13,17,.765,100
654,DAL,2024-03-21,113,,UTA,W 113-97,240,43,86,.500,33,54,.611,10,32,.313,17,28,.607,113,38,83,.458,34,53,.642,4,30,.133,17,19,.895,97
655,DET,2024-03-13,113,,TOR,W 113-104,240,39,88,.443,28,58,.483,11,30,.367,24,31,.774,113,41,93,.441,32,57,.561,9,36,.250,13,19,.684,104
656,GSW,2024-03-09,113,,SAS,L 113-126,240,41,88,.466,31,58,.534,10,30,.333,21,29,.724,113,44,86,.512,27,53,.509,17,33,.515,21,28,.750,126
657,CLE,2024-03-08,113,,MIN,W 113-104 (OT),265,38,88,.432,27,54,.500,11,34,.324,26,36,.722,113,39,94,.415,31,64,.484,8,30,.267,18,22,.818,104
658,MIL,2024-03-04,113,,LAC,W 113-106,240,37,78,.474,22,40,.550,15,38,.395,24,28,.857,113,37,84,.440,21,44,.477,16,40,.400,16,25,.640,106
659,ORL,2024-03-03,113,,DET,W 113-91,240,43,72,.597,36,49,.735,7,23,.304,20,25,.800,113,33,86,.384,25,50,.500,8,36,.222,17,20,.850,91
660,NYK,2024-02-26,113,,DET,W 113-111,240,41,92,.446,26,53,.491,15,39,.385,16,21,.762,113,38,79,.481,24,49,.490,14,30,.467,21,26,.808,111
661,MEM,2024-02-15,113,,MIL,W 113-110,240,44,83,.530,31,57,.544,13,26,.500,12,19,.632,113,42,90,.467,31,46,.674,11,44,.250,15,20,.750,110
662,ORL,2024-02-13,113,,OKC,L 113-127,240,41,91,.451,30,55,.545,11,36,.306,20,25,.800,113,46,84,.548,33,52,.635,13,32,.406,22,24,.917,127
663,WAS,2024-02-10,113,,PHI,L 113-119,240,42,86,.488,29,51,.569,13,35,.371,16,21,.762,113,48,100,.480,40,73,.548,8,27,.296,15,23,.652,119
664,GSW,2024-02-10,113,,PHO,W 113-112,240,45,101,.446,28,60,.467,17,41,.415,6,11,.545,113,43,94,.457,32,60,.533,11,34,.324,15,16,.938,112
665,SAS,2024-02-02,113,,NOP,L 113-114,240,46,96,.479,36,57,.632,10,39,.256,11,18,.611,113,46,95,.484,39,69,.565,7,26,.269,15,21,.714,114
666,DEN,2024-01-29,113,,MIL,W 113-107,240,44,91,.484,40,73,.548,4,18,.222,21,24,.875,113,36,84,.429,20,44,.455,16,40,.400,19,25,.760,107
667,SAS,2024-01-29,113,,WAS,L 113-118,240,43,92,.467,31,62,.500,12,30,.400,15,17,.882,113,46,86,.535,37,61,.607,9,25,.360,17,24,.708,118
668,ORL,2024-01-28,113,,PHO,W 113-98,240,41,92,.446,29,56,.518,12,36,.333,19,26,.731,113,41,73,.562,37,59,.627,4,14,.286,12,21,.571,98
669,SAS,2024-01-27,113,,MIN,W 113-112,240,46,84,.548,33,54,.611,13,30,.433,8,15,.533,113,45,79,.570,31,53,.585,14,26,.538,8,15,.533,112
670,DET,2024-01-24,113,,CHO,W 113-106,240,43,86,.500,28,48,.583,15,38,.395,12,20,.600,113,38,87,.437,23,49,.469,15,38,.395,15,19,.789,106
671,DET,2024-01-22,113,,MIL,L 113-122,240,40,89,.449,30,59,.508,10,30,.333,23,29,.793,113,42,94,.447,32,55,.582,10,39,.256,28,34,.824,122
672,NYK,2024-01-18,113,,WAS,W 113-109,240,39,86,.453,26,48,.542,13,38,.342,22,26,.846,113,41,90,.456,31,59,.525,10,31,.323,17,22,.773,109
673,LAL,2024-01-05,113,,MEM,L 113-127,240,42,85,.494,32,57,.561,10,28,.357,19,27,.704,113,44,82,.537,21,37,.568,23,45,.511,16,20,.800,127
674,GSW,2024-01-05,113,,DET,W 113-109,240,38,82,.463,22,44,.500,16,38,.421,21,25,.840,113,44,98,.449,31,54,.574,13,44,.295,8,10,.800,109
675,PHO,2024-01-05,113,,MIA,W 113-97,240,44,87,.506,30,52,.577,14,35,.400,11,17,.647,113,34,83,.410,24,46,.522,10,37,.270,19,22,.864,97
676,MIL,2024-01-01,113,,IND,L 113-122,240,41,93,.441,31,53,.585,10,40,.250,21,26,.808,113,43,97,.443,38,62,.613,5,35,.143,31,38,.816,122
677,HOU,2023-12-27,113,,PHO,L 113-129,240,40,96,.417,23,55,.418,17,41,.415,16,22,.727,113,47,82,.573,33,49,.673,14,33,.424,21,26,.808,129
678,LAC,2023-12-26,113,,CHO,W 113-104,240,40,85,.471,26,51,.510,14,34,.412,19,25,.760,113,43,93,.462,37,64,.578,6,29,.207,12,16,.750,104
679,NOP,2023-12-19,113,,MEM,L 113-115,240,40,85,.471,29,60,.483,11,25,.440,22,24,.917,113,41,82,.500,31,51,.608,10,31,.323,23,29,.793,115
680,MEM,2023-12-11,113,,DAL,L 113-120,240,41,89,.461,23,45,.511,18,44,.409,13,16,.813,113,43,86,.500,26,46,.565,17,40,.425,17,19,.895,120
681,ATL,2023-12-06,113,,BRK,L 113-114,240,42,94,.447,30,59,.508,12,35,.343,17,18,.944,113,43,94,.457,32,67,.478,11,27,.407,17,24,.708,114
682,LAC,2023-12-02,113,,GSW,W 113-112,240,44,90,.489,31,51,.608,13,39,.333,12,14,.857,113,38,86,.442,21,43,.488,17,43,.395,19,24,.792,112
683,NYK,2023-11-26,113,,PHO,L 113-116,240,39,86,.453,27,57,.474,12,29,.414,23,32,.719,113,42,91,.462,26,53,.491,16,38,.421,16,21,.762,116
684,BOS,2023-11-26,113,,ATL,W 113-103,240,42,95,.442,29,48,.604,13,47,.277,16,20,.800,113,36,88,.409,17,35,.486,19,53,.358,12,19,.632,103
685,ORL,2023-11-24,113,,BOS,W 113-96,240,43,85,.506,32,57,.561,11,28,.393,16,22,.727,113,31,76,.408,24,47,.511,7,29,.241,27,37,.730,96
686,DAL,2023-11-19,113,,SAC,L 113-129,240,41,88,.466,29,54,.537,12,34,.353,19,26,.731,113,48,90,.533,31,50,.620,17,40,.425,16,21,.762,129
687,SAS,2023-11-12,113,,MIA,L 113-118,240,42,91,.462,23,47,.489,19,44,.432,10,12,.833,113,39,89,.438,27,58,.466,12,31,.387,28,30,.933,118
688,UTA,2023-11-02,113,,ORL,L 113-115,240,41,89,.461,29,56,.518,12,33,.364,19,26,.731,113,39,85,.459,29,56,.518,10,29,.345,27,36,.750,115
689,CLE,2023-10-28,113,,IND,L 113-125,240,43,99,.434,31,68,.456,12,31,.387,15,24,.625,113,48,98,.490,33,60,.550,15,38,.395,14,17,.824,125
690,WAS,2023-10-28,113,,MEM,W 113-106,240,40,93,.430,24,47,.511,16,46,.348,17,22,.773,113,39,91,.429,20,44,.455,19,47,.404,9,9,1.000,106
691,BRK,2023-10-25,113,,CLE,L 113-114,240,42,84,.500,33,57,.579,9,27,.333,20,26,.769,113,44,94,.468,27,51,.529,17,43,.395,9,10,.900,114
692,OKC,2024-04-09,112,,SAC,W 112-105,240,39,80,.488,28,50,.560,11,30,.367,23,31,.742,112,33,96,.344,13,38,.342,20,58,.345,19,26,.731,105
693,NYK,2024-03-31,112,,OKC,L 112-113,240,38,92,.413,25,49,.510,13,43,.302,23,34,.676,112,44,82,.537,31,48,.646,13,34,.382,12,24,.500,113
694,NOP,2024-03-26,112,,OKC,L 112-119,240,39,86,.453,25,48,.521,14,38,.368,20,23,.870,112,46,86,.535,31,52,.596,15,34,.441,12,14,.857,119
695,WAS,2024-03-23,112,,TOR,W 112-109,240,44,92,.478,33,57,.579,11,35,.314,13,19,.684,112,40,94,.426,32,61,.525,8,33,.242,21,26,.808,109
696,ORL,2024-03-19,112,,CHO,W 112-92,240,44,81,.543,32,47,.681,12,34,.353,12,13,.923,112,38,79,.481,29,50,.580,9,29,.310,7,9,.778,92
697,MIN,2024-03-19,112,,DEN,L 112-115,240,42,88,.477,30,53,.566,12,35,.343,16,23,.696,112,42,81,.519,28,54,.519,14,27,.519,17,22,.773,115
698,GSW,2024-03-18,112,,NYK,L 112-119,240,42,88,.477,28,52,.538,14,36,.389,14,18,.778,112,44,91,.484,30,54,.556,14,37,.378,17,20,.850,119
699,MEM,2024-03-16,112,,OKC,L 112-118,240,37,81,.457,19,37,.514,18,44,.409,20,26,.769,112,45,87,.517,33,52,.635,12,35,.343,16,21,.762,118
700,NOP,2024-03-15,112,,LAC,W 112-104,240,42,87,.483,29,52,.558,13,35,.371,15,20,.750,112,37,77,.481,25,44,.568,12,33,.364,18,19,.947,104
701,LAC,2024-03-09,112,,CHI,W 112-102,240,42,84,.500,30,49,.612,12,35,.343,16,18,.889,112,37,86,.430,24,51,.471,13,35,.371,15,19,.789,102
702,WAS,2024-03-08,112,,CHO,W 112-100,240,43,87,.494,37,54,.685,6,33,.182,20,23,.870,112,40,100,.400,31,58,.534,9,42,.214,11,15,.733,100
703,ATL,2024-03-06,112,,CLE,W 112-101,240,43,84,.512,32,54,.593,11,30,.367,15,20,.750,112,39,89,.438,29,45,.644,10,44,.227,13,17,.765,101
704,BRK,2024-03-05,112,,PHI,W 112-107,240,41,84,.488,29,54,.537,12,30,.400,18,24,.750,112,40,82,.488,28,54,.519,12,28,.429,15,19,.789,107
705,LAC,2024-02-28,112,,LAL,L 112-116,240,45,89,.506,35,52,.673,10,37,.270,12,16,.750,112,47,86,.547,33,50,.660,14,36,.389,8,10,.800,116
706,WAS,2024-02-27,112,,GSW,L 112-123,240,46,93,.495,34,58,.586,12,35,.343,8,10,.800,112,47,94,.500,26,48,.542,21,46,.457,8,11,.727,123
707,OKC,2024-02-27,112,,HOU,W 112-95,240,44,93,.473,34,66,.515,10,27,.370,14,18,.778,112,37,95,.389,28,56,.500,9,39,.231,12,18,.667,95
708,POR,2024-02-23,112,,DEN,L 112-127,240,46,101,.455,38,76,.500,8,25,.320,12,18,.667,112,50,85,.588,37,52,.712,13,33,.394,14,22,.636,127
709,CHI,2024-02-22,112,,BOS,L 112-129,240,44,94,.468,34,66,.515,10,28,.357,14,16,.875,112,45,83,.542,22,36,.611,23,47,.489,16,21,.762,129
710,MIL,2024-02-12,112,,DEN,W 112-95,240,42,84,.500,26,50,.520,16,34,.471,12,18,.667,112,36,94,.383,25,54,.463,11,40,.275,12,17,.706,95
711,DAL,2024-02-12,112,,WAS,W 112-104,240,43,96,.448,34,60,.567,9,36,.250,17,26,.654,112,44,106,.415,37,74,.500,7,32,.219,9,15,.600,104
712,LAC,2024-02-10,112,,DET,W 112-106,240,37,82,.451,24,43,.558,13,39,.333,25,26,.962,112,45,102,.441,36,72,.500,9,30,.300,7,7,1.000,106
713,DEN,2024-02-04,112,,POR,W 112-103,240,42,86,.488,30,58,.517,12,28,.429,16,19,.842,112,39,85,.459,28,54,.519,11,31,.355,14,15,.933,103
714,WAS,2024-02-04,112,,PHO,L 112-140,240,47,96,.490,40,64,.625,7,32,.219,11,17,.647,112,54,88,.614,43,63,.683,11,25,.440,21,26,.808,140
715,LAL,2024-01-19,112,,BRK,L 112-130,240,40,90,.444,28,57,.491,12,33,.364,20,24,.833,112,50,95,.526,31,48,.646,19,47,.404,11,14,.786,130
716,LAL,2024-01-15,112,,OKC,W 112-105,240,44,84,.524,36,60,.600,8,24,.333,16,18,.889,112,40,96,.417,25,47,.532,15,49,.306,10,11,.909,105
717,OKC,2024-01-13,112,,ORL,W 112-100,240,43,94,.457,35,58,.603,8,36,.222,18,21,.857,112,39,84,.464,32,49,.653,7,35,.200,15,24,.625,100
718,PHI,2024-01-12,112,,SAC,W 112-93,240,40,93,.430,25,58,.431,15,35,.429,17,18,.944,112,32,95,.337,24,57,.421,8,38,.211,21,26,.808,93
719,IND,2024-01-10,112,,WAS,W 112-104,240,41,92,.446,33,67,.493,8,25,.320,22,24,.917,112,38,88,.432,31,57,.544,7,31,.226,21,30,.700,104
720,NYK,2024-01-09,112,,POR,W 112-84,240,37,89,.416,19,41,.463,18,48,.375,20,23,.870,112,33,86,.384,27,57,.474,6,29,.207,12,18,.667,84
721,CHO,2024-01-08,112,,CHI,L 112-119 (OT),265,40,94,.426,23,52,.442,17,42,.405,15,17,.882,112,45,92,.489,36,66,.545,9,26,.346,20,24,.833,119
722,HOU,2024-01-06,112,,MIL,W 112-108,240,36,83,.434,23,49,.469,13,34,.382,27,32,.844,112,35,76,.461,26,42,.619,9,34,.265,29,42,.690,108
723,HOU,2024-01-03,112,,BRK,W 112-101,240,37,76,.487,18,37,.486,19,39,.487,19,27,.704,112,36,93,.387,23,49,.469,13,44,.295,16,26,.615,101
724,NOP,2024-01-02,112,,BRK,W 112-85,240,41,88,.466,25,49,.510,16,39,.410,14,18,.778,112,35,98,.357,24,55,.436,11,43,.256,4,8,.500,85
725,NYK,2024-01-01,112,,MIN,W 112-106,240,39,89,.438,27,55,.491,12,34,.353,22,28,.786,112,36,76,.474,25,48,.521,11,28,.393,23,29,.793,106
726,PHO,2023-12-31,112,,ORL,W 112-107,240,44,88,.500,36,61,.590,8,27,.296,16,19,.842,112,42,90,.467,30,53,.566,12,37,.324,11,12,.917,107
727,NOP,2023-12-28,112,,UTA,W 112-105,240,45,82,.549,35,55,.636,10,27,.370,12,15,.800,112,36,85,.424,24,46,.522,12,39,.308,21,25,.840,105
728,DET,2023-12-26,112,,BRK,L 112-118,240,40,90,.444,31,65,.477,9,25,.360,23,32,.719,112,41,82,.500,32,60,.533,9,22,.409,27,43,.628,118
729,PHO,2023-12-17,112,,WAS,W 112-108,240,41,90,.456,34,59,.576,7,31,.226,23,30,.767,112,39,95,.411,25,49,.510,14,46,.304,16,20,.800,108
730,PHO,2023-12-13,112,,BRK,L 112-116,240,40,84,.476,31,56,.554,9,28,.321,23,27,.852,112,41,89,.461,26,48,.542,15,41,.366,19,24,.792,116
731,POR,2023-12-08,112,,DAL,L 112-125,240,39,105,.371,21,52,.404,18,53,.340,16,18,.889,112,47,91,.516,35,52,.673,12,39,.308,19,22,.864,125
732,SAS,2023-12-08,112,,CHI,L 112-121,240,39,83,.470,22,41,.537,17,42,.405,17,20,.850,112,47,102,.461,34,74,.459,13,28,.464,14,24,.583,121
733,TOR,2023-11-29,112,,PHO,W 112-105,240,42,93,.452,32,66,.485,10,27,.370,18,21,.857,112,38,94,.404,31,68,.456,7,26,.269,22,23,.957,105
734,BRK,2023-11-25,112,,MIA,W 112-97,240,39,78,.500,25,42,.595,14,36,.389,20,23,.870,112,38,87,.437,27,53,.509,11,34,.324,10,13,.769,97
735,MIN,2023-11-22,112,,PHI,W 112-99,240,43,89,.483,33,63,.524,10,26,.385,16,24,.667,112,34,87,.391,27,55,.491,7,32,.219,24,30,.800,99
736,TOR,2023-11-15,112,,MIL,L 112-128,240,38,96,.396,29,63,.460,9,33,.273,27,31,.871,112,44,85,.518,24,46,.522,20,39,.513,20,21,.952,128
737,ORL,2023-11-11,112,,MIL,W 112-97,240,36,84,.429,26,58,.448,10,26,.385,30,35,.857,112,38,77,.494,29,48,.604,9,29,.310,12,25,.480,97
738,PHI,2023-11-04,112,,PHO,W 112-100,240,43,90,.478,32,60,.533,11,30,.367,15,18,.833,112,32,89,.360,23,54,.426,9,35,.257,27,33,.818,100
739,MEM,2024-04-14,111,,DEN,L 111-126,240,45,100,.450,37,67,.552,8,33,.242,13,18,.722,111,46,89,.517,34,53,.642,12,36,.333,22,26,.846,126
740,NYK,2024-04-12,111,,BRK,W 111-107,240,38,83,.458,24,53,.453,14,30,.467,21,25,.840,111,41,82,.500,30,50,.600,11,32,.344,14,19,.737,107
741,ATL,2024-04-09,111,,MIA,L 111-117 (2OT),290,45,113,.398,35,67,.522,10,46,.217,11,14,.786,111,42,88,.477,24,43,.558,18,45,.400,15,21,.714,117
742,MIL,2024-04-05,111,,TOR,L 111-117,240,41,94,.436,29,52,.558,12,42,.286,17,21,.810,111,36,79,.456,22,43,.512,14,36,.389,31,36,.861,117
743,TOR,2024-04-02,111,,LAL,L 111-128,240,43,89,.483,33,57,.579,10,32,.313,15,21,.714,111,52,101,.515,34,60,.567,18,41,.439,6,12,.500,128
744,NOP,2024-04-01,111,,PHO,L 111-124,240,42,89,.472,31,62,.500,11,27,.407,16,24,.667,111,43,87,.494,25,40,.625,18,47,.383,20,25,.800,124
745,UTA,2024-03-27,111,,SAS,L 111-118,240,39,83,.470,26,48,.542,13,35,.371,20,22,.909,111,44,86,.512,28,53,.528,16,33,.485,14,21,.667,118
746,POR,2024-03-23,111,,DEN,L 111-114,240,43,93,.462,33,65,.508,10,28,.357,15,17,.882,111,41,91,.451,33,67,.493,8,24,.333,24,33,.727,114
747,GSW,2024-03-22,111,,IND,L 111-123,240,43,106,.406,29,58,.500,14,48,.292,11,16,.688,111,48,99,.485,33,63,.524,15,36,.417,12,16,.750,123
748,ORL,2024-03-17,111,,TOR,W 111-96,240,43,85,.506,32,49,.653,11,36,.306,14,20,.700,111,37,84,.440,29,53,.547,8,31,.258,14,15,.933,96
749,CHI,2024-03-14,111,,LAC,L 111-126,240,41,86,.477,25,51,.490,16,35,.457,13,16,.813,111,48,80,.600,28,40,.700,20,40,.500,10,14,.714,126
750,OKC,2024-03-12,111,,IND,L 111-121,240,43,99,.434,29,62,.468,14,37,.378,11,15,.733,111,48,89,.539,39,61,.639,9,28,.321,16,19,.842,121
751,CLE,2024-03-11,111,,PHO,L 111-117,240,40,84,.476,25,38,.658,15,46,.326,16,19,.842,111,46,84,.548,34,52,.654,12,32,.375,13,19,.684,117
752,IND,2024-03-07,111,,MIN,L 111-113,240,42,82,.512,32,56,.571,10,26,.385,17,23,.739,111,46,98,.469,39,73,.534,7,25,.280,14,19,.737,113
753,TOR,2024-03-03,111,,CHO,W 111-106,240,42,91,.462,29,53,.547,13,38,.342,14,18,.778,111,43,92,.467,35,65,.538,8,27,.296,12,16,.750,106
754,CHO,2024-02-12,111,,IND,W 111-102,240,44,82,.537,34,48,.708,10,34,.294,13,16,.813,111,42,83,.506,34,53,.642,8,30,.267,10,16,.625,102
755,NYK,2024-02-10,111,,IND,L 111-125,240,40,84,.476,30,52,.577,10,32,.313,21,23,.913,111,50,82,.610,36,53,.679,14,29,.483,11,19,.579,125
756,MIN,2024-02-04,111,,HOU,W 111-90,240,40,90,.444,29,60,.483,11,30,.367,20,27,.741,111,31,88,.352,21,58,.362,10,30,.333,18,27,.667,90
757,DEN,2024-01-27,111,,PHI,W 111-105,240,37,82,.451,24,45,.533,13,37,.351,24,38,.632,111,43,81,.531,37,59,.627,6,22,.273,13,16,.813,105
758,OKC,2024-01-23,111,,POR,W 111-109,240,43,89,.483,36,66,.545,7,23,.304,18,28,.643,111,37,86,.430,19,47,.404,18,39,.462,17,21,.810,109
759,CLE,2024-01-11,111,,BRK,W 111-102,240,32,82,.390,19,38,.500,13,44,.295,34,43,.791,111,37,82,.451,29,55,.527,8,27,.296,20,28,.714,102
760,MEM,2024-01-03,111,,TOR,L 111-116,240,40,94,.426,25,52,.481,15,42,.357,16,19,.842,111,41,85,.482,29,59,.492,12,26,.462,22,27,.815,116
761,DEN,2024-01-01,111,,CHO,W 111-93,240,41,83,.494,26,45,.578,15,38,.395,14,18,.778,111,36,86,.419,26,60,.433,10,26,.385,11,16,.688,93
762,CLE,2023-12-29,111,,MIL,L 111-119,240,49,103,.476,43,60,.717,6,43,.140,7,9,.778,111,41,80,.513,29,51,.569,12,29,.414,25,28,.893,119
763,NYK,2023-12-23,111,,MIL,L 111-130,240,41,93,.441,32,64,.500,9,29,.310,20,21,.952,111,48,91,.527,32,59,.542,16,32,.500,18,23,.783,130
764,DET,2023-12-21,111,,UTA,L 111-119,240,43,86,.500,34,55,.618,9,31,.290,16,19,.842,111,43,94,.457,32,64,.500,11,30,.367,22,24,.917,119
765,DAL,2023-12-20,111,,LAC,L 111-120,240,39,91,.429,25,48,.521,14,43,.326,19,27,.704,111,43,77,.558,32,46,.696,11,31,.355,23,25,.920,120
766,DET,2023-12-13,111,,PHI,L 111-129,240,39,88,.443,29,55,.527,10,33,.303,23,30,.767,111,45,87,.517,34,57,.596,11,30,.367,28,34,.824,129
767,CHI,2023-12-06,111,,CHO,W 111-100,240,38,90,.422,26,65,.400,12,25,.480,23,29,.793,111,39,90,.433,29,53,.547,10,37,.270,12,12,1.000,100
768,LAC,2023-12-06,111,,DEN,W 111-102,240,40,87,.460,28,60,.467,12,27,.444,19,25,.760,111,41,98,.418,29,67,.433,12,31,.387,8,9,.889,102
769,PHO,2023-12-01,111,,DEN,L 111-119,240,39,84,.464,30,57,.526,9,27,.333,24,26,.923,111,50,88,.568,38,56,.679,12,32,.375,7,12,.583,119
770,MIN,2023-11-24,111,,SAC,L 111-124,240,36,82,.439,24,49,.490,12,33,.364,27,29,.931,111,49,100,.490,32,65,.492,17,35,.486,9,11,.818,124
771,HOU,2023-11-22,111,,MEM,W 111-91,240,40,92,.435,26,49,.531,14,43,.326,17,20,.850,111,27,82,.329,20,50,.400,7,32,.219,30,35,.857,91
772,DEN,2023-11-14,111,,LAC,W 111-108,240,39,73,.534,31,50,.620,8,23,.348,25,32,.781,111,37,86,.430,24,57,.421,13,29,.448,21,24,.875,108
773,TOR,2023-11-13,111,,WAS,W 111-107,240,45,90,.500,41,70,.586,4,20,.200,17,25,.680,111,43,84,.512,31,58,.534,12,26,.462,9,12,.750,107
774,NYK,2023-11-06,111,,LAC,W 111-97,240,41,88,.466,29,57,.509,12,31,.387,17,18,.944,111,36,73,.493,25,41,.610,11,32,.344,14,16,.875,97
775,CLE,2024-04-14,110,,CHO,L 110-120,240,44,93,.473,28,60,.467,16,33,.485,6,9,.667,110,46,91,.505,27,51,.529,19,40,.475,9,11,.818,120
776,CLE,2024-04-10,110,,MEM,W 110-98,240,37,82,.451,22,45,.489,15,37,.405,21,29,.724,110,33,84,.393,19,52,.365,14,32,.438,18,19,.947,98
777,HOU,2024-04-04,110,,GSW,L 110-133,240,36,86,.419,24,46,.522,12,40,.300,26,30,.867,110,47,80,.588,30,45,.667,17,35,.486,22,25,.880,133
778,DEN,2024-04-02,110,,SAS,W 110-105,240,43,98,.439,32,64,.500,11,34,.324,13,16,.813,110,42,105,.400,29,61,.475,13,44,.295,8,16,.500,105
779,HOU,2024-03-25,110,,POR,W 110-92,240,37,93,.398,25,54,.463,12,39,.308,24,25,.960,110,36,87,.414,29,54,.537,7,33,.212,13,15,.867,92
780,CHI,2024-03-18,110,,POR,W 110-107,240,41,93,.441,30,60,.500,11,33,.333,17,21,.810,110,40,88,.455,32,60,.533,8,28,.286,19,25,.760,107
781,CHO,2024-03-09,110,,BRK,W 110-99,240,44,81,.543,33,51,.647,11,30,.367,11,15,.733,110,36,90,.400,22,48,.458,14,42,.333,13,17,.765,99
782,PHO,2024-03-03,110,,OKC,L 110-118,240,40,91,.440,26,52,.500,14,39,.359,16,18,.889,110,49,102,.480,40,71,.563,9,31,.290,11,15,.733,118
783,PHO,2024-02-29,110,,HOU,W 110-105,240,36,89,.404,23,52,.442,13,37,.351,25,37,.676,110,33,99,.333,22,54,.407,11,45,.244,28,31,.903,105
784,MIN,2024-02-28,110,,MEM,W 110-101,240,39,79,.494,25,44,.568,14,35,.400,18,22,.818,110,36,93,.387,25,56,.446,11,37,.297,18,20,.900,101
785,SAC,2024-02-26,110,,MIA,L 110-121,240,45,85,.529,32,53,.604,13,32,.406,7,12,.583,110,45,87,.517,34,57,.596,11,30,.367,20,25,.800,121
786,HOU,2024-02-25,110,,OKC,L 110-123,240,38,93,.409,22,52,.423,16,41,.390,18,23,.783,110,46,97,.474,29,62,.468,17,35,.486,14,15,.933,123
787,BRK,2024-02-13,110,,BOS,L 110-118,240,39,79,.494,24,46,.522,15,33,.455,17,26,.654,110,43,83,.518,28,46,.609,15,37,.405,17,23,.739,118
788,MEM,2024-02-08,110,,CHI,L 110-118,240,42,91,.462,24,45,.533,18,46,.391,8,13,.615,110,43,79,.544,31,53,.585,12,26,.462,20,22,.909,118
789,CHO,2024-01-31,110,,CHI,L 110-117,240,40,90,.444,24,44,.545,16,46,.348,14,17,.824,110,45,87,.517,34,58,.586,11,29,.379,16,22,.727,117
790,MIA,2024-01-25,110,,BOS,L 110-143,240,42,94,.447,26,52,.500,16,42,.381,10,13,.769,110,51,80,.638,29,40,.725,22,40,.550,19,20,.950,143
791,DAL,2024-01-22,110,,BOS,L 110-119,240,43,97,.443,29,57,.509,14,40,.350,10,14,.714,110,41,88,.466,26,42,.619,15,46,.326,22,30,.733,119
792,TOR,2024-01-18,110,,CHI,L 110-116,240,42,83,.506,32,45,.711,10,38,.263,16,20,.800,110,48,91,.527,42,67,.627,6,24,.250,14,17,.824,116
793,DET,2024-01-12,110,,HOU,L 110-112,240,44,88,.500,32,53,.604,12,35,.343,10,16,.625,110,41,90,.456,33,60,.550,8,30,.267,22,25,.880,112
794,DET,2024-01-09,110,,SAC,L 110-131,240,40,85,.471,26,48,.542,14,37,.378,16,21,.762,110,54,94,.574,41,61,.672,13,33,.394,10,14,.714,131
795,PHI,2024-01-02,110,,CHI,W 110-97,240,38,80,.475,26,50,.520,12,30,.400,22,30,.733,110,37,96,.385,30,59,.508,7,37,.189,16,23,.696,97
796,ATL,2023-12-29,110,,SAC,L 110-117,240,37,94,.394,22,51,.431,15,43,.349,21,25,.840,110,46,89,.517,29,44,.659,17,45,.378,8,15,.533,117
797,WAS,2023-12-29,110,,BRK,W 110-104,240,46,91,.505,31,53,.585,15,38,.395,3,7,.429,110,39,91,.429,30,63,.476,9,28,.321,17,27,.630,104
798,DAL,2023-12-27,110,,CLE,L 110-113,240,39,88,.443,29,51,.569,10,37,.270,22,26,.846,110,40,92,.435,23,49,.469,17,43,.395,16,23,.696,113
799,IND,2023-12-23,110,,ORL,L 110-117,240,43,82,.524,28,48,.583,15,34,.441,9,13,.692,110,39,73,.534,33,55,.600,6,18,.333,33,41,.805,117
800,SAS,2023-12-17,110,,NOP,L 110-146,240,40,94,.426,25,52,.481,15,42,.357,15,21,.714,110,55,98,.561,33,56,.589,22,42,.524,14,22,.636,146
801,GSW,2023-12-06,110,,POR,W 110-106,240,36,86,.419,26,52,.500,10,34,.294,28,33,.848,110,39,95,.411,23,49,.469,16,46,.348,12,16,.750,106
802,HOU,2023-12-06,110,,OKC,W 110-101,240,40,83,.482,25,50,.500,15,33,.455,15,22,.682,110,37,87,.425,29,58,.500,8,29,.276,19,24,.792,101
803,IND,2023-11-27,110,,POR,L 110-114,240,42,88,.477,34,55,.618,8,33,.242,18,24,.750,110,40,85,.471,31,67,.463,9,18,.500,25,31,.806,114
804,LAL,2023-11-15,110,,SAC,L 110-125,240,42,83,.506,31,54,.574,11,29,.379,15,19,.789,110,48,96,.500,32,52,.615,16,44,.364,13,17,.765,125
805,GSW,2023-11-12,110,,MIN,L 110-116,240,37,96,.385,25,53,.472,12,43,.279,24,28,.857,110,43,82,.524,34,55,.618,9,27,.333,21,30,.700,116
806,GSW,2023-11-11,110,,CLE,L 110-118,240,37,90,.411,24,52,.462,13,38,.342,23,30,.767,110,37,86,.430,26,56,.464,11,30,.367,33,43,.767,118
807,SAS,2023-11-10,110,,MIN,L 110-117,240,43,92,.467,31,58,.534,12,34,.353,12,19,.632,110,43,87,.494,33,60,.550,10,27,.370,21,27,.778,117
808,MIL,2023-11-03,110,,NYK,W 110-105,240,35,82,.427,15,43,.349,20,39,.513,20,28,.714,110,38,96,.396,28,57,.491,10,39,.256,19,25,.760,105
809,MIN,2023-11-01,110,,DEN,W 110-89,240,38,83,.458,30,62,.484,8,21,.381,26,27,.963,110,38,96,.396,32,63,.508,6,33,.182,7,10,.700,89
810,MEM,2023-10-30,110,,DAL,L 110-125,240,42,92,.457,28,55,.509,14,37,.378,12,20,.600,110,42,84,.500,19,37,.514,23,47,.489,18,24,.750,125
811,DEN,2023-10-30,110,,UTA,W 110-102,240,47,84,.560,38,56,.679,9,28,.321,7,17,.412,110,42,98,.429,31,61,.508,11,37,.297,7,15,.467,102
812,MIL,2023-10-29,110,,ATL,L 110-127,240,39,86,.453,23,42,.548,16,44,.364,16,20,.800,110,47,93,.505,32,56,.571,15,37,.405,18,22,.818,127
813,GSW,2024-04-12,109,,NOP,L 109-114,240,40,86,.465,27,52,.519,13,34,.382,16,21,.762,109,42,90,.467,22,52,.423,20,38,.526,10,16,.625,114
814,LAC,2024-04-12,109,,UTA,L 109-110,240,43,96,.448,33,57,.579,10,39,.256,13,19,.684,109,41,88,.466,35,53,.660,6,35,.171,22,25,.880,110
815,MIN,2024-04-12,109,,ATL,W 109-106,240,38,79,.481,28,42,.667,10,37,.270,23,29,.793,109,40,90,.444,31,60,.517,9,30,.300,17,25,.680,106
816,BOS,2024-04-11,109,,NYK,L 109-118,240,40,86,.465,24,44,.545,16,42,.381,13,16,.813,109,49,99,.495,35,63,.556,14,36,.389,6,10,.600,118
817,MIL,2024-04-07,109,,NYK,L 109-122,240,35,75,.467,23,41,.561,12,34,.353,27,32,.844,109,45,92,.489,31,63,.492,14,29,.483,18,22,.818,122
818,NOP,2024-04-05,109,,SAS,L 109-111,240,44,86,.512,35,57,.614,9,29,.310,12,12,1.000,109,42,83,.506,25,37,.676,17,46,.370,10,13,.769,111
819,DAL,2024-04-04,109,,ATL,W 109-95,240,38,94,.404,20,45,.444,18,49,.367,15,17,.882,109,34,85,.400,21,47,.447,13,38,.342,14,21,.667,95
820,SAC,2024-04-02,109,,LAC,W 109-95,240,39,92,.424,27,50,.540,12,42,.286,19,25,.760,109,31,76,.408,20,49,.408,11,27,.407,22,27,.815,95
821,PHI,2024-04-02,109,,OKC,W 109-105,240,36,78,.462,22,48,.458,14,30,.467,23,25,.920,109,37,87,.425,24,48,.500,13,39,.333,18,22,.818,105
822,MIA,2024-04-02,109,,NYK,W 109-99,240,36,74,.486,19,36,.528,17,38,.447,20,21,.952,109,35,76,.461,23,42,.548,12,34,.353,17,21,.810,99
823,IND,2024-03-29,109,,LAL,W 109-90,240,43,89,.483,33,58,.569,10,31,.323,13,14,.929,109,35,86,.407,30,56,.536,5,30,.167,15,18,.833,90
824,WAS,2024-03-21,109,,SAC,W 109-102,240,41,81,.506,31,56,.554,10,25,.400,17,23,.739,109,37,86,.430,26,47,.553,11,39,.282,17,19,.895,102
825,PHI,2024-03-16,109,,CHO,W 109-98,240,36,81,.444,23,40,.575,13,41,.317,24,25,.960,109,37,82,.451,27,51,.529,10,31,.323,14,18,.778,98
826,DAL,2024-03-13,109,,GSW,W 109-99,240,44,82,.537,38,55,.691,6,27,.222,15,19,.789,109,37,92,.402,28,64,.438,9,28,.321,16,19,.842,99
827,MEM,2024-03-12,109,,WAS,W 109-97,240,42,94,.447,34,61,.557,8,33,.242,17,21,.810,109,37,82,.451,26,46,.565,11,36,.306,12,16,.750,97
828,WAS,2024-03-06,109,,ORL,L 109-119,240,40,88,.455,28,50,.560,12,38,.316,17,20,.850,109,44,81,.543,32,55,.582,12,26,.462,19,21,.905,119
829,PHI,2024-03-06,109,,MEM,L 109-115,240,39,102,.382,26,67,.388,13,35,.371,18,21,.857,109,41,91,.451,28,54,.519,13,37,.351,20,23,.870,115
830,SAC,2024-03-04,109,,CHI,L 109-113,240,41,92,.446,30,55,.545,11,37,.297,16,18,.889,109,42,84,.500,31,52,.596,11,32,.344,18,22,.818,113
831,PHO,2024-03-02,109,,HOU,L 109-118,240,39,85,.459,30,56,.536,9,29,.310,22,29,.759,109,42,96,.438,26,54,.481,16,42,.381,18,26,.692,118
832,ATL,2024-02-25,109,,ORL,W 109-92,240,41,90,.456,29,61,.475,12,29,.414,15,17,.882,109,35,84,.417,21,46,.457,14,38,.368,8,18,.444,92
833,DET,2024-02-24,109,,ORL,L 109-112,240,43,85,.506,29,54,.537,14,31,.452,9,13,.692,109,43,87,.494,31,63,.492,12,24,.500,14,21,.667,112
834,CLE,2024-02-22,109,,ORL,L 109-116,240,39,70,.557,29,48,.604,10,22,.455,21,26,.808,109,43,84,.512,29,59,.492,14,25,.560,16,18,.889,116
835,POR,2024-02-13,109,,MIN,L 109-121,240,39,87,.448,28,58,.483,11,29,.379,20,25,.800,109,39,84,.464,26,51,.510,13,33,.394,30,34,.882,121
836,IND,2024-02-08,109,,GSW,L 109-131,240,39,81,.481,27,50,.540,12,31,.387,19,27,.704,109,52,93,.559,35,61,.574,17,32,.531,10,13,.769,131
837,NYK,2024-02-01,109,,IND,W 109-105,240,41,103,.398,33,65,.508,8,38,.211,19,25,.760,109,42,93,.452,29,60,.483,13,33,.394,8,13,.615,105
838,WAS,2024-01-31,109,,LAC,L 109-125,240,45,97,.464,36,68,.529,9,29,.310,10,15,.667,109,47,100,.470,35,70,.500,12,30,.400,19,22,.864,125
839,DAL,2024-01-24,109,,PHO,L 109-132,240,41,89,.461,24,46,.522,17,43,.395,10,18,.556,109,51,85,.600,37,51,.725,14,34,.412,16,22,.727,132
840,IND,2024-01-23,109,,DEN,L 109-114,240,43,87,.494,38,66,.576,5,21,.238,18,21,.857,109,44,88,.500,33,55,.600,11,33,.333,15,17,.882,114
841,NOP,2024-01-19,109,,PHO,L 109-123,240,41,93,.441,31,51,.608,10,42,.238,17,23,.739,109,46,93,.495,31,52,.596,15,41,.366,16,21,.762,123
842,ORL,2024-01-19,109,,PHI,L 109-124,240,37,78,.474,27,55,.491,10,23,.435,25,27,.926,109,42,87,.483,29,57,.509,13,30,.433,27,29,.931,124
843,NYK,2024-01-17,109,,HOU,W 109-94,240,39,87,.448,26,50,.520,13,37,.351,18,22,.818,109,35,84,.417,27,54,.500,8,30,.267,16,19,.842,94
844,ATL,2024-01-15,109,,SAS,W 109-99,240,40,93,.430,27,55,.491,13,38,.342,16,21,.762,109,38,95,.400,27,53,.509,11,42,.262,12,17,.706,99
845,CLE,2024-01-15,109,,CHI,W 109-91,240,39,95,.411,19,38,.500,20,57,.351,11,11,1.000,109,35,83,.422,26,51,.510,9,32,.281,12,16,.750,91
846,MIN,2024-01-14,109,,LAC,W 109-105,240,38,67,.567,25,41,.610,13,26,.500,20,31,.645,109,36,83,.434,19,44,.432,17,39,.436,16,18,.889,105
847,LAL,2024-01-11,109,,PHO,L 109-127,240,40,80,.500,27,46,.587,13,34,.382,16,25,.640,109,46,93,.495,32,54,.593,14,39,.359,21,23,.913,127
848,PHI,2024-01-06,109,,UTA,L 109-120,240,42,104,.404,35,66,.530,7,38,.184,18,23,.783,109,46,80,.575,38,50,.760,8,30,.267,20,24,.833,120
849,PHO,2024-01-01,109,,POR,W 109-88,240,38,80,.475,27,51,.529,11,29,.379,22,33,.667,109,33,80,.413,25,50,.500,8,30,.267,14,19,.737,88
850,POR,2023-12-19,109,,PHO,W 109-104,240,39,87,.448,25,59,.424,14,28,.500,17,19,.895,109,42,94,.447,37,71,.521,5,23,.217,15,21,.714,104
851,LAL,2023-12-18,109,,NYK,L 109-114,240,42,99,.424,29,58,.500,13,41,.317,12,13,.923,109,42,88,.477,32,58,.552,10,30,.333,20,23,.870,114
852,GSW,2023-11-16,109,,OKC,L 109-128,240,40,98,.408,26,57,.456,14,41,.341,15,19,.789,109,44,87,.506,25,55,.455,19,32,.594,21,23,.913,128
853,ATL,2023-11-11,109,,MIA,L 109-117,240,38,87,.437,20,41,.488,18,46,.391,15,18,.833,109,41,84,.488,29,46,.630,12,38,.316,23,25,.920,117
854,DET,2023-11-06,109,,GSW,L 109-120,240,38,80,.475,25,50,.500,13,30,.433,20,21,.952,109,46,97,.474,34,56,.607,12,41,.293,16,21,.762,120
855,NOP,2024-04-14,108,,LAL,L 108-124,240,41,86,.477,26,49,.531,15,37,.405,11,14,.786,108,48,87,.552,37,58,.638,11,29,.379,17,18,.944,124
856,LAC,2024-04-10,108,,PHO,L 108-124,240,44,95,.463,32,59,.542,12,36,.333,8,10,.800,108,46,95,.484,28,45,.622,18,50,.360,14,15,.933,124
857,MEM,2024-04-05,108,,DET,W 108-90,240,42,90,.467,32,59,.542,10,31,.323,14,16,.875,108,32,79,.405,24,49,.490,8,30,.267,18,24,.750,90
858,DAL,2024-04-05,108,,GSW,W 108-106,240,40,84,.476,28,50,.560,12,34,.353,16,21,.762,108,41,93,.441,29,58,.500,12,35,.343,12,18,.667,106
859,CHI,2024-04-05,108,,NYK,W 108-100,240,44,93,.473,37,70,.529,7,23,.304,13,16,.813,108,36,83,.434,26,54,.481,10,29,.345,18,24,.750,100
860,NOP,2024-04-03,108,,ORL,L 108-117,240,36,76,.474,24,47,.511,12,29,.414,24,28,.857,108,41,80,.513,28,48,.583,13,32,.406,22,30,.733,117
861,DET,2024-04-01,108,,MEM,L 108-110,240,40,79,.506,29,51,.569,11,28,.393,17,22,.773,108,40,91,.440,29,58,.500,11,33,.333,19,23,.826,110
862,SAC,2024-03-25,108,,PHI,W 108-96,240,38,86,.442,28,48,.583,10,38,.263,22,28,.786,108,34,82,.415,23,48,.479,11,34,.324,17,20,.850,96
863,MIA,2024-03-10,108,,WAS,L 108-110,240,43,95,.453,33,62,.532,10,33,.303,12,18,.667,108,39,81,.481,23,42,.548,16,39,.410,16,22,.727,110
864,ORL,2024-02-27,108,,BRK,W 108-81,240,39,74,.527,30,49,.612,9,25,.360,21,25,.840,108,31,79,.392,23,48,.479,8,31,.258,11,14,.786,81
865,CLE,2024-02-14,108,,CHI,W 108-105,240,40,83,.482,28,46,.609,12,37,.324,16,21,.762,108,38,83,.458,24,50,.480,14,33,.424,15,17,.882,105
866,NYK,2024-02-08,108,,DAL,L 108-122,240,42,94,.447,28,57,.491,14,37,.378,10,11,.909,108,43,82,.524,25,40,.625,18,42,.429,18,23,.783,122
867,WAS,2024-01-25,108,,UTA,L 108-123,240,43,88,.489,36,58,.621,7,30,.233,15,20,.750,108,50,97,.515,37,66,.561,13,31,.419,10,12,.833,123
868,MIA,2024-01-19,108,,ATL,L 108-109,240,38,82,.463,26,51,.510,12,31,.387,20,22,.909,108,40,87,.460,25,52,.481,15,35,.429,14,17,.824,109
869,DAL,2024-01-13,108,,NOP,L 108-118,240,37,82,.451,22,41,.537,15,41,.366,19,20,.950,108,39,79,.494,27,49,.551,12,30,.400,28,37,.757,118
870,ATL,2024-01-12,108,,IND,L 108-126,240,40,89,.449,29,59,.492,11,30,.367,17,23,.739,108,53,79,.671,42,61,.689,11,18,.611,9,12,.750,126
871,DET,2024-01-10,108,,SAS,L 108-130,240,44,96,.458,34,64,.531,10,32,.313,10,13,.769,108,49,94,.521,40,67,.597,9,27,.333,23,27,.852,130
872,MIN,2023-12-30,108,,LAL,W 108-106,240,38,76,.500,26,42,.619,12,34,.353,20,24,.833,108,37,88,.420,30,64,.469,7,24,.292,25,32,.781,106
873,LAC,2023-12-23,108,,BOS,L 108-145,240,41,89,.461,30,55,.545,11,34,.324,15,15,1.000,108,49,94,.521,24,41,.585,25,53,.472,22,28,.786,145
874,MIA,2023-12-18,108,,MIN,L 108-112,240,41,87,.471,30,57,.526,11,30,.367,15,18,.833,108,42,85,.494,31,56,.554,11,29,.379,17,19,.895,112
875,MIL,2023-11-26,108,,POR,W 108-102,240,35,89,.393,21,47,.447,14,42,.333,24,32,.750,108,37,91,.407,24,59,.407,13,32,.406,15,20,.750,102
876,WAS,2023-11-25,108,,ATL,L 108-136,240,43,88,.489,33,50,.660,10,38,.263,12,12,1.000,108,52,102,.510,34,65,.523,18,37,.486,14,20,.700,136
877,CHO,2023-11-18,108,,NYK,L 108-122,240,40,82,.488,23,47,.489,17,35,.486,11,13,.846,108,46,91,.505,30,54,.556,16,37,.432,14,19,.737,122
878,SAS,2023-11-18,108,,MEM,L 108-120,240,36,83,.434,21,43,.488,15,40,.375,21,26,.808,108,40,86,.465,29,53,.547,11,33,.333,29,36,.806,120
879,CLE,2023-11-17,108,,DET,W 108-100,240,42,82,.512,33,61,.541,9,21,.429,15,21,.714,108,39,91,.429,30,56,.536,9,35,.257,13,15,.867,100
880,DEN,2023-11-08,108,,GSW,W 108-105,240,41,92,.446,30,57,.526,11,35,.314,15,22,.682,108,37,86,.430,26,51,.510,11,35,.314,20,26,.769,105
881,MIA,2023-11-06,108,,LAL,W 108-107,240,41,88,.466,29,51,.569,12,37,.324,14,16,.875,108,44,81,.543,36,55,.655,8,26,.308,11,14,.786,107
882,PHI,2024-04-14,107,,BRK,W 107-86,240,41,96,.427,27,52,.519,14,44,.318,11,15,.733,107,32,83,.386,23,49,.469,9,34,.265,13,17,.765,86
883,SAC,2024-04-12,107,,PHO,L 107-108,240,40,91,.440,26,53,.491,14,38,.368,13,14,.929,107,40,76,.526,28,44,.636,12,32,.375,16,17,.941,108
884,POR,2024-04-12,107,,HOU,L 107-116,240,37,95,.389,25,60,.417,12,35,.343,21,29,.724,107,44,92,.478,33,53,.623,11,39,.282,17,20,.850,116
885,HOU,2024-03-31,107,,DAL,L 107-125,240,39,92,.424,26,54,.481,13,38,.342,16,19,.842,107,48,93,.516,24,46,.522,24,47,.511,5,9,.556,125
886,WAS,2024-03-31,107,,MIA,L 107-119,240,40,88,.455,29,50,.580,11,38,.289,16,21,.762,107,40,81,.494,26,45,.578,14,36,.389,25,29,.862,119
887,NOP,2024-03-28,107,,MIL,W 107-100,240,36,91,.396,28,59,.475,8,32,.250,27,34,.794,107,38,82,.463,24,43,.558,14,39,.359,10,19,.526,100
888,PHI,2024-03-27,107,,LAC,L 107-108,240,39,82,.476,26,49,.531,13,33,.394,16,19,.842,107,40,90,.444,26,54,.481,14,36,.389,14,20,.700,108
889,LAC,2024-03-24,107,,PHI,L 107-121,240,40,83,.482,30,55,.545,10,28,.357,17,18,.944,107,48,90,.533,30,53,.566,18,37,.486,7,9,.778,121
890,ORL,2024-03-23,107,,SAC,L 107-109,240,42,88,.477,32,53,.604,10,35,.286,13,18,.722,107,38,87,.437,23,47,.489,15,40,.375,18,21,.857,109
891,SAS,2024-03-19,107,,DAL,L 107-113,240,39,89,.438,25,50,.500,14,39,.359,15,21,.714,107,44,91,.484,34,61,.557,10,30,.333,15,17,.882,113
892,DAL,2024-03-17,107,,DEN,W 107-105,240,42,100,.420,33,65,.508,9,35,.257,14,21,.667,107,37,84,.440,25,56,.446,12,28,.429,19,22,.864,105
893,UTA,2024-03-12,107,,BOS,L 107-123,240,41,86,.477,26,54,.481,15,32,.469,10,11,.909,107,43,92,.467,23,43,.535,20,49,.408,17,19,.895,123
894,PHO,2024-03-09,107,,BOS,L 107-117,240,44,87,.506,35,56,.625,9,31,.290,10,16,.625,107,46,94,.489,31,55,.564,15,39,.385,10,13,.769,117
895,OKC,2024-03-08,107,,MIA,W 107-100,240,42,89,.472,30,51,.588,12,38,.316,11,13,.846,107,38,82,.463,27,53,.509,11,29,.379,13,18,.722,100
896,POR,2024-03-08,107,,HOU,L 107-123,240,37,89,.416,21,54,.389,16,35,.457,17,25,.680,107,45,94,.479,31,57,.544,14,37,.378,19,26,.731,123
897,DEN,2024-03-05,107,,PHO,L 107-117 (OT),265,41,96,.427,26,56,.464,15,40,.375,10,14,.714,107,42,96,.438,27,62,.435,15,34,.441,18,22,.818,117
898,LAC,2024-02-25,107,,SAC,L 107-123,240,40,82,.488,32,55,.582,8,27,.296,19,20,.950,107,45,91,.495,30,54,.556,15,37,.405,18,22,.818,123
899,MIN,2024-02-23,107,,MIL,L 107-112,240,43,98,.439,30,63,.476,13,35,.371,8,13,.615,107,41,87,.471,28,50,.560,13,37,.351,17,25,.680,112
900,UTA,2024-02-22,107,,CHO,L 107-115,240,37,86,.430,28,47,.596,9,39,.231,24,27,.889,107,40,92,.435,20,50,.400,20,42,.476,15,22,.682,115
901,UTA,2024-02-12,107,,GSW,L 107-129,240,41,92,.446,30,60,.500,11,32,.344,14,16,.875,107,48,100,.480,28,56,.500,20,44,.455,13,17,.765,129
902,TOR,2024-02-09,107,,HOU,W 107-104,240,40,95,.421,30,62,.484,10,33,.303,17,19,.895,107,38,85,.447,23,47,.489,15,38,.395,13,16,.813,104
903,BRK,2024-02-06,107,,DAL,L 107-119,240,41,91,.451,29,58,.500,12,33,.364,13,15,.867,107,46,91,.505,27,48,.563,19,43,.442,8,13,.615,119
904,CHI,2024-01-30,107,,TOR,L 107-118,240,38,75,.507,27,43,.628,11,32,.344,20,27,.741,107,43,83,.518,29,54,.537,14,29,.483,18,20,.900,118
905,TOR,2024-01-26,107,,LAC,L 107-127,240,44,96,.458,38,64,.594,6,32,.188,13,22,.591,107,48,95,.505,39,63,.619,9,32,.281,22,24,.917,127
906,MEM,2024-01-26,107,,ORL,W 107-106,240,42,90,.467,27,49,.551,15,41,.366,8,13,.615,107,38,81,.469,29,47,.617,9,34,.265,21,29,.724,106
907,WAS,2024-01-24,107,,MIN,L 107-118,240,37,77,.481,27,53,.509,10,24,.417,23,29,.793,107,42,100,.420,33,68,.485,9,32,.281,25,29,.862,118
908,HOU,2024-01-21,107,,BOS,L 107-116,240,41,94,.436,31,59,.525,10,35,.286,15,22,.682,107,43,98,.439,26,51,.510,17,47,.362,13,18,.722,116
909,CHO,2023-12-15,107,,NOP,L 107-112,240,41,92,.446,32,61,.525,9,31,.290,16,21,.762,107,38,80,.475,29,53,.547,9,27,.333,27,32,.844,112
910,LAL,2023-12-02,107,,HOU,W 107-97,240,40,89,.449,32,62,.516,8,27,.296,19,27,.704,107,36,89,.404,25,58,.431,11,31,.355,14,18,.778,97
911,DET,2023-11-29,107,,LAL,L 107-133,240,40,97,.412,25,61,.410,15,36,.417,12,14,.857,107,45,88,.511,33,54,.611,12,34,.353,31,38,.816,133
912,DET,2023-11-27,107,,WAS,L 107-126,240,43,102,.422,35,64,.547,8,38,.211,13,19,.684,107,45,89,.506,35,60,.583,10,29,.345,26,28,.929,126
913,LAC,2023-11-25,107,,DAL,W 107-88,240,38,88,.432,30,59,.508,8,29,.276,23,31,.742,107,34,91,.374,25,53,.472,9,38,.237,11,14,.786,88
914,PHI,2023-11-15,107,,BOS,L 107-117,240,39,85,.459,28,55,.509,11,30,.367,18,22,.818,107,42,88,.477,24,38,.632,18,50,.360,15,19,.789,117
915,HOU,2023-11-12,107,,DEN,W 107-104,240,37,87,.425,27,55,.491,10,32,.313,23,29,.793,107,42,91,.462,33,59,.559,9,32,.281,11,14,.786,104
916,HOU,2023-11-04,107,,SAC,W 107-89,240,40,87,.460,27,51,.529,13,36,.361,14,20,.700,107,32,84,.381,21,43,.488,11,41,.268,14,19,.737,89
917,CHI,2023-11-03,107,,BRK,L 107-109,240,43,89,.483,32,61,.525,11,28,.393,10,14,.714,107,44,96,.458,26,51,.510,18,45,.400,3,5,.600,109
918,WAS,2023-10-30,107,,BOS,L 107-126,240,39,87,.448,28,51,.549,11,36,.306,18,26,.692,107,51,102,.500,32,49,.653,19,53,.358,5,7,.714,126
919,TOR,2023-10-28,107,,PHI,L 107-114,240,38,87,.437,21,55,.382,17,32,.531,14,19,.737,107,43,86,.500,33,58,.569,10,28,.357,18,21,.857,114
920,MIN,2024-04-14,106,,PHO,L 106-125,240,36,70,.514,27,44,.614,9,26,.346,25,31,.806,106,47,86,.547,31,57,.544,16,29,.552,15,18,.833,125
921,BRK,2024-04-10,106,,TOR,W 106-102,240,38,86,.442,27,50,.540,11,36,.306,19,24,.792,106,35,94,.372,19,54,.352,16,40,.400,16,18,.889,102
922,MIN,2024-03-27,106,,DET,W 106-91,240,42,82,.512,31,46,.674,11,36,.306,11,16,.688,106,31,81,.383,22,49,.449,9,32,.281,20,25,.800,91
923,SAS,2024-03-23,106,,PHO,L 106-131,240,40,85,.471,31,52,.596,9,33,.273,17,21,.810,106,56,94,.596,45,70,.643,11,24,.458,8,10,.800,131
924,SAS,2024-03-15,106,,DEN,L 106-117,240,37,81,.457,26,52,.500,11,29,.379,21,27,.778,106,49,89,.551,39,64,.609,10,25,.400,9,12,.750,117
925,POR,2024-03-13,106,,ATL,W 106-102,240,38,82,.463,28,52,.538,10,30,.333,20,24,.833,106,38,88,.432,24,49,.490,14,39,.359,12,18,.667,102
926,NYK,2024-03-12,106,,PHI,W 106-79,240,40,79,.506,26,39,.667,14,40,.350,12,15,.800,106,30,80,.375,22,47,.468,8,33,.242,11,16,.688,79
927,NOP,2024-02-25,106,,CHI,L 106-114,240,40,88,.455,24,47,.511,16,41,.390,10,14,.714,106,41,95,.432,28,55,.509,13,40,.325,19,21,.905,114
928,MIA,2024-02-11,106,,BOS,L 106-110,240,40,97,.412,28,57,.491,12,40,.300,14,15,.933,106,41,81,.506,25,42,.595,16,39,.410,12,17,.706,110
929,LAL,2024-02-08,106,,DEN,L 106-114,240,41,89,.461,33,64,.516,8,25,.320,16,22,.727,106,47,97,.485,33,65,.508,14,32,.438,6,7,.857,114
930,WAS,2024-02-07,106,,CLE,L 106-114,240,42,94,.447,26,54,.481,16,40,.400,6,9,.667,106,43,88,.489,31,53,.585,12,35,.343,16,22,.727,114
931,LAC,2024-02-07,106,,NOP,L 106-117,240,36,78,.462,24,46,.522,12,32,.375,22,26,.846,106,47,88,.534,35,56,.625,12,32,.375,11,16,.688,117
932,MIN,2024-02-02,106,,ORL,L 106-108,240,38,82,.463,26,44,.591,12,38,.316,18,20,.900,106,39,85,.459,30,60,.500,9,25,.360,21,26,.808,108
933,BRK,2024-01-27,106,,HOU,W 106-104,240,36,74,.486,24,40,.600,12,34,.353,22,37,.595,106,37,94,.394,27,57,.474,10,37,.270,20,23,.870,104
934,ATL,2024-01-17,106,,ORL,W 106-104,240,39,76,.513,31,51,.608,8,25,.320,20,22,.909,106,39,88,.443,29,53,.547,10,35,.286,16,22,.727,104
935,LAL,2024-01-07,106,,LAC,W 106-103,240,42,82,.512,31,53,.585,11,29,.379,11,16,.688,106,36,91,.396,22,54,.407,14,37,.378,17,19,.895,103
936,MIN,2024-01-03,106,,NOP,L 106-117,240,37,82,.451,27,51,.529,10,31,.323,22,27,.815,106,45,81,.556,33,55,.600,12,26,.462,15,17,.882,117
937,MEM,2024-01-02,106,,SAS,W 106-98,240,37,80,.463,25,42,.595,12,38,.316,20,25,.800,106,36,85,.424,26,54,.481,10,31,.323,16,23,.696,98
938,ORL,2023-12-20,106,,MIA,L 106-115,240,41,89,.461,32,53,.604,9,36,.250,15,19,.789,106,40,83,.482,25,54,.463,15,29,.517,20,24,.833,115
939,CHI,2023-12-12,106,,DEN,L 106-114,240,36,86,.419,23,46,.500,13,40,.325,21,23,.913,106,39,83,.470,25,53,.472,14,30,.467,22,32,.688,114
940,PHO,2023-12-08,106,,SAC,L 106-114,240,40,83,.482,29,51,.569,11,32,.344,15,23,.652,106,42,92,.457,28,53,.528,14,39,.359,16,20,.800,114
941,DEN,2023-12-08,106,,HOU,L 106-114,240,38,90,.422,28,62,.452,10,28,.357,20,27,.741,106,35,82,.427,22,43,.512,13,39,.333,31,42,.738,114
942,LAL,2023-12-05,106,,PHO,W 106-103,240,38,102,.373,29,72,.403,9,30,.300,21,25,.840,106,37,75,.493,25,50,.500,12,25,.480,17,21,.810,103
943,TOR,2023-12-01,106,,NYK,L 106-119,240,44,100,.440,38,68,.559,6,32,.188,12,17,.706,106,45,90,.500,29,54,.537,16,36,.444,13,16,.813,119
944,MIN,2023-11-28,106,,OKC,W 106-103,240,33,78,.423,19,45,.422,14,33,.424,26,32,.813,106,37,90,.411,26,60,.433,11,30,.367,18,23,.783,103
945,LAC,2023-11-24,106,,NOP,L 106-116,240,42,92,.457,31,55,.564,11,37,.297,11,17,.647,106,43,88,.489,33,64,.516,10,24,.417,20,27,.741,116
946,LAC,2023-11-17,106,,HOU,W 106-100,240,36,83,.434,23,49,.469,13,34,.382,21,30,.700,106,38,88,.432,28,57,.491,10,31,.323,14,20,.700,100
947,DET,2023-11-10,106,,PHI,L 106-114,240,40,86,.465,32,58,.552,8,28,.286,18,22,.818,106,35,83,.422,26,55,.473,9,28,.321,35,41,.854,114
948,PHI,2023-11-08,106,,BOS,W 106-103,240,42,95,.442,33,61,.541,9,34,.265,13,15,.867,106,36,91,.396,21,44,.477,15,47,.319,16,19,.842,103
949,DET,2023-11-05,106,,PHO,L 106-120,240,43,87,.494,35,64,.547,8,23,.348,12,14,.857,106,43,86,.500,35,65,.538,8,21,.381,26,29,.897,120
950,OKC,2023-11-01,106,,NOP,L 106-110,240,38,88,.432,31,54,.574,7,34,.206,23,25,.920,106,40,102,.392,27,60,.450,13,42,.310,17,29,.586,110
951,LAL,2023-10-30,106,,ORL,W 106-103,240,42,79,.532,34,52,.654,8,27,.296,14,18,.778,106,38,95,.400,24,60,.400,14,35,.400,13,18,.722,103
952,MIN,2023-10-28,106,,MIA,W 106-90,240,44,86,.512,32,52,.615,12,34,.353,6,8,.750,106,35,87,.402,23,49,.469,12,38,.316,8,14,.571,90
953,LAC,2024-04-14,105,,HOU,L 105-116,240,41,104,.394,33,67,.493,8,37,.216,15,17,.882,105,50,103,.485,39,65,.600,11,38,.289,5,14,.357,116
954,DET,2024-04-11,105,,CHI,L 105-127,240,38,77,.494,24,42,.571,14,35,.400,15,23,.652,105,51,96,.531,37,60,.617,14,36,.389,11,15,.733,127
955,PHO,2024-04-07,105,,NOP,L 105-113,240,39,87,.448,25,48,.521,14,39,.359,13,14,.929,105,40,85,.471,24,46,.522,16,39,.410,17,19,.895,113
956,MIA,2024-04-04,105,,PHI,L 105-109,240,39,94,.415,26,51,.510,13,43,.302,14,16,.875,105,43,92,.467,29,52,.558,14,40,.350,9,11,.818,109
957,CHI,2024-03-25,105,,WAS,L 105-107,240,36,87,.414,26,52,.500,10,35,.286,23,28,.821,105,39,97,.402,25,48,.521,14,49,.286,15,18,.833,107
958,UTA,2024-03-25,105,,DAL,L 105-115,240,37,87,.425,24,48,.500,13,39,.333,18,22,.818,105,44,92,.478,32,50,.640,12,42,.286,15,18,.833,115
959,NYK,2024-03-23,105,,BRK,W 105-93,240,42,97,.433,27,57,.474,15,40,.375,6,12,.500,105,34,76,.447,22,42,.524,12,34,.353,13,15,.867,93
960,CLE,2024-03-05,105,,BOS,W 105-104,240,39,90,.433,19,48,.396,20,42,.476,7,11,.636,105,39,93,.419,24,55,.436,15,38,.395,11,12,.917,104
961,TOR,2024-03-01,105,,GSW,L 105-120,240,41,95,.432,29,50,.580,12,45,.267,11,17,.647,105,44,98,.449,26,54,.481,18,44,.409,14,18,.778,120
962,WAS,2024-02-25,105,,CLE,L 105-114,240,40,90,.444,28,50,.560,12,40,.300,13,18,.722,105,42,83,.506,32,51,.627,10,32,.313,20,27,.741,114
963,HOU,2024-02-12,105,,NYK,W 105-103,240,36,80,.450,26,54,.481,10,26,.385,23,33,.697,105,42,92,.457,30,56,.536,12,36,.333,7,12,.583,103
964,MIL,2024-02-08,105,,MIN,L 105-129,240,40,81,.494,26,48,.542,14,33,.424,11,16,.688,105,48,87,.552,27,46,.587,21,41,.512,12,16,.750,129
965,NYK,2024-02-03,105,,LAL,L 105-113,240,41,100,.410,31,65,.477,10,35,.286,13,15,.867,105,39,80,.488,27,49,.551,12,31,.387,23,27,.852,113
966,BOS,2024-02-01,105,,LAL,L 105-114,240,41,97,.423,25,49,.510,16,48,.333,7,7,1.000,105,38,94,.404,19,58,.328,19,36,.528,19,26,.731,114
967,OKC,2024-01-31,105,,DEN,W 105-100,240,37,87,.425,26,61,.426,11,26,.423,20,25,.800,105,37,93,.398,22,56,.393,15,37,.405,11,16,.688,100
968,MIA,2024-01-29,105,,PHO,L 105-118,240,33,84,.393,19,48,.396,14,36,.389,25,25,1.000,105,46,94,.489,32,54,.593,14,40,.350,12,17,.706,118
969,ORL,2024-01-21,105,,MIA,W 105-87,240,37,78,.474,28,50,.560,9,28,.321,22,28,.786,105,30,80,.375,18,43,.419,12,37,.324,15,18,.833,87
970,POR,2024-01-17,105,,BRK,W 105-103,240,42,86,.488,33,59,.559,9,27,.333,12,14,.857,105,35,73,.479,20,35,.571,15,38,.395,18,27,.667,103
971,GSW,2024-01-10,105,,NOP,L 105-141,240,39,89,.438,27,50,.540,12,39,.308,15,18,.833,105,54,94,.574,35,54,.648,19,40,.475,14,19,.737,141
972,WAS,2024-01-06,105,,NYK,L 105-121,240,40,85,.471,27,48,.563,13,37,.351,12,20,.600,105,43,87,.494,29,51,.569,14,36,.389,21,24,.875,121
973,CHI,2023-12-30,105,,PHI,W 105-92,240,40,79,.506,33,54,.611,7,25,.280,18,30,.600,105,36,92,.391,27,54,.500,9,38,.237,11,15,.733,92
974,POR,2023-12-28,105,,SAS,L 105-118,240,35,101,.347,24,65,.369,11,36,.306,24,32,.750,105,41,85,.482,31,49,.633,10,36,.278,26,28,.929,118
975,MEM,2023-11-29,105,,UTA,W 105-91,240,43,87,.494,30,48,.625,13,39,.333,6,8,.750,105,34,90,.378,18,51,.353,16,39,.410,7,12,.583,91
976,CLE,2023-11-26,105,,TOR,W 105-102,240,45,97,.464,35,66,.530,10,31,.323,5,6,.833,105,37,89,.416,29,57,.509,8,32,.250,20,29,.690,102
977,UTA,2023-11-25,105,,NOP,W 105-100,240,38,87,.437,23,44,.523,15,43,.349,14,17,.824,105,39,93,.419,28,57,.491,11,36,.306,11,18,.611,100
978,HOU,2023-11-24,105,,DEN,W 105-86,240,40,82,.488,28,53,.528,12,29,.414,13,15,.867,105,32,94,.340,25,64,.391,7,30,.233,15,21,.714,86
979,LAL,2023-11-19,105,,HOU,W 105-104,240,39,83,.470,33,54,.611,6,29,.207,21,29,.724,105,41,84,.488,27,47,.574,14,37,.378,8,10,.800,104
980,TOR,2023-11-17,105,,BOS,L 105-108,240,42,87,.483,30,54,.556,12,33,.364,9,14,.643,105,42,92,.457,26,46,.565,16,46,.348,8,9,.889,108
981,CHO,2023-11-14,105,,MIA,L 105-111,240,36,81,.444,21,49,.429,15,32,.469,18,22,.818,105,40,83,.482,32,52,.615,8,31,.258,23,28,.821,111
982,SAC,2023-11-10,105,,OKC,W 105-98,240,38,91,.418,25,44,.568,13,47,.277,16,21,.762,105,39,87,.448,32,57,.561,7,30,.233,13,16,.813,98
983,NOP,2023-11-04,105,,ATL,L 105-123,240,40,84,.476,32,53,.604,8,31,.258,17,21,.810,105,45,93,.484,31,52,.596,14,41,.341,19,24,.792,123
984,MIA,2023-11-01,105,,BRK,L 105-109,240,39,91,.429,26,53,.491,13,38,.342,14,18,.778,105,37,82,.451,21,46,.457,16,36,.444,19,26,.731,109
985,IND,2023-10-30,105,,CHI,L 105-112,240,36,88,.409,24,42,.571,12,46,.261,21,25,.840,105,40,87,.460,34,70,.486,6,17,.353,26,31,.839,112
986,CLE,2023-10-27,105,,OKC,L 105-108,240,38,92,.413,26,47,.553,12,45,.267,17,23,.739,105,40,87,.460,27,61,.443,13,26,.500,15,19,.789,108
987,MIL,2024-04-09,104,,BOS,W 104-91,240,43,81,.531,26,45,.578,17,36,.472,1,2,.500,104,37,93,.398,20,41,.488,17,52,.327,0,0,,91
988,CHO,2024-04-09,104,,DAL,L 104-130,240,39,89,.438,29,57,.509,10,32,.313,16,21,.762,104,50,93,.538,33,43,.767,17,50,.340,13,20,.650,130
989,HOU,2024-04-05,104,,MIA,L 104-119,240,34,90,.378,20,46,.435,14,44,.318,22,25,.880,104,44,89,.494,31,53,.585,13,36,.361,18,21,.857,119
990,GSW,2024-04-02,104,,DAL,W 104-100,240,41,90,.456,26,58,.448,15,32,.469,7,7,1.000,104,39,89,.438,24,49,.490,15,40,.375,7,11,.636,100
991,CHO,2024-04-01,104,,BOS,L 104-118,240,41,91,.451,28,54,.519,13,37,.351,9,11,.818,104,43,89,.483,24,36,.667,19,53,.358,13,16,.813,118
992,ORL,2024-04-01,104,,POR,W 104-103,240,36,76,.474,25,44,.568,11,32,.344,21,27,.778,104,40,90,.444,29,59,.492,11,31,.355,12,15,.800,103
993,BRK,2024-03-31,104,,LAL,L 104-116,240,39,92,.424,27,56,.482,12,36,.333,14,19,.737,104,42,77,.545,27,37,.730,15,40,.375,17,22,.773,116
994,SAS,2024-03-25,104,,PHO,W 104-102,240,40,91,.440,32,60,.533,8,31,.258,16,19,.842,104,42,83,.506,32,55,.582,10,28,.357,8,14,.571,102
995,MIN,2024-03-22,104,,CLE,W 104-91,240,41,85,.482,27,58,.466,14,27,.519,8,16,.500,104,34,81,.420,27,52,.519,7,29,.241,16,19,.842,91
996,CLE,2024-03-20,104,,MIA,L 104-107,240,35,75,.467,20,33,.606,15,42,.357,19,22,.864,104,38,83,.458,25,47,.532,13,36,.361,18,19,.947,107
997,UTA,2024-03-18,104,,MIN,L 104-114,240,39,84,.464,25,52,.481,14,32,.438,12,14,.857,104,44,91,.484,28,50,.560,16,41,.390,10,12,.833,114
998,WAS,2024-03-17,104,,BOS,L 104-130,240,41,89,.461,31,55,.564,10,34,.294,12,14,.857,104,43,87,.494,19,37,.514,24,50,.480,20,24,.833,130
999,SAC,2024-03-10,104,,HOU,L 104-112,240,39,86,.453,33,54,.611,6,32,.188,20,23,.870,104,39,84,.464,27,55,.491,12,29,.414,22,27,.815,112
1000,PHI,2024-02-23,104,,CLE,W 104-97,240,40,90,.444,28,61,.459,12,29,.414,12,15,.800,104,34,80,.425,26,53,.491,8,27,.296,21,31,.677,97
1001,PHI,2024-02-14,104,,MIA,L 104-109,240,41,86,.477,31,51,.608,10,35,.286,12,16,.750,104,42,88,.477,31,53,.585,11,35,.314,14,15,.933,109
1002,PHI,2024-02-07,104,,GSW,L 104-127,240,41,98,.418,33,66,.500,8,32,.250,14,14,1.000,104,47,94,.500,31,56,.554,16,38,.421,17,22,.773,127
1003,DET,2024-01-27,104,,WAS,L 104-118,240,37,85,.435,28,53,.528,9,32,.281,21,27,.778,104,45,100,.450,34,66,.515,11,34,.324,17,21,.810,118
1004,CHO,2024-01-26,104,,HOU,L 104-138,240,35,85,.412,26,56,.464,9,29,.310,25,32,.781,104,50,89,.562,37,56,.661,13,33,.394,25,31,.806,138
1005,WAS,2024-01-21,104,,DEN,L 104-113,240,39,91,.429,31,64,.484,8,27,.296,18,22,.818,104,43,88,.489,35,66,.530,8,22,.364,19,28,.679,113
1006,MIA,2024-01-14,104,,CHO,W 104-87,240,40,81,.494,29,56,.518,11,25,.440,13,16,.813,104,33,95,.347,23,54,.426,10,41,.244,11,15,.733,87
1007,CHI,2024-01-05,104,,CHO,W 104-91,240,40,74,.541,30,46,.652,10,28,.357,14,17,.824,104,36,89,.404,26,55,.473,10,34,.294,9,12,.750,91
1008,SAC,2024-01-02,104,,CHO,L 104-111,240,40,92,.435,26,56,.464,14,36,.389,10,17,.588,104,42,82,.512,30,48,.625,12,34,.353,15,19,.789,111
1009,CHI,2023-12-28,104,,IND,L 104-120,240,40,97,.412,33,70,.471,7,27,.259,17,22,.773,104,43,85,.506,24,43,.558,19,42,.452,15,22,.682,120
1010,NOP,2023-12-23,104,,HOU,L 104-106,240,38,82,.463,30,51,.588,8,31,.258,20,29,.690,104,35,82,.427,26,53,.491,9,29,.310,27,35,.771,106
1011,CLE,2023-12-21,104,,NOP,L 104-123,240,41,87,.471,24,43,.558,17,44,.386,5,8,.625,104,47,86,.547,32,51,.627,15,35,.429,14,16,.875,123
1012,TOR,2023-12-20,104,,DEN,L 104-113,240,43,90,.478,34,63,.540,9,27,.333,9,13,.692,104,49,98,.500,37,65,.569,12,33,.364,3,7,.429,113
1013,PHI,2023-12-18,104,,CHI,L 104-108,240,38,88,.432,27,56,.482,11,32,.344,17,19,.895,104,42,89,.472,30,60,.500,12,29,.414,12,15,.800,108
1014,TOR,2023-12-15,104,,ATL,L 104-125,240,40,77,.519,30,46,.652,10,31,.323,14,25,.560,104,52,101,.515,36,60,.600,16,41,.390,5,6,.833,125
1015,ORL,2023-12-11,104,,CLE,W 104-94,240,39,84,.464,32,58,.552,7,26,.269,19,25,.760,104,30,85,.353,21,45,.467,9,40,.225,25,33,.758,94
1016,LAC,2023-11-27,104,,DEN,L 104-113,240,35,85,.412,29,65,.446,6,20,.300,28,34,.824,104,44,92,.478,34,70,.486,10,22,.455,15,28,.536,113
1017,HOU,2023-11-10,104,,NOP,W 104-101,240,36,88,.409,26,53,.491,10,35,.286,22,28,.786,104,34,75,.453,26,50,.520,8,25,.320,25,34,.735,101
1018,MEM,2023-10-27,104,,DEN,L 104-108,240,37,85,.435,27,52,.519,10,33,.303,20,24,.833,104,41,88,.466,27,51,.529,14,37,.378,12,18,.667,108
1019,CHI,2023-10-27,104,,TOR,W 104-103 (OT),265,37,99,.374,29,60,.483,8,39,.205,22,28,.786,104,39,84,.464,30,48,.625,9,36,.250,16,25,.640,103
1020,CHI,2023-10-25,104,,OKC,L 104-124,240,39,94,.415,27,52,.519,12,42,.286,14,18,.778,104,45,82,.549,26,43,.605,19,39,.487,15,18,.833,124
1021,NYK,2023-10-25,104,,BOS,L 104-108,240,36,97,.371,18,56,.321,18,41,.439,14,26,.538,104,37,77,.481,25,38,.658,12,39,.308,22,26,.846,108
1022,MEM,2023-10-25,104,,NOP,L 104-111,240,38,91,.418,26,48,.542,12,43,.279,16,20,.800,104,40,85,.471,26,53,.491,14,32,.438,17,22,.773,111
1023,GSW,2023-10-24,104,,PHO,L 104-108,240,36,101,.356,26,58,.448,10,43,.233,22,28,.786,104,42,95,.442,31,62,.500,11,33,.333,13,17,.765,108
1024,SAC,2024-03-29,103,,DAL,L 103-107,240,40,92,.435,25,60,.417,15,32,.469,8,12,.667,103,35,74,.473,20,39,.513,15,35,.429,22,33,.667,107
1025,TOR,2024-03-22,103,,OKC,L 103-123,240,40,76,.526,29,46,.630,11,30,.367,12,17,.706,103,48,95,.505,36,63,.571,12,32,.375,15,19,.789,123
1026,POR,2024-03-20,103,,LAC,L 103-116,240,39,81,.481,24,47,.511,15,34,.441,10,15,.667,103,45,86,.523,32,55,.582,13,31,.419,13,15,.867,116
1027,DET,2024-03-20,103,,IND,L 103-122,240,37,90,.411,32,67,.478,5,23,.217,24,30,.800,103,50,88,.568,39,59,.661,11,29,.379,11,18,.611,122
1028,IND,2024-03-18,103,,CLE,L 103-108,240,42,91,.462,33,53,.623,9,38,.237,10,16,.625,103,38,80,.475,26,48,.542,12,32,.375,20,28,.714,108
1029,TOR,2024-03-15,103,,ORL,L 103-113,240,38,81,.469,24,47,.511,14,34,.412,13,20,.650,103,40,80,.500,26,49,.531,14,31,.452,19,22,.864,113
1030,ATL,2024-03-10,103,,NOP,L 103-116,240,38,91,.418,21,45,.467,17,46,.370,10,13,.769,103,43,75,.573,29,48,.604,14,27,.519,16,22,.727,116
1031,DEN,2024-02-29,103,,MIA,W 103-97,240,36,84,.429,24,50,.480,12,34,.353,19,21,.905,103,35,83,.422,28,57,.491,7,26,.269,20,24,.833,97
1032,GSW,2024-02-25,103,,DEN,L 103-119,240,35,81,.432,24,47,.511,11,34,.324,22,29,.759,103,43,88,.489,32,56,.571,11,32,.344,22,26,.846,119
1033,BRK,2024-01-23,103,,NYK,L 103-108,240,42,95,.442,27,53,.509,15,42,.357,4,5,.800,103,40,86,.465,30,57,.526,10,29,.345,18,19,.947,108
1034,DAL,2024-01-09,103,,MEM,L 103-120,240,36,82,.439,27,55,.491,9,27,.333,22,27,.815,103,44,91,.484,30,54,.556,14,37,.378,18,21,.857,120
1035,MEM,2023-12-08,103,,MIN,L 103-127,240,37,86,.430,22,51,.431,15,35,.429,14,19,.737,103,44,88,.500,29,50,.580,15,38,.395,24,26,.923,127
1036,UTA,2023-12-08,103,,LAC,L 103-117,240,38,84,.452,29,53,.547,9,31,.290,18,24,.750,103,43,88,.489,28,54,.519,15,34,.441,16,21,.762,117
1037,TOR,2023-12-06,103,,MIA,L 103-112,240,37,86,.430,23,49,.469,14,37,.378,15,17,.882,103,41,89,.461,27,51,.529,14,38,.368,16,19,.842,112
1038,DET,2023-11-20,103,,DEN,L 103-107,240,36,81,.444,29,60,.483,7,21,.333,24,26,.923,103,40,87,.460,29,59,.492,11,28,.393,16,21,.762,107
1039,MIA,2023-10-25,103,,DET,W 103-102,240,37,92,.402,29,70,.414,8,22,.364,21,26,.808,103,41,92,.446,30,60,.500,11,32,.344,9,15,.600,102
1040,WAS,2024-04-05,102,,POR,L 102-108,240,38,88,.432,33,55,.600,5,33,.152,21,30,.700,102,41,94,.436,32,65,.492,9,29,.310,17,24,.708,108
1041,LAC,2024-04-04,102,,DEN,W 102-100,240,34,90,.378,27,57,.474,7,33,.212,27,32,.844,102,36,83,.434,25,48,.521,11,35,.314,17,25,.680,100
1042,DET,2024-03-22,102,,BOS,L 102-129,240,42,83,.506,33,52,.635,9,31,.290,9,13,.692,102,47,89,.528,31,44,.705,16,45,.356,19,27,.704,129
1043,SAS,2024-03-11,102,,GSW,L 102-112,240,39,93,.419,25,56,.446,14,37,.378,10,15,.667,102,46,93,.495,34,66,.515,12,27,.444,8,12,.667,112
1044,BRK,2024-03-04,102,,MEM,L 102-106,240,35,79,.443,20,37,.541,15,42,.357,17,30,.567,102,38,82,.463,26,45,.578,12,37,.324,18,22,.818,106
1045,NYK,2024-02-24,102,,BOS,L 102-116,240,37,82,.451,24,44,.545,13,38,.342,15,16,.938,102,46,81,.568,31,46,.674,15,35,.429,9,12,.750,116
1046,PHI,2024-02-05,102,,DAL,L 102-118,240,40,93,.430,32,64,.500,8,29,.276,14,20,.700,102,42,87,.483,25,44,.568,17,43,.395,17,23,.739,118
1047,WAS,2024-02-02,102,,MIA,L 102-110,240,37,90,.411,26,48,.542,11,42,.262,17,21,.810,102,38,88,.432,31,57,.544,7,31,.226,27,35,.771,110
1048,GSW,2023-12-28,102,,MIA,L 102-114,240,37,88,.420,29,55,.527,8,33,.242,20,25,.800,102,44,91,.484,34,60,.567,10,31,.323,16,22,.727,114
1049,WAS,2023-12-27,102,,TOR,L 102-132,240,42,90,.467,34,57,.596,8,33,.242,10,15,.667,102,52,91,.571,37,53,.698,15,38,.395,13,19,.684,132
1050,BRK,2023-12-20,102,,NYK,L 102-121,240,37,101,.366,22,54,.407,15,47,.319,13,17,.765,102,44,95,.463,31,62,.500,13,33,.394,20,25,.800,121
1051,DET,2023-12-06,102,,MEM,L 102-116,240,41,91,.451,30,56,.536,11,35,.314,9,9,1.000,102,47,91,.516,36,65,.554,11,26,.423,11,14,.786,116
1052,MIN,2023-12-06,102,,SAS,W 102-94,240,36,87,.414,24,47,.511,12,40,.300,18,21,.857,102,38,101,.376,30,65,.462,8,36,.222,10,15,.667,94
1053,SAS,2023-11-22,102,,LAC,L 102-109,240,35,91,.385,24,53,.453,11,38,.289,21,23,.913,102,39,85,.459,30,57,.526,9,28,.321,22,29,.759,109
1054,CHI,2023-11-18,102,,MIA,W 102-97,240,36,81,.444,20,36,.556,16,45,.356,14,19,.737,102,33,77,.429,21,41,.512,12,36,.333,19,23,.826,97
1055,BRK,2023-11-12,102,,WAS,W 102-94,240,37,98,.378,25,49,.510,12,49,.245,16,20,.800,102,33,88,.375,23,47,.489,10,41,.244,18,25,.720,94
1056,MEM,2023-11-08,102,,MIA,L 102-108,240,35,90,.389,24,53,.453,11,37,.297,21,28,.750,102,35,77,.455,24,49,.490,11,28,.393,27,32,.844,108
1057,ORL,2023-11-06,102,,DAL,L 102-117,240,40,85,.471,32,58,.552,8,27,.296,14,18,.778,102,41,82,.500,26,42,.619,15,40,.375,20,28,.714,117
1058,GSW,2023-11-01,102,,SAC,W 102-101,240,39,81,.481,28,50,.560,11,31,.355,13,15,.867,102,36,88,.409,25,53,.472,11,35,.314,18,23,.783,101
1059,NOP,2023-10-30,102,,GSW,L 102-130,240,38,93,.409,28,54,.519,10,39,.256,16,26,.615,102,51,98,.520,36,57,.632,15,41,.366,13,20,.650,130
1060,BOS,2024-04-05,101,,SAC,W 101-100,240,38,89,.427,26,45,.578,12,44,.273,13,18,.722,101,38,99,.384,21,48,.438,17,51,.333,7,13,.538,100
1061,MIL,2024-04-03,101,,MEM,L 101-111,240,38,95,.400,20,51,.392,18,44,.409,7,12,.583,101,46,91,.505,39,68,.574,7,23,.304,12,17,.706,111
1062,CHI,2024-04-01,101,,ATL,L 101-113,240,37,94,.394,30,66,.455,7,28,.250,20,24,.833,101,41,82,.500,22,42,.524,19,40,.475,12,18,.667,113
1063,MIN,2024-03-31,101,,CHI,L 101-109,240,38,81,.469,27,44,.614,11,37,.297,14,21,.667,101,42,80,.525,25,51,.490,17,29,.586,8,12,.667,109
1064,TOR,2024-03-27,101,,NYK,L 101-145,240,39,84,.464,28,53,.528,11,31,.355,12,13,.923,101,55,94,.585,33,50,.660,22,44,.500,13,16,.813,145
1065,DET,2024-03-24,101,,NOP,L 101-114,240,32,79,.405,21,38,.553,11,41,.268,26,32,.813,101,41,81,.506,30,47,.638,11,34,.324,21,31,.677,114
1066,LAL,2024-03-22,101,,PHI,W 101-94,240,32,73,.438,20,42,.476,12,31,.387,25,33,.758,101,33,96,.344,25,59,.424,8,37,.216,20,24,.833,94
1067,DET,2024-03-17,101,,MIA,L 101-104,240,38,83,.458,24,47,.511,14,36,.389,11,14,.786,101,40,89,.449,28,54,.519,12,35,.343,12,16,.750,104
1068,SAS,2024-03-12,101,,HOU,L 101-103,240,39,82,.476,28,46,.609,11,36,.306,12,14,.857,101,37,80,.463,27,48,.563,10,32,.313,19,21,.905,103
1069,CLE,2024-03-10,101,,BRK,L 101-120,240,37,76,.487,23,44,.523,14,32,.438,13,20,.650,101,42,79,.532,24,44,.545,18,35,.514,18,20,.900,120
1070,MIN,2024-02-24,101,,BRK,W 101-86,240,36,84,.429,24,46,.522,12,38,.316,17,23,.739,101,35,104,.337,29,69,.420,6,35,.171,10,11,.909,86
1071,SAS,2024-02-03,101,,CLE,L 101-117,240,36,98,.367,24,58,.414,12,40,.300,17,21,.810,101,46,97,.474,33,53,.623,13,44,.295,12,13,.923,117
1072,MEM,2024-02-02,101,,GSW,L 101-121,240,35,87,.402,21,41,.512,14,46,.304,17,24,.708,101,46,83,.554,35,54,.648,11,29,.379,18,22,.818,121
1073,MEM,2024-02-01,101,,CLE,L 101-108,240,37,90,.411,25,52,.481,12,38,.316,15,17,.882,101,41,86,.477,27,51,.529,14,35,.400,12,18,.667,108
1074,OKC,2024-01-29,101,,MIN,L 101-107,240,35,79,.443,21,44,.477,14,35,.400,17,22,.773,101,40,83,.482,26,54,.481,14,29,.483,13,15,.867,107
1075,IND,2024-01-06,101,,BOS,L 101-118,240,38,92,.413,30,50,.600,8,42,.190,17,22,.773,101,46,90,.511,30,49,.612,16,41,.390,10,19,.526,118
1076,SAS,2023-12-31,101,,BOS,L 101-134,240,40,94,.426,28,49,.571,12,45,.267,9,12,.750,101,51,95,.537,36,53,.679,15,42,.357,17,22,.773,134
1077,DAL,2023-12-14,101,,MIN,L 101-119,240,39,83,.470,32,51,.627,7,32,.219,16,18,.889,101,44,88,.500,30,57,.526,14,31,.452,17,25,.680,119
1078,DET,2023-12-02,101,,CLE,L 101-110,240,39,83,.470,31,53,.585,8,30,.267,15,23,.652,101,44,89,.494,34,59,.576,10,30,.333,12,18,.667,110
1079,MIN,2023-11-30,101,,UTA,W 101-90,240,39,89,.438,26,54,.481,13,35,.371,10,13,.769,101,33,87,.379,22,53,.415,11,34,.324,13,14,.929,90
1080,LAL,2023-11-22,101,,DAL,L 101-104,240,39,84,.464,28,55,.509,11,29,.379,12,19,.632,101,38,96,.396,22,46,.478,16,50,.320,12,16,.750,104
1081,GSW,2023-11-14,101,,MIN,L 101-104,240,37,88,.420,24,49,.490,13,39,.333,14,16,.875,101,36,81,.444,22,47,.468,14,34,.412,18,21,.857,104
1082,LAC,2023-11-12,101,,MEM,L 101-105,240,37,85,.435,25,51,.490,12,34,.353,15,23,.652,101,37,88,.420,24,47,.511,13,41,.317,18,24,.750,105
1083,DET,2023-11-01,101,,POR,L 101-110,240,40,90,.444,29,61,.475,11,29,.379,10,11,.909,101,38,81,.469,31,61,.508,7,20,.350,27,33,.818,110
1084,POR,2024-04-09,100,,NOP,L 100-110,240,40,85,.471,27,47,.574,13,38,.342,7,8,.875,100,36,87,.414,25,51,.490,11,36,.306,27,29,.931,110
1085,UTA,2024-03-29,100,,HOU,L 100-101,240,37,80,.463,29,49,.592,8,31,.258,18,19,.947,100,35,91,.385,22,49,.449,13,42,.310,18,28,.643,101
1086,UTA,2024-03-16,100,,MIN,L 100-119,240,38,83,.458,32,57,.561,6,26,.231,18,21,.857,100,44,93,.473,25,52,.481,19,41,.463,12,15,.800,119
1087,LAC,2024-03-12,100,,MIN,L 100-118,240,34,72,.472,23,42,.548,11,30,.367,21,25,.840,100,48,94,.511,36,61,.590,12,33,.364,10,14,.714,118
1088,NYK,2024-03-05,100,,ATL,L 100-116,240,38,99,.384,22,47,.468,16,52,.308,8,11,.727,100,44,87,.506,34,56,.607,10,31,.323,18,23,.783,116
1089,MEM,2024-03-02,100,,POR,L 100-107 (OT),265,30,83,.361,15,43,.349,15,40,.375,25,33,.758,100,39,92,.424,28,57,.491,11,35,.314,18,24,.750,107
1090,DET,2024-03-01,100,,CLE,L 100-110,240,33,89,.371,23,53,.434,10,36,.278,24,28,.857,100,33,83,.398,15,42,.357,18,41,.439,26,30,.867,110
1091,LAC,2024-02-12,100,,MIN,L 100-121,240,34,84,.405,25,56,.446,9,28,.321,23,26,.885,100,46,86,.535,35,52,.673,11,34,.324,18,19,.947,121
1092,MIL,2024-01-26,100,,CLE,L 100-112,240,35,87,.402,22,53,.415,13,34,.382,17,24,.708,100,38,92,.413,24,56,.429,14,36,.389,22,31,.710,112
1093,TOR,2024-01-22,100,,MEM,L 100-108,240,35,79,.443,27,56,.482,8,23,.348,22,23,.957,100,44,95,.463,31,61,.508,13,34,.382,7,12,.583,108
1094,BOS,2024-01-19,100,,DEN,L 100-102,240,38,89,.427,24,45,.533,14,44,.318,10,14,.714,100,42,81,.519,34,50,.680,8,31,.258,10,13,.769,102
1095,SAC,2024-01-07,100,,NOP,L 100-133,240,38,91,.418,23,46,.500,15,45,.333,9,12,.750,100,50,82,.610,31,47,.660,19,35,.543,14,16,.875,133
1096,NYK,2023-11-24,100,,MIA,W 100-98,240,39,81,.481,29,52,.558,10,29,.345,12,18,.667,100,34,87,.391,24,50,.480,10,37,.270,20,21,.952,98
1097,CHI,2023-11-20,100,,MIA,L 100-118,240,37,81,.457,26,44,.591,11,37,.297,15,16,.938,100,42,84,.500,25,49,.510,17,35,.486,17,20,.850,118
1098,MEM,2023-11-19,100,,BOS,L 100-102,240,37,95,.389,20,51,.392,17,44,.386,9,10,.900,100,35,77,.455,23,46,.500,12,31,.387,20,25,.800,102
1099,BRK,2023-11-08,100,,LAC,W 100-93,240,37,92,.402,22,51,.431,15,41,.366,11,13,.846,100,36,91,.396,28,55,.509,8,36,.222,13,13,1.000,93
1100,POR,2023-11-05,100,,MEM,L 100-112,240,37,95,.389,23,50,.460,14,45,.311,12,15,.800,100,45,89,.506,32,57,.561,13,32,.406,9,13,.692,112
1101,LAL,2023-10-26,100,,PHO,W 100-95,240,36,84,.429,31,55,.564,5,29,.172,23,29,.793,100,34,81,.420,25,50,.500,9,31,.290,18,23,.783,95
1102,POR,2024-03-11,99,,BOS,L 99-121,240,39,87,.448,29,59,.492,10,28,.357,11,11,1.000,99,49,100,.490,34,60,.567,15,40,.375,8,12,.667,121
1103,CHO,2024-02-29,99,,MIL,L 99-111,240,36,82,.439,24,43,.558,12,39,.308,15,20,.750,99,39,86,.453,23,47,.489,16,39,.410,17,20,.850,111
1104,NYK,2024-02-29,99,,GSW,L 99-110,240,35,95,.368,23,56,.411,12,39,.308,17,24,.708,99,44,98,.449,30,54,.556,14,44,.318,8,16,.500,110
1105,TOR,2024-02-12,99,,SAS,L 99-122,240,39,98,.398,31,67,.463,8,31,.258,13,16,.813,99,46,87,.529,35,57,.614,11,30,.367,19,23,.826,122
1106,CHO,2024-02-04,99,,IND,L 99-115,240,35,88,.398,27,59,.458,8,29,.276,21,25,.840,99,45,92,.489,34,59,.576,11,33,.333,14,18,.778,115
1107,DET,2024-02-04,99,,ORL,L 99-111,240,36,80,.450,28,49,.571,8,31,.258,19,22,.864,99,45,84,.536,35,60,.583,10,24,.417,11,15,.733,111
1108,HOU,2024-01-31,99,,NOP,L 99-110,240,35,87,.402,22,43,.512,13,44,.295,16,17,.941,99,41,82,.500,30,48,.625,11,34,.324,17,24,.708,110
1109,ORL,2024-01-22,99,,CLE,L 99-126,240,34,74,.459,23,45,.511,11,29,.379,20,30,.667,99,45,80,.563,25,42,.595,20,38,.526,16,22,.727,126
1110,ATL,2024-01-13,99,,WAS,L 99-127,240,32,93,.344,21,53,.396,11,40,.275,24,33,.727,99,47,97,.485,35,65,.538,12,32,.375,21,26,.808,127
1111,MIA,2024-01-12,99,,ORL,W 99-96,240,37,83,.446,29,57,.509,8,26,.308,17,20,.850,99,36,82,.439,24,42,.571,12,40,.300,12,20,.600,96
1112,MIA,2023-12-08,99,,CLE,L 99-111,240,37,86,.430,22,44,.500,15,42,.357,10,15,.667,99,40,87,.460,26,49,.531,14,38,.368,17,26,.654,111
1113,SAS,2023-11-20,99,,LAC,L 99-124,240,39,90,.433,29,52,.558,10,38,.263,11,14,.786,99,45,95,.474,33,59,.559,12,36,.333,22,25,.880,124
1114,BRK,2023-11-19,99,,PHI,L 99-121,240,38,81,.469,27,53,.509,11,28,.393,12,16,.750,99,44,94,.468,28,59,.475,16,35,.457,17,18,.944,121
1115,CHO,2023-11-17,99,,MIL,L 99-130,240,37,91,.407,31,65,.477,6,26,.231,19,22,.864,99,49,89,.551,27,44,.614,22,45,.489,10,13,.769,130
1116,WAS,2023-11-17,99,,NYK,L 99-120,240,37,82,.451,27,50,.540,10,32,.313,15,16,.938,99,45,91,.495,29,53,.547,16,38,.421,14,20,.700,120
1117,PHO,2023-11-12,99,,OKC,L 99-111,240,32,83,.386,23,54,.426,9,29,.310,26,31,.839,99,40,82,.488,30,55,.545,10,27,.370,21,25,.840,111
1118,CHO,2023-10-27,99,,DET,L 99-111,240,33,88,.375,26,60,.433,7,28,.250,26,34,.765,99,40,88,.455,30,58,.517,10,30,.333,21,25,.840,111
1119,DEN,2024-03-29,98,,MIN,L 98-111,240,35,88,.398,27,60,.450,8,28,.286,20,27,.741,98,38,74,.514,29,46,.630,9,28,.321,26,37,.703,111
1120,PHI,2024-03-18,98,,MIA,W 98-91,240,37,85,.435,24,49,.490,13,36,.361,11,12,.917,98,35,89,.393,23,56,.411,12,33,.364,9,14,.643,91
1121,MEM,2024-03-13,98,,CHO,L 98-110,240,36,85,.424,20,45,.444,16,40,.400,10,11,.909,98,44,82,.537,31,46,.674,13,36,.361,9,13,.692,110
1122,NYK,2024-03-08,98,,ORL,W 98-74,240,38,79,.481,22,46,.478,16,33,.485,6,8,.750,98,27,79,.342,21,53,.396,6,26,.231,14,20,.700,74
1123,TOR,2024-03-05,98,,NOP,L 98-139,240,36,93,.387,23,49,.469,13,44,.295,13,22,.591,98,53,105,.505,29,56,.518,24,49,.490,9,11,.818,139
1124,CLE,2024-03-03,98,,NYK,L 98-107,240,39,87,.448,22,43,.512,17,44,.386,3,8,.375,98,42,86,.488,26,47,.553,16,39,.410,7,10,.700,107
1125,PHI,2024-02-25,98,,MIL,L 98-119,240,36,97,.371,20,51,.392,16,46,.348,10,11,.909,98,43,79,.544,25,42,.595,18,37,.486,15,18,.833,119
1126,DEN,2024-02-14,98,,SAC,L 98-102,240,35,89,.393,26,63,.413,9,26,.346,19,22,.864,98,39,89,.438,30,56,.536,9,33,.273,15,19,.789,102
1127,BRK,2024-02-05,98,,GSW,L 98-109,240,34,89,.382,21,47,.447,13,42,.310,17,22,.773,98,43,93,.462,39,71,.549,4,22,.182,19,23,.826,109
1128,SAS,2024-01-31,98,,ORL,L 98-108,240,36,80,.450,27,49,.551,9,31,.290,17,24,.708,98,41,86,.477,34,66,.515,7,20,.350,19,23,.826,108
1129,CHO,2024-01-10,98,,SAC,L 98-123,240,35,87,.402,19,49,.388,16,38,.421,12,16,.750,98,46,89,.517,33,54,.611,13,35,.371,18,23,.783,123
1130,SAC,2023-12-23,98,,MIN,L 98-110,240,37,85,.435,29,52,.558,8,33,.242,16,21,.762,98,44,87,.506,34,54,.630,10,33,.303,12,14,.857,110
1131,PHO,2024-04-05,97,,MIN,W 97-87,240,33,76,.434,24,50,.480,9,26,.346,22,29,.759,97,33,85,.388,23,56,.411,10,29,.345,11,14,.786,87
1132,CHO,2024-03-29,97,,GSW,L 97-115,240,34,84,.405,22,38,.579,12,46,.261,17,24,.708,97,48,89,.539,37,57,.649,11,32,.344,8,9,.889,115
1133,ORL,2024-03-29,97,,LAC,L 97-100,240,38,86,.442,28,57,.491,10,29,.345,11,15,.733,97,41,85,.482,33,61,.541,8,24,.333,10,12,.833,100
1134,DEN,2024-03-27,97,,PHO,L 97-104,240,38,88,.432,28,48,.583,10,40,.250,11,12,.917,97,39,83,.470,23,50,.460,16,33,.485,10,11,.909,104
1135,SAS,2024-03-22,97,,MEM,L 97-99,240,37,95,.389,30,57,.526,7,38,.184,16,23,.696,97,33,82,.402,21,48,.438,12,34,.353,21,31,.677,99
1136,ORL,2024-03-10,97,,IND,L 97-111,240,33,88,.375,24,52,.462,9,36,.250,22,29,.759,97,38,78,.487,30,55,.545,8,23,.348,27,33,.818,111
1137,CHI,2024-03-01,97,,MIL,L 97-113,240,36,86,.419,25,59,.424,11,27,.407,14,16,.875,97,37,86,.430,22,40,.550,15,46,.326,24,32,.750,113
1138,GSW,2024-02-23,97,,CHO,W 97-84,240,38,89,.427,25,47,.532,13,42,.310,8,10,.800,97,32,88,.364,21,49,.429,11,39,.282,9,11,.818,84
1139,MIL,2024-02-13,97,,MIA,L 97-123,240,37,83,.446,24,44,.545,13,39,.333,10,11,.909,97,45,87,.517,26,47,.553,19,40,.475,14,18,.778,123
1140,MIN,2024-01-20,97,,OKC,L 97-102,240,31,75,.413,17,38,.447,14,37,.378,21,29,.724,97,32,81,.395,24,57,.421,8,24,.333,30,35,.857,102
1141,MEM,2023-11-26,97,,MIN,L 97-119,240,34,88,.386,24,51,.471,10,37,.270,19,27,.704,97,43,81,.531,28,47,.596,15,34,.441,18,23,.783,119
1142,CHI,2023-11-17,97,,ORL,L 97-103,240,35,79,.443,25,50,.500,10,29,.345,17,22,.773,97,38,79,.481,27,45,.600,11,34,.324,16,23,.696,103
1143,POR,2023-10-27,97,,ORL,L 97-102,240,35,88,.398,26,56,.464,9,32,.281,18,21,.857,97,36,79,.456,27,51,.529,9,28,.321,21,32,.656,102
1144,TOR,2023-10-25,97,,MIN,W 97-94,240,36,90,.400,22,55,.400,14,35,.400,11,16,.688,97,34,100,.340,26,69,.377,8,31,.258,18,22,.818,94
1145,MEM,2024-04-06,96,,PHI,L 96-116,240,36,87,.414,27,61,.443,9,26,.346,15,21,.714,96,41,79,.519,25,40,.625,16,39,.410,18,23,.783,116
1146,SAC,2024-03-26,96,,DAL,L 96-132,240,35,90,.389,24,60,.400,11,30,.367,15,19,.789,96,51,92,.554,29,53,.547,22,39,.564,8,13,.615,132
1147,CHO,2024-03-15,96,,PHO,L 96-107,240,35,94,.372,29,57,.509,6,37,.162,20,27,.741,96,40,87,.460,29,49,.592,11,38,.289,16,20,.800,107
1148,POR,2024-02-27,96,,MIA,L 96-106,240,35,86,.407,25,55,.455,10,31,.323,16,19,.842,96,37,70,.529,23,44,.523,14,26,.538,18,26,.692,106
1149,PHI,2024-02-22,96,,NYK,L 96-110,240,37,84,.440,27,55,.491,10,29,.345,12,14,.857,96,38,79,.481,23,45,.511,15,34,.441,19,27,.704,110
1150,POR,2024-01-28,96,,CHI,L 96-104,240,32,79,.405,26,46,.565,6,33,.182,26,29,.897,96,42,90,.467,34,58,.586,8,32,.250,12,17,.706,104
1151,BOS,2024-01-27,96,,LAC,L 96-115,240,36,100,.360,26,60,.433,10,40,.250,14,16,.875,96,45,102,.441,35,62,.565,10,40,.250,15,18,.833,115
1152,MIA,2024-01-24,96,,MEM,L 96-105,240,33,82,.402,22,48,.458,11,34,.324,19,25,.760,96,36,80,.450,19,44,.432,17,36,.472,16,19,.842,105
1153,TOR,2024-01-15,96,,BOS,L 96-105,240,38,95,.400,34,63,.540,4,32,.125,16,21,.762,96,33,82,.402,17,43,.395,16,39,.410,23,25,.920,105
1154,LAL,2024-01-03,96,,MIA,L 96-110,240,35,83,.422,31,53,.585,4,30,.133,22,24,.917,96,41,93,.441,25,51,.490,16,42,.381,12,17,.706,110
1155,MEM,2023-12-15,96,,HOU,L 96-103,240,37,92,.402,26,52,.500,11,40,.275,11,15,.733,96,32,88,.364,21,59,.356,11,29,.379,28,32,.875,103
1156,CLE,2023-11-22,96,,MIA,L 96-129,240,36,77,.468,22,47,.468,14,30,.467,10,14,.714,96,46,88,.523,26,53,.491,20,35,.571,17,21,.810,129
1157,NOP,2023-10-28,96,,NYK,W 96-87,240,40,87,.460,31,54,.574,9,33,.273,7,16,.438,96,33,90,.367,26,53,.491,7,37,.189,14,18,.778,87
1158,UTA,2024-04-09,95,,DEN,L 95-111,240,36,91,.396,26,60,.433,10,31,.323,13,13,1.000,95,46,94,.489,32,57,.561,14,37,.378,5,11,.455,111
1159,DET,2024-03-15,95,,MIA,L 95-108,240,36,84,.429,26,46,.565,10,38,.263,13,15,.867,95,43,91,.473,36,57,.632,7,34,.206,15,21,.714,108
1160,NOP,2024-03-13,95,,CLE,L 95-116,240,35,80,.438,31,58,.534,4,22,.182,21,26,.808,95,47,92,.511,27,47,.574,20,45,.444,2,3,.667,116
1161,PHI,2024-03-08,95,,NOP,L 95-103,240,35,88,.398,26,51,.510,9,37,.243,16,20,.800,95,35,79,.443,24,48,.500,11,31,.355,22,23,.957,103
1162,CHI,2024-02-27,95,,DET,L 95-105,240,39,98,.398,37,69,.536,2,29,.069,15,18,.833,95,37,75,.493,23,38,.605,14,37,.378,17,23,.739,105
1163,MEM,2024-02-23,95,,LAC,L 95-101,240,38,91,.418,30,56,.536,8,35,.229,11,16,.688,95,37,84,.440,25,52,.481,12,32,.375,15,17,.882,101
1164,NOP,2024-02-23,95,,MIA,L 95-106,240,39,104,.375,32,72,.444,7,32,.219,10,13,.769,95,38,82,.463,25,53,.472,13,29,.448,17,25,.680,106
1165,TOR,2024-02-10,95,,CLE,L 95-119,240,35,87,.402,26,56,.464,9,31,.290,16,23,.696,95,48,92,.522,34,51,.667,14,41,.341,9,13,.692,119
1166,BRK,2024-02-08,95,,CLE,L 95-118,240,37,93,.398,27,68,.397,10,25,.400,11,14,.786,95,43,80,.538,28,43,.651,15,37,.405,17,17,1.000,118
1167,MIA,2024-02-04,95,,LAC,L 95-103,240,38,91,.418,30,61,.492,8,30,.267,11,12,.917,95,34,77,.442,18,38,.474,16,39,.410,19,22,.864,103
1168,ATL,2024-01-20,95,,CLE,L 95-116,240,37,93,.398,26,55,.473,11,38,.289,10,15,.667,95,43,85,.506,27,42,.643,16,43,.372,14,16,.875,116
1169,BRK,2024-01-15,95,,MIA,L 95-96 (OT),265,34,99,.343,22,44,.500,12,55,.218,15,16,.938,95,33,87,.379,25,56,.446,8,31,.258,22,25,.880,96
1170,HOU,2024-01-05,95,,MIN,L 95-122,240,36,90,.400,24,58,.414,12,32,.375,11,15,.733,95,46,88,.523,32,55,.582,14,33,.424,16,20,.800,122
1171,NOP,2024-01-05,95,,LAC,L 95-111,240,33,92,.359,21,63,.333,12,29,.414,17,23,.739,95,40,82,.488,25,46,.543,15,36,.417,16,20,.800,111
1172,CHO,2023-12-23,95,,DEN,L 95-102,240,34,88,.386,26,60,.433,8,28,.286,19,23,.826,95,39,90,.433,27,60,.450,12,30,.400,12,14,.857,102
1173,CHI,2023-12-23,95,,CLE,L 95-109,240,35,80,.438,27,45,.600,8,35,.229,17,19,.895,95,39,88,.443,27,43,.628,12,45,.267,19,26,.731,109
1174,CLE,2023-11-30,95,,POR,L 95-103,240,38,89,.427,31,57,.544,7,32,.219,12,12,1.000,95,39,77,.506,25,42,.595,14,35,.400,11,11,1.000,103
1175,POR,2023-11-17,95,,LAL,L 95-107,240,36,89,.404,26,52,.500,10,37,.270,13,18,.722,95,40,81,.494,28,52,.538,12,29,.414,15,22,.682,107
1176,POR,2023-11-15,95,,CLE,L 95-109,240,34,91,.374,21,53,.396,13,38,.342,14,16,.875,95,42,75,.560,33,45,.733,9,30,.300,16,21,.762,109
1177,HOU,2023-10-29,95,,GSW,L 95-106,240,34,90,.378,25,57,.439,9,33,.273,18,19,.947,95,35,81,.432,17,36,.472,18,45,.400,18,23,.783,106
1178,OKC,2023-10-29,95,,DEN,L 95-128,240,37,90,.411,31,58,.534,6,32,.188,15,18,.833,95,53,88,.602,42,61,.689,11,27,.407,11,13,.846,128
1179,MEM,2024-01-29,94,,SAC,L 94-103,240,30,80,.375,17,44,.386,13,36,.361,21,28,.750,94,43,84,.512,32,46,.696,11,38,.289,6,10,.600,103
1180,BRK,2024-01-25,94,,MIN,L 94-96,240,35,77,.455,25,44,.568,10,33,.303,14,16,.875,94,37,75,.493,27,54,.500,10,21,.476,12,16,.750,96
1181,NYK,2024-01-15,94,,ORL,L 94-98,240,33,83,.398,20,43,.465,13,40,.325,15,22,.682,94,38,85,.447,30,56,.536,8,29,.276,14,21,.667,98
1182,MEM,2024-01-13,94,,NYK,L 94-106,240,36,87,.414,27,49,.551,9,38,.237,13,15,.867,94,40,83,.482,27,45,.600,13,38,.342,13,19,.684,106
1183,DAL,2023-12-01,94,,MEM,L 94-108,240,34,92,.370,22,53,.415,12,39,.308,14,21,.667,94,44,90,.489,33,56,.589,11,34,.324,9,11,.818,108
1184,CHI,2023-11-15,94,,ORL,L 94-96,240,33,83,.398,24,50,.480,9,33,.273,19,22,.864,94,32,82,.390,24,54,.444,8,28,.286,24,30,.800,96
1185,ORL,2024-03-27,93,,GSW,L 93-101,240,36,85,.424,26,53,.491,10,32,.313,11,21,.524,93,40,90,.444,30,56,.536,10,34,.294,11,13,.846,101
1186,LAC,2024-03-17,93,,ATL,L 93-110,240,28,74,.378,17,38,.447,11,36,.306,26,29,.897,93,41,84,.488,24,50,.480,17,34,.500,11,12,.917,110
1187,POR,2024-03-14,93,,NYK,L 93-105,240,34,84,.405,23,51,.451,11,33,.333,14,16,.875,93,38,87,.437,32,58,.552,6,29,.207,23,26,.885,105
1188,DEN,2023-12-29,93,,OKC,L 93-119,240,36,85,.424,26,48,.542,10,37,.270,11,15,.733,93,46,91,.505,34,56,.607,12,35,.343,15,16,.938,119
1189,HOU,2023-12-11,93,,SAS,W 93-82,240,32,93,.344,20,54,.370,12,39,.308,17,20,.850,93,31,87,.356,26,46,.565,5,41,.122,15,22,.682,82
1190,POR,2024-04-11,92,,GSW,L 92-100,240,35,97,.361,27,63,.429,8,34,.235,14,17,.824,92,36,77,.468,24,42,.571,12,35,.343,16,20,.800,100
1191,MIA,2024-04-10,92,,DAL,L 92-111,240,33,81,.407,20,51,.392,13,30,.433,13,13,1.000,92,43,87,.494,28,43,.651,15,44,.341,10,13,.769,111
1192,PHO,2024-04-09,92,,LAC,L 92-105,240,30,89,.337,22,54,.407,8,35,.229,24,28,.857,92,41,87,.471,29,61,.475,12,26,.462,11,11,1.000,105
1193,NOP,2024-03-30,92,,BOS,L 92-104,240,34,86,.395,21,51,.412,13,35,.371,11,18,.611,92,39,82,.476,24,45,.533,15,37,.405,11,12,.917,104
1194,MIA,2024-03-26,92,,GSW,L 92-113,240,37,92,.402,29,59,.492,8,33,.242,10,13,.769,92,47,85,.553,34,47,.723,13,38,.342,6,10,.600,113
1195,CHI,2024-03-11,92,,DAL,L 92-127,240,35,89,.393,28,55,.509,7,34,.206,15,22,.682,92,51,93,.548,38,52,.731,13,41,.317,12,15,.800,127
1196,MEM,2024-03-08,92,,ATL,L 92-99,240,30,74,.405,20,48,.417,10,26,.385,22,30,.733,92,37,87,.425,22,52,.423,15,35,.429,10,15,.667,99
1197,MEM,2024-03-01,92,,POR,L 92-122,240,35,79,.443,26,55,.473,9,24,.375,13,22,.591,92,48,92,.522,35,61,.574,13,31,.419,13,16,.813,122
1198,NYK,2024-02-27,92,,NOP,L 92-115,240,31,83,.373,17,37,.459,14,46,.304,16,23,.696,92,39,77,.506,21,43,.488,18,34,.529,19,23,.826,115
1199,CHO,2024-01-29,92,,NYK,L 92-113,240,37,81,.457,26,49,.531,11,32,.344,7,14,.500,92,44,84,.524,32,47,.681,12,37,.324,13,16,.813,113
1200,ORL,2024-01-09,92,,MIN,L 92-113,240,34,94,.362,21,52,.404,13,42,.310,11,18,.611,92,43,80,.538,31,50,.620,12,30,.400,15,19,.789,113
1201,PHI,2024-01-05,92,,NYK,L 92-128,240,33,81,.407,27,58,.466,6,23,.261,20,27,.741,92,43,89,.483,25,48,.521,18,41,.439,24,25,.960,128
1202,MEM,2023-12-31,92,,SAC,L 92-123,240,30,82,.366,18,42,.429,12,40,.300,20,28,.714,92,47,92,.511,31,59,.525,16,33,.485,13,17,.765,123
1203,ORL,2023-12-27,92,,PHI,L 92-112,240,31,79,.392,22,46,.478,9,33,.273,21,24,.875,92,45,96,.469,35,68,.515,10,28,.357,12,17,.706,112
1204,BRK,2024-03-19,91,,NOP,L 91-104,240,31,84,.369,19,44,.432,12,40,.300,17,22,.773,91,42,83,.506,32,49,.653,10,34,.294,10,13,.769,104
1205,SAC,2024-03-16,91,,NYK,L 91-98,240,30,85,.353,20,48,.417,10,37,.270,21,26,.808,91,37,86,.430,26,47,.553,11,39,.282,13,16,.813,98
1206,POR,2024-02-15,91,,MIN,L 91-128,240,31,83,.373,23,54,.426,8,29,.276,21,30,.700,91,46,89,.517,35,59,.593,11,30,.367,25,27,.926,128
1207,POR,2023-11-19,91,,OKC,L 91-134,240,34,85,.400,25,51,.490,9,34,.265,14,21,.667,91,49,81,.605,27,45,.600,22,36,.611,14,14,1.000,134
1208,CLE,2023-10-31,91,,NYK,L 91-109,240,36,92,.391,26,54,.481,10,38,.263,9,12,.750,91,38,86,.442,25,52,.481,13,34,.382,20,25,.800,109
1209,TOR,2023-10-30,91,,POR,L 91-99,240,38,94,.404,34,65,.523,4,29,.138,11,15,.733,91,38,85,.447,27,50,.540,11,35,.314,12,15,.800,99
1210,DAL,2024-04-12,89,,DET,L 89-107,240,36,83,.434,28,54,.519,8,29,.276,9,12,.750,89,46,95,.484,38,64,.594,8,31,.258,7,9,.778,107
1211,TOR,2024-03-20,89,,SAC,L 89-123,240,33,80,.413,23,49,.469,10,31,.323,13,18,.722,89,48,93,.516,36,53,.679,12,40,.300,15,18,.833,123
1212,CHO,2024-03-05,89,,ORL,L 89-101,240,33,72,.458,21,39,.538,12,33,.364,11,11,1.000,89,40,74,.541,27,39,.692,13,35,.371,8,15,.533,101
1213,CHO,2024-01-20,89,,PHI,L 89-97,240,35,85,.412,26,48,.542,9,37,.243,10,14,.714,89,36,85,.424,31,60,.517,5,25,.200,20,24,.833,97
1214,MEM,2023-11-24,89,,PHO,L 89-110,240,37,80,.463,28,47,.596,9,33,.273,6,10,.600,89,39,76,.513,28,45,.622,11,31,.355,21,28,.750,110
1215,NYK,2023-11-01,89,,CLE,L 89-95,240,32,92,.348,27,62,.435,5,30,.167,20,30,.667,89,32,74,.432,20,42,.476,12,32,.375,19,20,.950,95
1216,TOR,2024-03-25,88,,BRK,L 88-96,240,37,85,.435,32,58,.552,5,27,.185,9,12,.750,88,37,81,.457,28,42,.667,9,39,.231,13,18,.722,96
1217,MIA,2024-03-22,88,,NOP,L 88-111,240,31,86,.360,18,39,.462,13,47,.277,13,15,.867,88,42,82,.512,24,46,.522,18,36,.500,9,12,.750,111
1218,MIA,2024-03-13,88,,DEN,L 88-100,240,34,80,.425,29,59,.492,5,21,.238,15,18,.833,88,40,82,.488,29,49,.592,11,33,.333,9,13,.692,100
1219,MIN,2024-03-03,88,,LAC,L 88-89,240,31,80,.388,22,47,.468,9,33,.273,17,18,.944,88,32,85,.376,22,51,.431,10,34,.294,15,17,.882,89
1220,MEM,2024-04-09,87,,SAS,L 87-102,240,36,104,.346,30,74,.405,6,30,.200,9,11,.818,87,42,87,.483,32,47,.681,10,40,.250,8,8,1.000,102
1221,WAS,2024-03-29,87,,DET,L 87-96,240,36,88,.409,27,55,.491,9,33,.273,6,8,.750,87,37,89,.416,31,65,.477,6,24,.250,16,20,.800,96
1222,MEM,2024-02-12,87,,NOP,L 87-96,240,34,81,.420,22,37,.595,12,44,.273,7,8,.875,87,32,78,.410,19,43,.442,13,35,.371,19,24,.792,96
1223,CHO,2024-04-03,86,,POR,L 86-89,240,32,78,.410,27,47,.574,5,31,.161,17,22,.773,86,37,93,.398,30,67,.448,7,26,.269,8,12,.667,89
1224,MEM,2024-02-26,86,,BRK,L 86-111,240,29,75,.387,22,49,.449,7,26,.269,21,26,.808,86,44,90,.489,29,48,.604,15,42,.357,8,14,.571,111
1225,POR,2024-02-10,84,,NOP,L 84-93,240,33,76,.434,27,55,.491,6,21,.286,12,17,.706,84,36,76,.474,26,49,.531,10,27,.370,11,16,.688,93
1226,NOP,2024-01-26,83,,OKC,L 83-107,240,32,82,.390,23,46,.500,9,36,.250,10,14,.714,83,42,88,.477,32,55,.582,10,33,.303,13,14,.929,107
1227,CHO,2023-12-16,82,,PHI,L 82-135,240,33,91,.363,26,56,.464,7,35,.200,9,11,.818,82,53,88,.602,39,57,.684,14,31,.452,15,17,.882,135
1228,POR,2024-02-25,80,,CHO,L 80-93,240,33,95,.347,30,63,.476,3,32,.094,11,16,.688,80,37,75,.493,30,51,.588,7,24,.292,12,17,.706,93
1229,BRK,2024-04-07,77,,SAC,L 77-107,240,30,86,.349,23,56,.411,7,30,.233,10,13,.769,77,40,94,.426,25,46,.543,15,48,.313,12,16,.750,107
1230,NYK,2024-03-10,73,,PHI,L 73-79,240,26,80,.325,17,40,.425,9,40,.225,12,16,.750,73,31,80,.388,22,50,.440,9,30,.300,8,14,.571,79