Rk,Team,Date,PTS,,Opp,Result,MP,FG,FGA,FG%,2P,2PA,2P%,3P,3PA,3P%,FT,FTA,FT%,PTS,FG,FGA,FG%,2P,2PA,2P%,3P,3PA,3P%,FT,FTA,FT%,PTS
1,ATL,2019-03-01,161,,CHI,L 161-168 (4OT),340,61,123,.496,39,63,.619,22,60,.367,17,25,.680,161,56,119,.471,35,71,.493,21,48,.438,35,48,.729,168
2,SAS,2019-01-10,154,,OKC,W 154-147 (2OT),290,56,99,.566,40,80,.500,16,19,.842,26,29,.897,154,58,114,.509,43,79,.544,15,35,.429,16,24,.667,147
3,HOU,2019-04-07,149,,PHO,W 149-113,240,53,100,.530,26,43,.605,27,57,.474,16,21,.762,149,43,93,.462,32,59,.542,11,34,.324,16,21,.762,113
4,ORL,2019-04-05,149,,ATL,W 149-113,240,56,92,.609,38,55,.691,18,37,.486,19,25,.760,149,41,94,.436,31,55,.564,10,39,.256,21,31,.677,113
5,PHI,2019-01-15,149,,MIN,W 149-107,240,55,92,.598,34,49,.694,21,43,.488,18,21,.857,149,35,90,.389,27,67,.403,8,23,.348,29,35,.829,107
6,WAS,2018-12-22,149,,PHO,W 149-146 (3OT),315,56,111,.505,43,75,.573,13,36,.361,24,27,.889,149,55,115,.478,44,80,.550,11,35,.314,25,33,.758,146
7,NOP,2018-10-19,149,,SAC,W 149-129,240,56,95,.589,40,64,.625,16,31,.516,21,33,.636,149,50,96,.521,40,71,.563,10,25,.400,19,26,.731,129
8,POR,2019-03-25,148,,BRK,W 148-144 (2OT),290,53,121,.438,39,76,.513,14,45,.311,28,36,.778,148,49,103,.476,34,61,.557,15,42,.357,31,44,.705,144
9,OKC,2019-02-22,148,,UTA,W 148-147 (2OT),290,55,118,.466,37,74,.500,18,44,.409,20,25,.800,148,52,105,.495,34,65,.523,18,40,.450,25,31,.806,147
10,MIL,2019-02-06,148,,WAS,W 148-129,240,56,93,.602,37,63,.587,19,30,.633,17,26,.654,148,48,92,.522,31,55,.564,17,37,.459,16,19,.842,129
11,GSW,2019-01-16,147,,NOP,W 147-140,240,49,102,.480,25,53,.472,24,49,.490,25,31,.806,147,47,98,.480,28,61,.459,19,37,.514,27,33,.818,140
12,GSW,2019-01-11,146,,CHI,W 146-109,240,53,92,.576,35,53,.660,18,39,.462,22,26,.846,146,35,78,.449,26,58,.448,9,20,.450,30,34,.882,109
13,MIL,2019-01-04,144,,ATL,W 144-112,240,55,100,.550,41,60,.683,14,40,.350,20,28,.714,144,37,85,.435,23,44,.523,14,41,.341,24,35,.686,112
14,BRK,2018-12-16,144,,ATL,W 144-127,240,49,88,.557,33,48,.688,16,40,.400,30,33,.909,144,47,85,.553,33,56,.589,14,29,.483,19,25,.760,127
15,MIL,2018-11-04,144,,SAC,W 144-109,240,46,95,.484,24,39,.615,22,56,.393,30,33,.909,144,42,95,.442,28,59,.475,14,36,.389,11,22,.500,109
16,GSW,2018-10-24,144,,WAS,W 144-122,240,53,92,.576,38,59,.644,15,33,.455,23,25,.920,144,42,93,.452,30,51,.588,12,42,.286,26,28,.929,122
17,LAC,2019-04-10,143,,UTA,W 143-137 (OT),265,54,106,.509,42,78,.538,12,28,.429,23,30,.767,143,47,106,.443,33,71,.465,14,35,.400,29,33,.879,137
18,PHI,2019-02-10,143,,LAL,W 143-120,240,56,97,.577,44,73,.603,12,24,.500,19,22,.864,143,48,93,.516,38,66,.576,10,27,.370,14,19,.737,120
19,MIL,2018-11-21,143,,POR,W 143-100,240,57,108,.528,42,63,.667,15,45,.333,14,17,.824,143,34,93,.366,25,52,.481,9,41,.220,23,28,.821,100
20,HOU,2019-01-16,142,,BRK,L 142-145 (OT),265,45,105,.429,22,35,.629,23,70,.329,29,34,.853,142,56,108,.519,40,72,.556,16,36,.444,17,22,.773,145
21,ATL,2019-01-15,142,,OKC,W 142-126,240,56,90,.622,38,53,.717,18,37,.486,12,16,.750,142,43,94,.457,34,62,.548,9,32,.281,31,41,.756,126
22,LAL,2018-10-22,142,,SAS,L 142-143 (OT),265,55,107,.514,41,68,.603,14,39,.359,18,26,.692,142,50,97,.515,35,69,.507,15,28,.536,28,38,.737,143
23,GSW,2019-02-06,141,,SAS,W 141-102,240,55,95,.579,39,61,.639,16,34,.471,15,21,.714,141,35,81,.432,23,49,.469,12,32,.375,20,21,.952,102
24,HOU,2019-01-11,141,,CLE,W 141-113,240,46,89,.517,26,37,.703,20,52,.385,29,32,.906,141,40,89,.449,31,56,.554,9,33,.273,24,26,.923,113
25,SAC,2018-12-12,141,,MIN,W 141-130,240,50,86,.581,31,48,.646,19,38,.500,22,32,.688,141,50,93,.538,41,71,.577,9,22,.409,21,27,.778,130
26,LAC,2019-03-11,140,,BOS,W 140-115,240,53,86,.616,40,58,.690,13,28,.464,21,25,.840,140,44,91,.484,30,55,.545,14,36,.389,13,19,.684,115
27,SAC,2019-02-27,140,,MIL,L 140-141 (OT),265,53,118,.449,41,85,.482,12,33,.364,22,30,.733,140,54,112,.482,37,67,.552,17,45,.378,16,21,.762,141
28,MIL,2019-02-23,140,,MIN,W 140-128,240,50,95,.526,31,52,.596,19,43,.442,21,22,.955,140,50,102,.490,38,76,.500,12,26,.462,16,20,.800,128
29,NOP,2019-01-09,140,,CLE,W 140-124,240,46,84,.548,34,55,.618,12,29,.414,36,39,.923,140,42,88,.477,28,58,.483,14,30,.467,26,30,.867,124
30,NOP,2018-11-19,140,,SAS,W 140-126,240,59,102,.578,49,76,.645,10,26,.385,12,14,.857,140,45,94,.479,33,70,.471,12,24,.500,24,30,.800,126
31,DAL,2018-10-20,140,,MIN,W 140-136,240,49,98,.500,32,48,.667,17,50,.340,25,34,.735,140,44,84,.524,30,57,.526,14,27,.519,34,40,.850,136
32,CLE,2019-02-13,139,,BRK,L 139-148 (3OT),315,54,120,.450,36,78,.462,18,42,.429,13,18,.722,139,52,113,.460,34,68,.500,18,45,.400,26,34,.765,148
33,UTA,2018-12-04,139,,SAS,W 139-105,240,51,84,.607,31,51,.608,20,33,.606,17,20,.850,139,44,90,.489,37,68,.544,7,22,.318,10,11,.909,105
34,HOU,2019-01-19,138,,LAL,W 138-134 (OT),265,42,100,.420,17,32,.531,25,68,.368,29,36,.806,138,50,96,.521,40,59,.678,10,37,.270,24,30,.800,134
35,WAS,2019-01-13,138,,TOR,L 138-140 (2OT),290,54,118,.458,35,74,.473,19,44,.432,11,18,.611,138,49,104,.471,36,68,.529,13,36,.361,29,36,.806,140
36,DEN,2018-11-15,138,,ATL,W 138-93,240,53,94,.564,40,63,.635,13,31,.419,19,25,.760,138,32,92,.348,23,50,.460,9,42,.214,20,27,.741,93
37,GSW,2019-03-31,137,,CHO,W 137-90,240,53,88,.602,32,55,.582,21,33,.636,10,12,.833,137,30,85,.353,22,53,.415,8,32,.250,22,25,.880,90
38,POR,2019-04-10,136,,SAC,W 136-131,240,53,91,.582,39,67,.582,14,24,.583,16,22,.727,136,50,96,.521,32,53,.604,18,43,.419,13,16,.813,131
39,ATL,2019-03-31,136,,MIL,W 136-135 (OT),265,52,118,.441,30,57,.526,22,61,.361,10,17,.588,136,48,116,.414,31,61,.508,17,55,.309,22,23,.957,135
40,NOP,2019-03-16,136,,PHO,L 136-138 (OT),265,47,102,.461,32,72,.444,15,30,.500,27,41,.659,136,51,100,.510,42,71,.592,9,29,.310,27,36,.750,138
41,IND,2019-02-05,136,,LAL,W 136-94,240,56,98,.571,37,64,.578,19,34,.559,5,8,.625,136,35,75,.467,31,54,.574,4,21,.190,20,26,.769,94
42,DEN,2019-02-01,136,,HOU,W 136-122,240,51,82,.622,37,51,.725,14,31,.452,20,23,.870,136,45,85,.529,29,41,.707,16,44,.364,16,21,.762,122
43,HOU,2018-12-19,136,,WAS,W 136-118,240,47,85,.553,21,30,.700,26,55,.473,16,21,.762,136,45,84,.536,35,54,.648,10,30,.333,18,23,.783,118
44,NYK,2018-12-01,136,,MIL,W 136-134 (OT),265,51,96,.531,31,62,.500,20,34,.588,14,21,.667,136,46,94,.489,28,52,.538,18,42,.429,24,31,.774,134
45,CLE,2018-10-30,136,,ATL,W 136-114,240,45,90,.500,32,65,.492,13,25,.520,33,43,.767,136,44,82,.537,29,47,.617,15,35,.429,11,17,.647,114
46,LAC,2018-10-28,136,,WAS,W 136-104,240,56,103,.544,40,74,.541,16,29,.552,8,13,.615,136,38,97,.392,33,70,.471,5,27,.185,23,28,.821,104
47,WAS,2019-03-16,135,,MEM,W 135-128,240,41,81,.506,24,46,.522,17,35,.486,36,43,.837,135,48,90,.533,36,57,.632,12,33,.364,20,26,.769,128
48,MIN,2019-03-09,135,,WAS,W 135-130 (OT),265,51,114,.447,39,78,.500,12,36,.333,21,24,.875,135,48,100,.480,32,56,.571,16,44,.364,18,24,.750,130
49,WAS,2019-03-03,135,,MIN,W 135-121,240,49,98,.500,38,65,.585,11,33,.333,26,32,.813,135,52,99,.525,48,72,.667,4,27,.148,13,19,.684,121
50,BRK,2019-02-06,135,,DEN,W 135-130,240,46,90,.511,27,56,.482,19,34,.559,24,33,.727,135,50,99,.505,37,64,.578,13,35,.371,17,21,.810,130
51,SAC,2019-01-30,135,,ATL,W 135-113,240,54,99,.545,43,64,.672,11,35,.314,16,21,.762,135,38,86,.442,22,40,.550,16,46,.348,21,25,.840,113
52,CHO,2019-01-19,135,,PHO,W 135-115,240,48,88,.545,32,54,.593,16,34,.471,23,27,.852,135,39,87,.448,28,54,.519,11,33,.333,26,33,.788,115
53,DEN,2019-01-17,135,,CHI,W 135-105,240,50,96,.521,30,56,.536,20,40,.500,15,20,.750,135,44,93,.473,34,65,.523,10,28,.357,7,11,.636,105
54,BOS,2019-01-09,135,,IND,W 135-108,240,50,88,.568,36,56,.643,14,32,.438,21,24,.875,135,39,91,.429,30,63,.476,9,28,.321,21,33,.636,108
55,WAS,2018-11-26,135,,HOU,W 135-131 (OT),265,50,89,.562,39,60,.650,11,29,.379,24,32,.750,135,46,97,.474,28,49,.571,18,48,.375,21,27,.778,131
56,MIL,2018-11-24,135,,SAS,W 135-129,240,49,86,.570,34,46,.739,15,40,.375,22,29,.759,135,49,92,.533,39,71,.549,10,21,.476,21,28,.750,129
57,CHO,2018-10-26,135,,CHI,W 135-106,240,53,93,.570,39,61,.639,14,32,.438,15,16,.938,135,37,85,.435,21,49,.429,16,36,.444,16,22,.727,106
58,ATL,2019-04-10,134,,IND,L 134-135,240,43,103,.417,26,62,.419,17,41,.415,31,38,.816,134,45,98,.459,33,68,.485,12,30,.400,33,39,.846,135
59,LAC,2019-02-13,134,,PHO,W 134-107,240,50,84,.595,39,62,.629,11,22,.500,23,30,.767,134,40,86,.465,32,56,.571,8,30,.267,19,25,.760,107
60,BOS,2019-02-03,134,,OKC,W 134-129,240,54,91,.593,41,57,.719,13,34,.382,13,17,.765,134,45,92,.489,31,57,.544,14,35,.400,25,34,.735,129
61,GSW,2019-01-03,134,,HOU,L 134-135 (OT),265,53,102,.520,39,65,.600,14,37,.378,14,15,.933,134,45,99,.455,24,45,.533,21,54,.389,24,28,.857,135
62,BRK,2018-12-26,134,,CHO,W 134-132 (2OT),290,51,104,.490,32,57,.561,19,47,.404,13,18,.722,134,47,106,.443,32,75,.427,15,31,.484,23,30,.767,132
63,PHO,2019-04-05,133,,NOP,W 133-126 (OT),265,51,104,.490,37,68,.544,14,36,.389,17,21,.810,133,49,101,.485,41,78,.526,8,23,.348,20,27,.741,126
64,DEN,2019-03-12,133,,MIN,W 133-107,240,51,85,.600,33,55,.600,18,30,.600,13,15,.867,133,41,89,.461,30,59,.508,11,30,.367,14,14,1.000,107
65,SAS,2018-12-07,133,,LAL,W 133-120,240,46,91,.505,33,60,.550,13,31,.419,28,33,.848,133,46,100,.460,35,64,.547,11,36,.306,17,21,.810,120
66,PHI,2018-11-09,133,,CHO,W 133-132 (OT),265,45,94,.479,33,57,.579,12,37,.324,31,41,.756,133,43,110,.391,27,70,.386,16,40,.400,30,40,.750,132
67,DET,2018-10-23,133,,PHI,W 133-132 (OT),265,51,108,.472,39,75,.520,12,33,.364,19,27,.704,133,49,98,.500,35,55,.636,14,43,.326,20,28,.714,132
68,MEM,2019-04-10,132,,GSW,W 132-117,240,48,98,.490,27,52,.519,21,46,.457,15,18,.833,132,46,92,.500,33,62,.532,13,30,.433,12,14,.857,117
69,LAC,2019-03-30,132,,CLE,W 132-108,240,53,85,.624,38,52,.731,15,33,.455,11,16,.688,132,41,92,.446,38,69,.551,3,23,.130,23,28,.821,108
70,ATL,2019-03-13,132,,MEM,W 132-111,240,52,103,.505,35,58,.603,17,45,.378,11,14,.786,132,38,89,.427,24,49,.490,14,40,.350,21,26,.808,111
71,WAS,2019-03-06,132,,DAL,W 132-123,240,50,93,.538,38,60,.633,12,33,.364,20,25,.800,132,45,93,.484,30,52,.577,15,41,.366,18,28,.643,123
72,OKC,2019-02-05,132,,ORL,W 132-122,240,46,92,.500,33,62,.532,13,30,.433,27,37,.730,132,42,90,.467,31,53,.585,11,37,.297,27,34,.794,122
73,POR,2019-01-30,132,,UTA,W 132-105,240,48,90,.533,32,58,.552,16,32,.500,20,23,.870,132,38,85,.447,27,51,.529,11,34,.324,18,21,.857,105
74,SAS,2019-01-27,132,,WAS,W 132-119,240,49,86,.570,33,52,.635,16,34,.471,18,21,.857,132,40,89,.449,22,43,.512,18,46,.391,21,29,.724,119
75,DEN,2019-01-25,132,,PHO,W 132-95,240,47,94,.500,32,58,.552,15,36,.417,23,29,.793,132,32,76,.421,25,46,.543,7,30,.233,24,26,.923,95
76,PHI,2019-01-08,132,,WAS,W 132-115,240,49,88,.557,32,55,.582,17,33,.515,17,25,.680,132,42,84,.500,28,52,.538,14,32,.438,17,21,.810,115
77,LAC,2018-12-22,132,,DEN,W 132-111,240,53,92,.576,43,72,.597,10,20,.500,16,17,.941,132,41,97,.423,32,66,.485,9,31,.290,20,25,.800,111
78,MIN,2018-12-17,132,,SAC,W 132-105,240,48,96,.500,38,69,.551,10,27,.370,26,30,.867,132,38,90,.422,24,52,.462,14,38,.368,15,23,.652,105
79,NOP,2018-12-05,132,,DAL,W 132-106,240,51,92,.554,34,63,.540,17,29,.586,13,20,.650,132,39,91,.429,25,45,.556,14,46,.304,14,21,.667,106
80,HOU,2018-11-17,132,,SAC,W 132-112,240,46,81,.568,26,34,.765,20,47,.426,20,24,.833,132,46,102,.451,35,67,.522,11,35,.314,9,12,.750,112
81,POR,2018-11-01,132,,NOP,W 132-119,240,44,87,.506,26,52,.500,18,35,.514,26,31,.839,132,40,94,.426,32,65,.492,8,29,.276,31,37,.838,119
82,IND,2018-10-20,132,,BRK,W 132-112,240,51,92,.554,35,68,.515,16,24,.667,14,22,.636,132,41,86,.477,25,49,.510,16,37,.432,14,22,.636,112
83,GSW,2019-04-07,131,,LAC,W 131-104,240,53,97,.546,41,60,.683,12,37,.324,13,15,.867,131,38,79,.481,28,60,.467,10,19,.526,18,29,.621,104
84,MIN,2019-03-29,131,,GSW,W 131-130 (OT),265,45,103,.437,31,65,.477,14,38,.368,27,34,.794,131,46,98,.469,28,58,.483,18,40,.450,20,28,.714,130
85,DET,2019-03-10,131,,CHI,W 131-108,240,49,91,.538,30,56,.536,19,35,.543,14,22,.636,131,41,82,.500,32,64,.500,9,18,.500,17,26,.654,108
86,MIL,2019-03-09,131,,CHO,W 131-114,240,44,90,.489,27,46,.587,17,44,.386,26,30,.867,131,44,93,.473,29,54,.537,15,39,.385,11,14,.786,114
87,DET,2019-03-06,131,,MIN,W 131-114,240,50,93,.538,36,60,.600,14,33,.424,17,22,.773,131,41,84,.488,29,57,.509,12,27,.444,20,21,.952,114
88,MIN,2019-03-05,131,,OKC,W 131-120,240,47,89,.528,36,67,.537,11,22,.500,26,35,.743,131,42,94,.447,24,48,.500,18,46,.391,18,31,.581,120
89,ATL,2019-02-27,131,,MIN,W 131-123 (OT),265,46,108,.426,34,79,.430,12,29,.414,27,32,.844,131,44,102,.431,32,64,.500,12,38,.316,23,33,.697,123
90,NOP,2019-02-14,131,,OKC,W 131-122,240,50,92,.543,38,66,.576,12,26,.462,19,24,.792,131,50,106,.472,40,62,.645,10,44,.227,12,13,.923,122
91,IND,2019-01-15,131,,PHO,W 131-97,240,46,89,.517,34,64,.531,12,25,.480,27,36,.750,131,40,95,.421,32,68,.471,8,27,.296,9,18,.500,97
92,PHI,2018-12-19,131,,NYK,W 131-109,240,47,88,.534,32,58,.552,15,30,.500,22,25,.880,131,37,86,.430,27,55,.491,10,31,.323,25,31,.806,109
93,SAS,2018-12-02,131,,POR,W 131-118,240,50,83,.602,39,68,.574,11,15,.733,20,22,.909,131,45,86,.523,33,57,.579,12,29,.414,16,16,1.000,118
94,TOR,2018-11-29,131,,GSW,W 131-128 (OT),265,47,90,.522,32,52,.615,15,38,.395,22,24,.917,131,50,103,.485,39,73,.534,11,30,.367,17,20,.850,128
95,ORL,2018-11-18,131,,NYK,W 131-117,240,48,84,.571,35,52,.673,13,32,.406,22,26,.846,131,40,87,.460,32,63,.508,8,24,.333,29,35,.829,117
96,GSW,2018-10-31,131,,NOP,W 131-121,240,47,89,.528,31,57,.544,16,32,.500,21,30,.700,131,44,92,.478,32,57,.561,12,35,.343,21,27,.778,121
97,MEM,2018-10-19,131,,ATL,W 131-117,240,44,81,.543,31,55,.564,13,26,.500,30,43,.698,131,41,83,.494,27,53,.509,14,30,.467,21,36,.583,117
98,MIN,2018-10-19,131,,CLE,W 131-123,240,44,87,.506,34,62,.548,10,25,.400,33,35,.943,131,45,93,.484,37,70,.529,8,23,.348,25,29,.862,123
99,ATL,2019-04-03,130,,PHI,W 130-122,240,48,92,.522,36,56,.643,12,36,.333,22,28,.786,130,45,98,.459,35,67,.522,10,31,.323,22,38,.579,122
100,NYK,2019-02-24,130,,SAS,W 130-118,240,50,98,.510,34,61,.557,16,37,.432,14,19,.737,130,42,94,.447,36,70,.514,6,24,.250,28,31,.903,118
101,MIN,2019-02-11,130,,LAC,W 130-120,240,47,90,.522,41,72,.569,6,18,.333,30,36,.833,130,37,72,.514,25,43,.581,12,29,.414,34,39,.872,120
102,WAS,2018-12-29,130,,CHO,W 130-126,240,48,93,.516,35,56,.625,13,37,.351,21,24,.875,130,47,90,.522,34,59,.576,13,31,.419,19,24,.792,126
103,ORL,2018-11-17,130,,LAL,W 130-117,240,50,93,.538,39,61,.639,11,32,.344,19,23,.826,130,43,90,.478,33,60,.550,10,30,.333,21,25,.840,117
104,SAC,2019-04-07,129,,NOP,L 129-133,240,50,109,.459,34,69,.493,16,40,.400,13,17,.765,129,52,101,.515,33,59,.559,19,42,.452,10,12,.833,133
105,LAL,2019-03-29,129,,CHO,W 129-115,240,51,91,.560,33,53,.623,18,38,.474,9,12,.750,129,42,88,.477,27,49,.551,15,39,.385,16,17,.941,115
106,ATL,2019-03-23,129,,PHI,W 129-127,240,49,106,.462,34,59,.576,15,47,.319,16,21,.762,129,42,91,.462,32,68,.471,10,23,.435,33,39,.846,127
107,SAC,2019-03-17,129,,CHI,W 129-102,240,54,103,.524,46,80,.575,8,23,.348,13,16,.813,129,39,88,.443,29,62,.468,10,26,.385,14,21,.667,102
108,BOS,2019-03-16,129,,ATL,W 129-120,240,44,93,.473,31,57,.544,13,36,.361,28,37,.757,129,43,100,.430,28,60,.467,15,40,.375,19,24,.792,120
109,TOR,2019-02-13,129,,WAS,W 129-120,240,44,92,.478,28,54,.519,16,38,.421,25,30,.833,129,37,84,.440,23,44,.523,14,40,.350,32,39,.821,120
110,POR,2019-02-13,129,,GSW,W 129-107,240,43,93,.462,27,56,.482,16,37,.432,27,34,.794,129,39,97,.402,26,59,.441,13,38,.342,16,18,.889,107
111,DET,2019-02-04,129,,DEN,W 129-103,240,48,88,.545,32,51,.627,16,37,.432,17,20,.850,129,41,92,.446,32,64,.500,9,28,.321,12,22,.545,103
112,WAS,2019-02-04,129,,ATL,L 129-137,240,48,97,.495,36,59,.610,12,38,.316,21,29,.724,129,46,91,.505,26,51,.510,20,40,.500,25,29,.862,137
113,POR,2019-01-16,129,,CLE,W 129-112,240,47,89,.528,31,60,.517,16,29,.552,19,23,.826,129,45,95,.474,39,76,.513,6,19,.316,16,19,.842,112
114,POR,2018-12-30,129,,PHI,W 129-95,240,49,83,.590,37,61,.607,12,22,.545,19,25,.760,129,34,96,.354,26,53,.491,8,43,.186,19,27,.704,95
115,MIL,2018-12-29,129,,BRK,W 129-115,240,47,96,.490,26,45,.578,21,51,.412,14,16,.875,129,38,79,.481,23,44,.523,15,35,.429,24,35,.686,115
116,UTA,2018-12-29,129,,NYK,W 129-97,240,51,93,.548,35,57,.614,16,36,.444,11,14,.786,129,32,86,.372,17,54,.315,15,32,.469,18,22,.818,97
117,GSW,2018-12-23,129,,LAC,W 129-127,240,42,93,.452,28,53,.528,14,40,.350,31,36,.861,129,43,80,.538,25,57,.439,18,23,.783,23,29,.793,127
118,BOS,2018-12-14,129,,ATL,W 129-108,240,46,95,.484,27,56,.482,19,39,.487,18,20,.900,129,36,86,.419,20,48,.417,16,38,.421,20,32,.625,108
119,NOP,2018-11-16,129,,NYK,W 129-124,240,48,99,.485,38,65,.585,10,34,.294,23,32,.719,129,48,98,.490,37,64,.578,11,34,.324,17,24,.708,124
120,TOR,2018-10-30,129,,PHI,W 129-112,240,47,92,.511,36,65,.554,11,27,.407,24,28,.857,129,38,91,.418,24,51,.471,14,40,.350,22,30,.733,112
121,MIL,2019-04-06,128,,BRK,L 128-133,240,49,88,.557,33,54,.611,16,34,.471,14,21,.667,128,48,97,.495,29,52,.558,19,45,.422,18,23,.783,133
122,UTA,2019-03-29,128,,WAS,W 128-124,240,48,87,.552,34,55,.618,14,32,.438,18,18,1.000,128,48,98,.490,33,61,.541,15,37,.405,13,22,.591,124
123,MIL,2019-03-28,128,,LAC,W 128-118,240,45,86,.523,29,49,.592,16,37,.432,22,27,.815,128,42,92,.457,25,59,.424,17,33,.515,17,22,.773,118
124,TOR,2019-03-18,128,,NYK,W 128-92,240,49,88,.557,32,48,.667,17,40,.425,13,22,.591,128,28,85,.329,20,50,.400,8,35,.229,28,32,.875,92
125,LAC,2019-03-15,128,,CHI,W 128-121,240,44,99,.444,34,79,.430,10,20,.500,30,35,.857,128,42,80,.525,31,59,.525,11,21,.524,26,33,.788,121
126,ATL,2019-03-10,128,,NOP,W 128-116,240,48,98,.490,31,61,.508,17,37,.459,15,18,.833,128,45,101,.446,27,60,.450,18,41,.439,8,8,1.000,116
127,LAC,2019-03-03,128,,NYK,W 128-107,240,48,98,.490,29,63,.460,19,35,.543,13,17,.765,128,35,88,.398,24,59,.407,11,29,.379,26,34,.765,107
128,NOP,2019-02-23,128,,LAL,W 128-115,240,50,96,.521,35,56,.625,15,40,.375,13,16,.813,128,44,81,.543,34,52,.654,10,29,.345,17,26,.654,115
129,BOS,2019-02-07,128,,LAL,L 128-129,240,46,94,.489,30,56,.536,16,38,.421,20,20,1.000,128,50,97,.515,28,56,.500,22,41,.537,7,18,.389,129
130,UTA,2019-02-01,128,,ATL,W 128-112,240,46,87,.529,34,52,.654,12,35,.343,24,30,.800,128,39,98,.398,25,52,.481,14,46,.304,20,24,.833,112
131,POR,2019-01-18,128,,NOP,W 128-112,240,48,103,.466,37,69,.536,11,34,.324,21,26,.808,128,41,84,.488,33,59,.559,8,25,.320,22,27,.815,112
132,OKC,2019-01-17,128,,LAL,L 128-138 (OT),265,41,104,.394,19,50,.380,22,54,.407,24,36,.667,128,50,99,.505,31,59,.525,19,40,.475,19,21,.905,138
133,LAC,2019-01-08,128,,CHO,W 128-109,240,48,93,.516,34,63,.540,14,30,.467,18,21,.857,128,36,90,.400,24,57,.421,12,33,.364,25,29,.862,109
134,WAS,2018-12-16,128,,LAL,W 128-110,240,54,106,.509,41,75,.547,13,31,.419,7,10,.700,128,44,91,.484,33,55,.600,11,36,.306,11,18,.611,110
135,POR,2018-12-14,128,,TOR,W 128-122,240,48,94,.511,35,67,.522,13,27,.481,19,21,.905,128,43,78,.551,25,47,.532,18,31,.581,18,21,.857,122
136,BOS,2018-12-06,128,,NYK,W 128-100,240,49,92,.533,36,54,.667,13,38,.342,17,20,.850,128,36,91,.396,24,56,.429,12,35,.343,16,20,.800,100
137,BOS,2018-11-30,128,,CLE,W 128-95,240,49,92,.533,32,61,.525,17,31,.548,13,16,.813,128,30,77,.390,23,55,.418,7,22,.318,28,35,.800,95
138,MIN,2018-11-28,128,,SAS,W 128-89,240,50,99,.505,32,58,.552,18,41,.439,10,15,.667,128,34,87,.391,26,60,.433,8,27,.296,13,13,1.000,89
139,OKC,2018-11-14,128,,NYK,W 128-103,240,51,95,.537,35,62,.565,16,33,.485,10,12,.833,128,39,88,.443,32,62,.516,7,26,.269,18,23,.783,103
140,TOR,2018-11-10,128,,NYK,W 128-112,240,42,79,.532,28,44,.636,14,35,.400,30,40,.750,128,44,96,.458,38,74,.514,6,22,.273,18,22,.818,112
141,LAC,2018-11-10,128,,MIL,W 128-126 (OT),265,46,99,.465,32,65,.492,14,34,.412,22,27,.815,128,47,105,.448,31,59,.525,16,46,.348,16,23,.696,126
142,MIN,2018-10-31,128,,UTA,W 128-125,240,50,86,.581,38,61,.623,12,25,.480,16,24,.667,128,47,97,.485,34,67,.507,13,30,.433,18,30,.600,125
143,OKC,2018-10-30,128,,LAC,W 128-110,240,48,94,.511,39,77,.506,9,17,.529,23,32,.719,128,35,74,.473,28,54,.519,7,20,.350,33,43,.767,110
144,POR,2018-10-18,128,,LAL,W 128-119,240,44,100,.440,31,63,.492,13,37,.351,27,29,.931,128,45,93,.484,38,63,.603,7,30,.233,22,29,.759,119
145,MEM,2019-04-07,127,,DAL,L 127-129 (OT),265,42,98,.429,23,54,.426,19,44,.432,24,28,.857,127,45,98,.459,33,57,.579,12,41,.293,27,34,.794,129
146,MIL,2019-03-24,127,,CLE,W 127-105,240,48,87,.552,33,46,.717,15,41,.366,16,21,.762,127,41,96,.427,30,55,.545,11,41,.268,12,17,.706,105
147,POR,2019-03-09,127,,PHO,W 127-120,240,43,86,.500,30,57,.526,13,29,.448,28,36,.778,127,43,103,.417,34,76,.447,9,27,.333,25,29,.862,120
148,BRK,2019-03-04,127,,DAL,W 127-88,240,48,85,.565,31,44,.705,17,41,.415,14,19,.737,127,31,87,.356,19,42,.452,12,45,.267,14,22,.636,88
149,ORL,2019-02-14,127,,CHO,W 127-89,240,48,92,.522,31,53,.585,17,39,.436,14,18,.778,127,33,94,.351,29,63,.460,4,31,.129,19,26,.731,89
150,TOR,2019-02-11,127,,BRK,W 127-125,240,50,92,.543,41,61,.672,9,31,.290,18,20,.900,127,46,88,.523,26,47,.553,20,41,.488,13,18,.722,125
151,POR,2019-02-07,127,,SAS,W 127-118,240,49,91,.538,38,60,.633,11,31,.355,18,18,1.000,127,48,91,.527,36,70,.514,12,21,.571,10,14,.714,118
152,SAC,2019-02-04,127,,SAS,W 127-112,240,50,90,.556,37,58,.638,13,32,.406,14,23,.609,127,42,98,.429,33,66,.500,9,32,.281,19,21,.905,112
153,POR,2019-01-11,127,,CHO,W 127-96,240,52,93,.559,37,53,.698,15,40,.375,8,9,.889,127,36,90,.400,23,60,.383,13,30,.433,11,16,.688,96
154,PHO,2019-01-02,127,,PHI,L 127-132,240,43,95,.453,32,61,.525,11,34,.324,30,36,.833,127,40,74,.541,29,50,.580,11,24,.458,41,54,.759,132
155,HOU,2018-12-27,127,,BOS,W 127-113,240,41,86,.477,23,41,.561,18,45,.400,27,35,.771,127,38,81,.469,26,50,.520,12,31,.387,25,31,.806,113
156,LAC,2018-12-26,127,,SAC,W 127-118,240,48,96,.500,36,68,.529,12,28,.429,19,23,.826,127,49,104,.471,39,74,.527,10,30,.333,10,15,.667,118
157,LAC,2018-12-17,127,,POR,L 127-131,240,42,83,.506,32,56,.571,10,27,.370,33,39,.846,127,47,86,.547,37,66,.561,10,20,.500,27,31,.871,131
158,CHO,2018-11-21,127,,IND,W 127-109,240,45,80,.563,27,51,.529,18,29,.621,19,22,.864,127,41,84,.488,30,51,.588,11,33,.333,16,17,.941,109
159,TOR,2018-10-22,127,,CHO,W 127-106,240,50,87,.575,35,48,.729,15,39,.385,12,14,.857,127,41,97,.423,32,69,.464,9,28,.321,15,18,.833,106
160,PHI,2018-10-18,127,,CHI,W 127-108,240,44,93,.473,32,57,.561,12,36,.333,27,30,.900,127,44,101,.436,33,68,.485,11,33,.333,9,12,.750,108
161,MIN,2019-04-07,126,,OKC,L 126-132,240,46,85,.541,36,62,.581,10,23,.435,24,29,.828,126,48,92,.522,34,58,.586,14,34,.412,22,26,.846,132
162,CHI,2019-03-20,126,,WAS,W 126-120 (OT),265,50,106,.472,38,83,.458,12,23,.522,14,17,.824,126,44,93,.473,30,51,.588,14,42,.333,18,23,.783,120
163,POR,2019-03-20,126,,DAL,W 126-118,240,45,91,.495,29,55,.527,16,36,.444,20,25,.800,126,43,87,.494,33,57,.579,10,30,.333,22,25,.880,118
164,MEM,2019-03-20,126,,HOU,W 126-125 (OT),265,41,89,.461,28,52,.538,13,37,.351,31,39,.795,126,42,94,.447,21,46,.457,21,48,.438,20,20,1.000,125
165,CLE,2019-03-18,126,,DET,W 126-119,240,46,79,.582,35,57,.614,11,22,.500,23,27,.852,126,42,94,.447,24,50,.480,18,44,.409,17,21,.810,119
166,BOS,2019-03-14,126,,SAC,W 126-120,240,49,97,.505,40,69,.580,9,28,.321,19,26,.731,126,48,95,.505,37,61,.607,11,34,.324,13,23,.565,120
167,CLE,2019-03-11,126,,TOR,W 126-101,240,44,94,.468,26,53,.491,18,41,.439,20,21,.952,126,40,84,.476,29,45,.644,11,39,.282,10,17,.588,101
168,MIA,2019-03-08,126,,CLE,W 126-110,240,45,79,.570,33,54,.611,12,25,.480,24,33,.727,126,39,81,.481,20,38,.526,19,43,.442,13,16,.813,110
169,MIA,2019-02-27,126,,GSW,W 126-125,240,42,83,.506,24,42,.571,18,41,.439,24,30,.800,126,44,89,.494,27,41,.659,17,48,.354,20,28,.714,125
170,CHI,2019-02-23,126,,BOS,W 126-116,240,47,88,.534,35,58,.603,12,30,.400,20,21,.952,126,45,92,.489,35,63,.556,10,29,.345,16,21,.762,116
171,IND,2019-02-22,126,,NOP,W 126-111,240,44,93,.473,30,61,.492,14,32,.438,24,35,.686,126,43,93,.462,35,66,.530,8,27,.296,17,30,.567,111
172,BOS,2019-01-30,126,,CHO,W 126-94,240,50,90,.556,38,61,.623,12,29,.414,14,16,.875,126,39,89,.438,26,49,.531,13,40,.325,3,7,.429,94
173,SAS,2019-01-29,126,,PHO,W 126-124,240,47,100,.470,32,66,.485,15,34,.441,17,20,.850,126,48,80,.600,35,51,.686,13,29,.448,15,19,.789,124
174,DEN,2019-01-26,126,,PHI,W 126-110,240,48,94,.511,40,70,.571,8,24,.333,22,29,.759,126,38,91,.418,24,55,.436,14,36,.389,20,27,.741,110
175,BRK,2019-01-02,126,,NOP,W 126-121,240,47,93,.505,31,62,.500,16,31,.516,16,21,.762,126,46,87,.529,36,64,.563,10,23,.435,19,27,.704,121
176,PHI,2018-12-22,126,,TOR,W 126-101,240,46,85,.541,38,61,.623,8,24,.333,26,35,.743,126,37,95,.389,27,55,.491,10,40,.250,17,19,.895,101
177,TOR,2018-12-21,126,,CLE,W 126-110,240,48,91,.527,39,60,.650,9,31,.290,21,26,.808,126,39,82,.476,30,58,.517,9,24,.375,23,30,.767,110
178,DEN,2018-12-18,126,,DAL,W 126-118,240,50,90,.556,38,61,.623,12,29,.414,14,18,.778,126,40,86,.465,25,49,.510,15,37,.405,23,30,.767,118
179,HOU,2018-12-13,126,,LAL,W 126-111,240,42,85,.494,27,51,.529,15,34,.441,27,32,.844,126,43,80,.538,33,48,.688,10,32,.313,15,27,.556,111
180,NOP,2018-12-03,126,,LAC,L 126-129,240,49,92,.533,36,58,.621,13,34,.382,15,22,.682,126,49,83,.590,41,63,.651,8,20,.400,23,30,.767,129
181,HOU,2018-11-21,126,,DET,W 126-124,240,40,72,.556,27,39,.692,13,33,.394,33,36,.917,126,40,85,.471,24,51,.471,16,34,.471,28,37,.757,124
182,LAL,2018-11-14,126,,POR,W 126-117,240,44,93,.473,29,61,.475,15,32,.469,23,26,.885,126,41,93,.441,27,60,.450,14,33,.424,21,23,.913,117
183,CHO,2018-11-03,126,,CLE,W 126-94,240,52,91,.571,42,61,.689,10,30,.333,12,13,.923,126,35,81,.432,25,55,.455,10,26,.385,14,15,.933,94
184,DEN,2018-10-23,126,,SAC,W 126-112,240,51,99,.515,40,69,.580,11,30,.367,13,15,.867,126,45,86,.523,32,55,.582,13,31,.419,9,20,.450,112
185,NYK,2018-10-17,126,,ATL,W 126-107,240,45,99,.455,33,66,.500,12,33,.364,24,31,.774,126,41,90,.456,31,54,.574,10,36,.278,15,18,.833,107
186,PHI,2019-04-10,125,,CHI,W 125-109,240,52,93,.559,40,67,.597,12,26,.462,9,15,.600,125,45,95,.474,36,71,.507,9,24,.375,10,15,.667,109
187,CHO,2019-03-26,125,,SAS,W 125-116 (OT),265,46,100,.460,33,58,.569,13,42,.310,20,28,.714,125,44,108,.407,31,69,.449,13,39,.333,15,21,.714,116
188,UTA,2019-03-25,125,,PHO,W 125-92,240,48,86,.558,38,65,.585,10,21,.476,19,23,.826,125,31,76,.408,24,53,.453,7,23,.304,23,28,.821,92
189,DAL,2019-03-18,125,,NOP,L 125-129 (OT),265,46,105,.438,37,70,.529,9,35,.257,24,29,.828,125,49,104,.471,37,65,.569,12,39,.308,19,22,.864,129
190,MIL,2019-03-17,125,,PHI,L 125-130,240,43,95,.453,27,45,.600,16,50,.320,23,28,.821,125,47,100,.470,32,68,.471,15,32,.469,21,30,.700,130
191,LAL,2019-02-27,125,,NOP,W 125-119,240,49,94,.521,41,69,.594,8,25,.320,19,31,.613,125,46,102,.451,39,67,.582,7,35,.200,20,27,.741,119
192,UTA,2019-02-23,125,,DAL,W 125-109,240,41,85,.482,27,47,.574,14,38,.368,29,33,.879,125,41,97,.423,28,61,.459,13,36,.361,14,18,.778,109
193,GSW,2019-02-21,125,,SAC,W 125-123,240,43,94,.457,24,48,.500,19,46,.413,20,24,.833,125,43,99,.434,33,66,.500,10,33,.303,27,34,.794,123
194,UTA,2019-02-09,125,,SAS,W 125-105,240,47,90,.522,31,49,.633,16,41,.390,15,20,.750,125,40,89,.449,33,67,.493,7,22,.318,18,20,.900,105
195,CHI,2019-02-09,125,,WAS,L 125-134,240,49,97,.505,43,74,.581,6,23,.261,21,28,.750,125,55,95,.579,43,68,.632,12,27,.444,12,14,.857,134
196,CHO,2019-02-02,125,,CHI,W 125-118,240,43,82,.524,29,50,.580,14,32,.438,25,29,.862,125,42,81,.519,33,57,.579,9,24,.375,25,25,1.000,118
197,HOU,2019-01-07,125,,DEN,W 125-113,240,38,76,.500,16,29,.552,22,47,.468,27,34,.794,125,44,93,.473,37,64,.578,7,29,.241,18,21,.857,113
198,SAS,2019-01-03,125,,TOR,W 125-107,240,47,85,.553,34,58,.586,13,27,.481,18,20,.900,125,39,87,.448,33,57,.579,6,30,.200,23,29,.793,107
199,CHO,2018-12-31,125,,ORL,W 125-100,240,42,85,.494,31,61,.508,11,24,.458,30,33,.909,125,38,92,.413,28,57,.491,10,35,.286,14,19,.737,100
200,IND,2018-12-28,125,,DET,W 125-88,240,53,87,.609,48,68,.706,5,19,.263,14,20,.700,125,34,91,.374,25,55,.455,9,36,.250,11,12,.917,88
201,LAC,2018-12-20,125,,DAL,W 125-121,240,47,83,.566,41,63,.651,6,20,.300,25,31,.806,125,43,92,.467,33,64,.516,10,28,.357,25,33,.758,121
202,SAC,2018-12-14,125,,GSW,L 125-130,240,45,96,.469,30,52,.577,15,44,.341,20,25,.800,125,44,96,.458,29,56,.518,15,40,.375,27,36,.750,130
203,BRK,2018-12-14,125,,WAS,W 125-118,240,44,84,.524,33,53,.623,11,31,.355,26,31,.839,125,49,90,.544,38,61,.623,11,29,.379,9,16,.563,118
204,SAS,2018-12-13,125,,LAC,W 125-87,240,48,83,.578,38,61,.623,10,22,.455,19,24,.792,125,30,84,.357,20,53,.377,10,31,.323,17,24,.708,87
205,WAS,2018-12-12,125,,BOS,L 125-130 (OT),265,46,91,.505,34,58,.586,12,33,.364,21,29,.724,125,47,104,.452,36,66,.545,11,38,.289,25,25,1.000,130
206,BRK,2018-11-30,125,,MEM,L 125-131 (2OT),290,42,94,.447,26,50,.520,16,44,.364,25,30,.833,125,50,101,.495,38,71,.535,12,30,.400,19,22,.864,131
207,NOP,2018-11-28,125,,WAS,W 125-104,240,46,95,.484,35,59,.593,11,36,.306,22,28,.786,125,41,95,.432,28,56,.500,13,39,.333,9,16,.563,104
208,TOR,2018-11-25,125,,MIA,W 125-115,240,47,90,.522,36,55,.655,11,35,.314,20,25,.800,125,39,95,.411,24,59,.407,15,36,.417,22,32,.688,115
209,BRK,2018-11-25,125,,PHI,L 125-127,240,50,88,.568,40,63,.635,10,25,.400,15,20,.750,125,44,91,.484,32,62,.516,12,29,.414,27,33,.818,127
210,TOR,2018-11-23,125,,WAS,W 125-107,240,46,93,.495,29,54,.537,17,39,.436,16,19,.842,125,40,100,.400,31,54,.574,9,46,.196,18,19,.947,107
211,GSW,2018-11-23,125,,POR,W 125-97,240,48,85,.565,31,53,.585,17,32,.531,12,16,.750,125,38,93,.409,29,69,.420,9,24,.375,12,22,.545,97
212,WAS,2018-11-20,125,,LAC,W 125-118,240,40,93,.430,27,54,.500,13,39,.333,32,39,.821,125,46,89,.517,35,62,.565,11,27,.407,15,18,.833,118
213,NOP,2018-11-17,125,,DEN,W 125-115,240,42,87,.483,32,62,.516,10,25,.400,31,34,.912,125,46,95,.484,31,56,.554,15,39,.385,8,13,.615,115
214,CHO,2018-10-30,125,,MIA,W 125-113,240,44,81,.543,31,53,.585,13,28,.464,24,29,.828,125,41,87,.471,30,59,.508,11,28,.393,20,24,.833,113
215,LAL,2019-03-26,124,,WAS,W 124-106,240,48,89,.539,37,56,.661,11,33,.333,17,23,.739,124,39,90,.433,33,58,.569,6,32,.188,22,27,.815,106
216,IND,2019-03-24,124,,DEN,W 124-88,240,51,91,.560,43,73,.589,8,18,.444,14,17,.824,124,33,93,.355,26,64,.406,7,29,.241,15,16,.938,88
217,CHO,2019-03-23,124,,BOS,W 124-117,240,42,95,.442,24,57,.421,18,38,.474,22,28,.786,124,44,93,.473,25,50,.500,19,43,.442,10,15,.667,117
218,NYK,2019-03-17,124,,LAL,W 124-123,240,44,76,.579,32,50,.640,12,26,.462,24,29,.828,124,47,97,.485,40,70,.571,7,27,.259,22,28,.786,123
219,DEN,2019-01-19,124,,CLE,W 124-102,240,50,89,.562,35,52,.673,15,37,.405,9,11,.818,124,35,72,.486,25,43,.581,10,29,.345,22,26,.846,102
220,MIL,2019-01-15,124,,MIA,W 124-86,240,48,96,.500,31,57,.544,17,39,.436,11,18,.611,124,36,86,.419,28,52,.538,8,34,.235,6,8,.750,86
221,POR,2019-01-09,124,,CHI,W 124-112,240,47,83,.566,36,57,.632,11,26,.423,19,21,.905,124,43,93,.462,34,71,.479,9,22,.409,17,19,.895,112
222,SAS,2018-12-21,124,,MIN,W 124-98,240,46,87,.529,27,54,.500,19,33,.576,13,18,.722,124,33,83,.398,27,62,.435,6,21,.286,26,31,.839,98
223,CHO,2018-12-14,124,,NYK,L 124-126 (OT),265,48,102,.471,28,54,.519,20,48,.417,8,10,.800,124,47,98,.480,35,64,.547,12,34,.353,20,31,.645,126
224,PHI,2018-12-12,124,,BRK,L 124-127,240,50,91,.549,38,63,.603,12,28,.429,12,16,.750,124,38,74,.514,24,46,.522,14,28,.500,37,43,.860,127
225,OKC,2018-11-30,124,,ATL,W 124-109,240,46,88,.523,28,47,.596,18,41,.439,14,15,.933,124,43,96,.448,32,60,.533,11,36,.306,12,20,.600,109
226,ATL,2018-11-25,124,,CHO,W 124-123,240,50,94,.532,34,55,.618,16,39,.410,8,11,.727,124,41,92,.446,23,47,.489,18,45,.400,23,28,.821,123
227,WAS,2018-11-24,124,,NOP,W 124-114,240,51,90,.567,41,61,.672,10,29,.345,12,23,.522,124,43,90,.478,32,59,.542,11,31,.355,17,21,.810,114
228,CHI,2018-11-21,124,,PHO,W 124-116,240,46,81,.568,35,56,.625,11,25,.440,21,24,.875,124,48,98,.490,38,64,.594,10,34,.294,10,10,1.000,116
229,CHI,2018-10-29,124,,GSW,L 124-149,240,46,94,.489,35,59,.593,11,35,.314,21,34,.618,124,53,96,.552,29,51,.569,24,45,.533,19,26,.731,149
230,MIL,2018-10-29,124,,TOR,W 124-109,240,45,92,.489,26,47,.553,19,45,.422,15,19,.789,124,39,103,.379,30,58,.517,9,45,.200,22,28,.786,109
231,MIN,2018-10-29,124,,LAL,W 124-120,240,42,98,.429,28,69,.406,14,29,.483,26,30,.867,124,49,104,.471,37,71,.521,12,33,.364,10,15,.667,120
232,POR,2018-10-22,124,,WAS,L 124-125 (OT),265,43,108,.398,32,69,.464,11,39,.282,27,31,.871,124,46,110,.418,31,73,.425,15,37,.405,18,26,.692,125
233,MIL,2018-10-22,124,,NYK,W 124-113,240,45,96,.469,28,56,.500,17,40,.425,17,24,.708,124,45,99,.455,35,70,.500,10,29,.345,13,15,.867,113
234,OKC,2019-04-05,123,,DET,W 123-110,240,48,101,.475,36,72,.500,12,29,.414,15,22,.682,123,35,81,.432,20,40,.500,15,41,.366,25,31,.806,110
235,PHI,2019-03-28,123,,BRK,W 123-110,240,45,90,.500,33,65,.508,12,25,.480,21,28,.750,123,40,90,.444,29,58,.500,11,32,.344,19,29,.655,110
236,ORL,2019-03-22,123,,MEM,W 123-119 (OT),265,44,93,.473,30,54,.556,14,39,.359,21,27,.778,123,47,93,.505,32,55,.582,15,38,.395,10,21,.476,119
237,PHI,2019-03-15,123,,SAC,W 123-114,240,46,91,.505,39,67,.582,7,24,.292,24,27,.889,123,43,94,.457,34,67,.507,9,27,.333,19,24,.792,114
238,DEN,2019-02-24,123,,LAC,W 123-96,240,44,85,.518,32,51,.627,12,34,.353,23,35,.657,123,30,87,.345,27,66,.409,3,21,.143,33,37,.892,96
239,CHO,2019-02-22,123,,WAS,W 123-110,240,46,96,.479,33,63,.524,13,33,.394,18,22,.818,123,42,97,.433,32,58,.552,10,39,.256,16,18,.889,110
240,BOS,2019-01-23,123,,CLE,W 123-103,240,45,86,.523,33,61,.541,12,25,.480,21,23,.913,123,38,87,.437,25,57,.439,13,30,.433,14,20,.700,103
241,OKC,2019-01-22,123,,POR,W 123-114,240,43,85,.506,32,62,.516,11,23,.478,26,33,.788,123,43,95,.453,33,59,.559,10,36,.278,18,22,.818,114
242,BRK,2019-01-21,123,,SAC,W 123-94,240,45,90,.500,32,55,.582,13,35,.371,20,24,.833,123,39,93,.419,29,68,.426,10,25,.400,6,11,.545,94
243,WAS,2019-01-09,123,,PHI,W 123-106,240,47,87,.540,34,60,.567,13,27,.481,16,21,.762,123,37,86,.430,29,59,.492,8,27,.296,24,31,.774,106
244,SAC,2019-01-05,123,,GSW,L 123-127,240,46,97,.474,26,61,.426,20,36,.556,11,14,.786,123,47,93,.505,26,46,.565,21,47,.447,12,14,.857,127
245,DEN,2019-01-05,123,,CHO,W 123-110,240,47,102,.461,33,63,.524,14,39,.359,15,20,.750,123,39,82,.476,28,53,.528,11,29,.379,21,26,.808,110
246,NOP,2018-12-31,123,,MIN,W 123-114,240,45,87,.517,31,62,.500,14,25,.560,19,21,.905,123,43,93,.462,34,65,.523,9,28,.321,19,23,.826,114
247,MIN,2018-12-19,123,,DET,L 123-129 (OT),265,45,103,.437,36,70,.514,9,33,.273,24,29,.828,123,46,94,.489,26,46,.565,20,48,.417,17,28,.607,129
248,MIL,2018-12-19,123,,NOP,W 123-115,240,43,85,.506,30,52,.577,13,33,.394,24,30,.800,123,43,92,.467,24,50,.480,19,42,.452,10,15,.667,115
249,SAS,2018-12-17,123,,PHI,W 123-96,240,49,87,.563,40,64,.625,9,23,.391,16,17,.941,123,40,98,.408,29,61,.475,11,37,.297,5,7,.714,96
250,PHI,2018-11-30,123,,WAS,W 123-98,240,43,98,.439,31,60,.517,12,38,.316,25,33,.758,123,37,92,.402,29,64,.453,8,28,.286,16,19,.842,98
251,BOS,2018-11-16,123,,TOR,W 123-116 (OT),265,47,89,.528,38,63,.603,9,26,.346,20,24,.833,123,42,97,.433,34,68,.500,8,29,.276,24,29,.828,116
252,MIL,2018-11-16,123,,CHI,W 123-104,240,47,93,.505,29,50,.580,18,43,.419,11,17,.647,123,41,94,.436,28,61,.459,13,33,.394,9,13,.692,104
253,UTA,2018-11-09,123,,BOS,W 123-115,240,43,77,.558,30,43,.698,13,34,.382,24,30,.800,123,39,88,.443,22,45,.489,17,43,.395,20,22,.909,115
254,ATL,2018-11-03,123,,MIA,W 123-118,240,46,88,.523,33,56,.589,13,32,.406,18,23,.783,123,41,85,.482,25,45,.556,16,40,.400,20,26,.769,118
255,MIL,2018-10-24,123,,PHI,W 123-108,240,41,100,.410,28,57,.491,13,43,.302,28,30,.933,123,38,92,.413,27,58,.466,11,34,.324,21,30,.700,108
256,GSW,2018-10-22,123,,PHO,W 123-103,240,45,88,.511,31,51,.608,14,37,.378,19,26,.731,123,39,86,.453,30,52,.577,9,34,.265,16,18,.889,103
257,UTA,2018-10-19,123,,GSW,L 123-124,240,40,89,.449,21,43,.488,19,46,.413,24,29,.828,123,49,87,.563,39,68,.574,10,19,.526,16,18,.889,124
258,MIA,2019-04-09,122,,PHI,W 122-99,240,46,87,.529,33,60,.550,13,27,.481,17,23,.739,122,40,98,.408,35,73,.479,5,25,.200,14,16,.875,99
259,PHI,2019-04-04,122,,MIL,L 122-128,240,45,95,.474,27,59,.458,18,36,.500,14,18,.778,122,42,93,.452,30,59,.508,12,34,.353,32,43,.744,128
260,PHO,2019-04-01,122,,CLE,W 122-113,240,46,84,.548,33,47,.702,13,37,.351,17,20,.850,122,45,99,.455,37,77,.481,8,22,.364,15,22,.682,113
261,MIN,2019-04-01,122,,POR,L 122-132,240,47,96,.490,36,67,.537,11,29,.379,17,19,.895,122,50,91,.549,35,61,.574,15,30,.500,17,24,.708,132
262,DAL,2019-04-01,122,,PHI,W 122-102,240,46,97,.474,34,65,.523,12,32,.375,18,27,.667,122,36,93,.387,30,60,.500,6,33,.182,24,32,.750,102
263,GSW,2019-03-08,122,,DEN,W 122-105,240,45,84,.536,27,49,.551,18,35,.514,14,21,.667,122,33,87,.379,21,54,.389,12,33,.364,27,35,.771,105
264,IND,2019-02-28,122,,MIN,W 122-115,240,40,84,.476,24,57,.421,16,27,.593,26,31,.839,122,42,89,.472,34,63,.540,8,26,.308,23,34,.676,115
265,ATL,2019-02-22,122,,DET,L 122-125,240,43,88,.489,23,46,.500,20,42,.476,16,19,.842,122,46,95,.484,31,55,.564,15,40,.375,18,28,.643,125
266,CHI,2019-02-13,122,,MEM,W 122-110,240,45,80,.563,37,60,.617,8,20,.400,24,29,.828,122,43,89,.483,32,58,.552,11,31,.355,13,17,.765,110
267,NOP,2019-02-08,122,,MIN,W 122-117,240,43,91,.473,34,61,.557,9,30,.300,27,28,.964,122,46,91,.505,37,70,.529,9,21,.429,16,22,.727,117
268,ORL,2019-02-07,122,,MIN,W 122-112,240,45,83,.542,34,57,.596,11,26,.423,21,23,.913,122,46,99,.465,36,73,.493,10,26,.385,10,12,.833,112
269,BRK,2019-01-29,122,,CHI,W 122-117,240,42,94,.447,32,59,.542,10,35,.286,28,40,.700,122,47,94,.500,38,66,.576,9,28,.321,14,19,.737,117
270,LAC,2019-01-27,122,,SAC,W 122-108,240,42,88,.477,31,59,.525,11,29,.379,27,29,.931,122,37,93,.398,29,57,.509,8,36,.222,26,30,.867,108
271,OKC,2019-01-24,122,,NOP,W 122-116,240,50,101,.495,36,69,.522,14,32,.438,8,16,.500,122,49,101,.485,39,65,.600,10,36,.278,8,12,.667,116
272,PHI,2019-01-23,122,,SAS,W 122-120,240,47,93,.505,30,57,.526,17,36,.472,11,14,.786,122,47,82,.573,34,55,.618,13,27,.481,13,15,.867,120
273,BOS,2019-01-18,122,,MEM,W 122-116,240,44,86,.512,27,48,.563,17,38,.447,17,22,.773,122,41,92,.446,25,57,.439,16,35,.457,18,20,.900,116
274,OKC,2019-01-12,122,,SAS,W 122-112,240,43,93,.462,32,70,.457,11,23,.478,25,29,.862,122,44,96,.458,34,65,.523,10,31,.323,14,20,.700,112
275,TOR,2019-01-11,122,,BRK,W 122-105,240,48,105,.457,37,70,.529,11,35,.314,15,24,.625,122,37,88,.420,26,58,.448,11,30,.367,20,30,.667,105
276,GSW,2019-01-08,122,,NYK,W 122-95,240,49,96,.510,35,51,.686,14,45,.311,10,12,.833,122,35,88,.398,29,64,.453,6,24,.250,19,21,.905,95
277,TOR,2019-01-01,122,,UTA,W 122-116,240,45,82,.549,38,62,.613,7,20,.350,25,35,.714,122,42,97,.433,33,65,.508,9,32,.281,23,29,.793,116
278,OKC,2018-12-31,122,,DAL,W 122-102,240,46,103,.447,40,79,.506,6,24,.250,24,35,.686,122,31,74,.419,17,36,.472,14,38,.368,26,34,.765,102
279,DAL,2018-12-26,122,,NOP,W 122-119,240,39,81,.481,27,46,.587,12,35,.343,32,38,.842,122,42,90,.467,30,63,.476,12,27,.444,23,30,.767,119
280,SAC,2018-12-23,122,,NOP,W 122-117,240,42,100,.420,28,69,.406,14,31,.452,24,33,.727,122,44,94,.468,38,68,.559,6,26,.231,23,28,.821,117
281,OKC,2018-12-10,122,,UTA,W 122-113,240,43,85,.506,35,64,.547,8,21,.381,28,39,.718,122,43,84,.512,35,55,.636,8,29,.276,19,30,.633,113
282,OKC,2018-11-05,122,,NOP,W 122-116,240,45,93,.484,35,66,.530,10,27,.370,22,31,.710,122,41,84,.488,32,55,.582,9,29,.310,25,30,.833,116
283,BRK,2018-11-04,122,,PHI,W 122-97,240,50,105,.476,41,77,.532,9,28,.321,13,18,.722,122,31,65,.477,27,45,.600,4,20,.200,31,41,.756,97
284,PHI,2018-11-01,122,,LAC,W 122-113,240,44,93,.473,31,66,.470,13,27,.481,21,28,.750,122,38,86,.442,29,63,.460,9,23,.391,28,33,.848,113
285,TOR,2019-04-01,121,,ORL,W 121-109,240,42,84,.500,23,47,.489,19,37,.514,18,22,.818,121,43,93,.462,31,60,.517,12,33,.364,11,15,.733,109
286,BRK,2019-04-01,121,,MIL,L 121-131,240,39,94,.415,23,50,.460,16,44,.364,27,34,.794,121,47,94,.500,36,60,.600,11,34,.324,26,30,.867,131
287,NOP,2019-03-28,121,,SAC,W 121-118,240,49,97,.505,40,69,.580,9,28,.321,14,14,1.000,121,47,95,.495,37,72,.514,10,23,.435,14,16,.875,118
288,PHO,2019-03-27,121,,WAS,L 121-124,240,43,87,.494,29,50,.580,14,37,.378,21,26,.808,121,43,90,.478,34,65,.523,9,25,.360,29,43,.674,124
289,DAL,2019-03-26,121,,SAC,L 121-125,240,39,77,.506,24,32,.750,15,45,.333,28,32,.875,121,44,87,.506,34,64,.531,10,23,.435,27,32,.844,125
290,GSW,2019-03-24,121,,DET,W 121-114,240,46,74,.622,33,49,.673,13,25,.520,16,19,.842,121,39,84,.464,27,53,.509,12,31,.387,24,25,.960,114
291,SAC,2019-03-19,121,,BRK,L 121-123,240,49,95,.516,40,70,.571,9,25,.360,14,20,.700,121,47,94,.500,35,59,.593,12,35,.343,17,23,.739,123
292,DAL,2019-03-16,121,,CLE,W 121-116,240,46,89,.517,30,55,.545,16,34,.471,13,16,.813,121,40,86,.465,25,48,.521,15,38,.395,21,22,.955,116
293,WAS,2019-03-11,121,,SAC,W 121-115,240,40,86,.465,26,49,.531,14,37,.378,27,33,.818,121,41,91,.451,32,64,.500,9,27,.333,24,32,.750,115
294,SAS,2019-03-10,121,,MIL,W 121-114,240,49,100,.490,37,71,.521,12,29,.414,11,15,.733,121,41,87,.471,27,51,.529,14,36,.389,18,25,.720,114
295,POR,2019-03-07,121,,OKC,L 121-129 (OT),265,37,94,.394,28,53,.528,9,41,.220,38,47,.809,121,48,105,.457,40,78,.513,8,27,.296,25,32,.781,129
296,HOU,2019-02-28,121,,MIA,W 121-118,240,38,77,.494,19,31,.613,19,46,.413,26,28,.929,121,42,81,.519,27,53,.509,15,28,.536,19,24,.792,118
297,DEN,2019-02-26,121,,OKC,W 121-112,240,41,88,.466,28,60,.467,13,28,.464,26,35,.743,121,43,95,.453,33,57,.579,10,38,.263,16,25,.640,112
298,MIA,2019-02-25,121,,PHO,L 121-124,240,48,97,.495,39,68,.574,9,29,.310,16,20,.800,121,45,89,.506,32,57,.561,13,32,.406,21,25,.840,124
299,LAC,2019-02-25,121,,DAL,W 121-112,240,45,100,.450,28,55,.509,17,45,.378,14,18,.778,121,37,76,.487,23,40,.575,14,36,.389,24,27,.889,112
300,MIN,2019-02-13,121,,HOU,W 121-111,240,49,90,.544,39,70,.557,10,20,.500,13,17,.765,121,40,98,.408,21,45,.467,19,53,.358,12,13,.923,111
301,DET,2019-02-11,121,,WAS,W 121-112,240,44,85,.518,29,49,.592,15,36,.417,18,21,.857,121,42,84,.500,28,45,.622,14,39,.359,14,19,.737,112
302,TOR,2019-02-03,121,,LAC,W 121-103,240,43,94,.457,34,61,.557,9,33,.273,26,31,.839,121,38,89,.427,36,77,.468,2,12,.167,25,29,.862,103
303,HOU,2019-01-25,121,,TOR,W 121-119,240,41,91,.451,31,45,.689,10,46,.217,29,33,.879,121,44,91,.484,30,55,.545,14,36,.389,17,18,.944,119
304,PHI,2019-01-21,121,,HOU,W 121-93,240,43,88,.489,35,65,.538,8,23,.348,27,33,.818,121,31,86,.360,20,44,.455,11,42,.262,20,26,.769,93
305,PHI,2019-01-11,121,,ATL,L 121-123,240,45,87,.517,34,54,.630,11,33,.333,20,27,.741,121,45,81,.556,33,56,.589,12,25,.480,21,27,.778,123
306,DEN,2019-01-10,121,,LAC,W 121-100,240,50,99,.505,39,71,.549,11,28,.393,10,13,.769,121,38,87,.437,32,63,.508,6,24,.250,18,26,.692,100
307,TOR,2019-01-06,121,,IND,W 121-105,240,44,85,.518,27,52,.519,17,33,.515,16,17,.941,121,43,94,.457,39,77,.506,4,17,.235,15,20,.750,105
308,MIL,2019-01-01,121,,DET,W 121-98,240,47,79,.595,37,52,.712,10,27,.370,17,26,.654,121,35,92,.380,23,59,.390,12,33,.364,16,21,.762,98
309,LAL,2018-12-30,121,,SAC,W 121-114,240,47,98,.480,32,54,.593,15,44,.341,12,20,.600,121,46,95,.484,33,61,.541,13,34,.382,9,12,.750,114
310,ATL,2018-12-26,121,,IND,L 121-129,240,45,89,.506,28,53,.528,17,36,.472,14,18,.778,121,46,83,.554,33,56,.589,13,27,.481,24,33,.727,129
311,BOS,2018-12-25,121,,PHI,W 121-114 (OT),265,45,108,.417,31,67,.463,14,41,.341,17,20,.850,121,38,92,.413,23,52,.442,15,40,.375,23,29,.793,114
312,POR,2018-12-23,121,,DAL,W 121-118 (OT),265,49,104,.471,38,66,.576,11,38,.289,12,17,.706,121,43,103,.417,31,69,.449,12,34,.353,20,28,.714,118
313,OKC,2018-12-17,121,,CHI,W 121-96,240,43,89,.483,35,68,.515,8,21,.381,27,33,.818,121,38,85,.447,30,63,.476,8,22,.364,12,16,.750,96
314,MIN,2018-12-05,121,,CHO,W 121-104,240,48,89,.539,36,65,.554,12,24,.500,13,20,.650,121,40,98,.408,28,65,.431,12,33,.364,12,15,.800,104
315,LAL,2018-12-05,121,,SAS,W 121-113,240,42,88,.477,28,49,.571,14,39,.359,23,33,.697,121,43,96,.448,36,69,.522,7,27,.259,20,20,1.000,113
316,HOU,2018-12-01,121,,CHI,W 121-105,240,42,84,.500,26,43,.605,16,41,.390,21,30,.700,121,39,88,.443,31,56,.554,8,32,.250,19,24,.792,105
317,SAC,2018-11-29,121,,LAC,L 121-133,240,46,96,.479,39,72,.542,7,24,.292,22,26,.846,121,50,90,.556,38,62,.613,12,28,.429,21,28,.750,133
318,PHI,2018-11-21,121,,NOP,W 121-120,240,44,98,.449,34,69,.493,10,29,.345,23,26,.885,121,42,98,.429,31,68,.456,11,30,.367,25,33,.758,120
319,IND,2018-11-19,121,,UTA,W 121-94,240,49,93,.527,37,68,.544,12,25,.480,11,17,.647,121,36,74,.486,25,49,.510,11,25,.440,11,16,.688,94
320,LAC,2018-11-12,121,,GSW,W 121-116 (OT),265,43,91,.473,38,71,.535,5,20,.250,30,34,.882,121,44,94,.468,32,63,.508,12,31,.387,16,23,.696,116
321,SAC,2018-11-09,121,,MIN,W 121-110,240,43,95,.453,31,63,.492,12,32,.375,23,29,.793,121,39,94,.415,32,69,.464,7,25,.280,25,31,.806,110
322,LAL,2018-10-25,121,,DEN,W 121-114,240,46,92,.500,36,63,.571,10,29,.345,19,23,.826,121,46,92,.500,40,69,.580,6,23,.261,16,20,.800,114
323,POR,2018-10-20,121,,SAS,W 121-108,240,45,84,.536,30,52,.577,15,32,.469,16,19,.842,121,42,100,.420,29,70,.414,13,30,.433,11,14,.786,108
324,PHO,2018-10-17,121,,DAL,W 121-100,240,44,81,.543,25,47,.532,19,34,.559,14,16,.875,121,38,88,.432,28,55,.509,10,33,.303,14,20,.700,100
325,DAL,2019-04-09,120,,PHO,W 120-109,240,41,91,.451,25,51,.490,16,40,.400,22,27,.815,120,38,88,.432,25,53,.472,13,35,.371,20,28,.714,109
326,GSW,2019-04-05,120,,CLE,W 120-114,240,46,87,.529,26,50,.520,20,37,.541,8,8,1.000,120,43,97,.443,36,67,.537,7,30,.233,21,23,.913,114
327,HOU,2019-04-05,120,,NYK,W 120-96,240,43,101,.426,21,42,.500,22,59,.373,12,17,.706,120,37,82,.451,31,55,.564,6,27,.222,16,27,.593,96
328,NOP,2019-03-26,120,,ATL,L 120-130,240,39,83,.470,27,49,.551,12,34,.353,30,40,.750,120,44,97,.454,25,46,.543,19,51,.373,23,26,.885,130
329,UTA,2019-03-14,120,,MIN,W 120-100,240,44,89,.494,31,51,.608,13,38,.342,19,27,.704,120,42,91,.462,37,67,.552,5,24,.208,11,15,.733,100
330,ORL,2019-03-14,120,,CLE,W 120-91,240,45,93,.484,31,62,.500,14,31,.452,16,21,.762,120,35,86,.407,28,55,.509,7,31,.226,14,15,.933,91
331,MEM,2019-03-05,120,,POR,W 120-111,240,40,75,.533,27,48,.563,13,27,.481,27,36,.750,120,42,79,.532,33,50,.660,9,29,.310,18,21,.857,111
332,LAL,2019-03-01,120,,MIL,L 120-131,240,46,96,.479,33,56,.589,13,40,.325,15,18,.833,120,48,93,.516,34,53,.642,14,40,.350,21,24,.875,131
333,ATL,2019-02-23,120,,PHO,W 120-112,240,38,92,.413,26,59,.441,12,33,.364,32,38,.842,120,41,93,.441,28,56,.500,13,37,.351,17,20,.850,112
334,TOR,2019-02-22,120,,SAS,W 120-117,240,40,94,.426,26,64,.406,14,30,.467,26,32,.813,120,43,89,.483,31,52,.596,12,37,.324,19,22,.864,117
335,DEN,2019-02-13,120,,SAC,W 120-118,240,45,99,.455,37,68,.544,8,31,.258,22,25,.880,120,42,93,.452,31,61,.508,11,32,.344,23,28,.821,118
336,HOU,2019-02-11,120,,DAL,W 120-104,240,42,90,.467,19,30,.633,23,60,.383,13,15,.867,120,35,73,.479,22,37,.595,13,36,.361,21,27,.778,104
337,OKC,2019-02-11,120,,POR,W 120-111,240,41,86,.477,25,51,.490,16,35,.457,22,29,.759,120,36,87,.414,25,58,.431,11,29,.379,28,38,.737,111
338,GSW,2019-02-10,120,,MIA,W 120-118,240,44,82,.537,31,46,.674,13,36,.361,19,26,.731,120,48,105,.457,30,62,.484,18,43,.419,4,8,.500,118
339,ATL,2019-02-09,120,,CHO,L 120-129,240,46,86,.535,32,53,.604,14,33,.424,14,19,.737,120,48,88,.545,29,46,.630,19,42,.452,14,18,.778,129
340,DET,2019-02-08,120,,NYK,W 120-103,240,42,86,.488,29,56,.518,13,30,.433,23,29,.793,120,35,78,.449,28,56,.500,7,22,.318,26,41,.634,103
341,CHI,2019-02-06,120,,NOP,L 120-125,240,45,91,.495,29,55,.527,16,36,.444,14,19,.737,120,45,85,.529,30,50,.600,15,35,.429,20,30,.667,125
342,LAC,2019-01-31,120,,LAL,L 120-123 (OT),265,46,104,.442,32,61,.525,14,43,.326,14,26,.538,120,42,92,.457,31,66,.470,11,26,.423,28,35,.800,123
343,DAL,2019-01-27,120,,TOR,L 120-123,240,43,88,.489,32,52,.615,11,36,.306,23,34,.676,120,37,83,.446,20,49,.408,17,34,.500,32,38,.842,123
344,POR,2019-01-26,120,,ATL,W 120-111,240,41,82,.500,30,52,.577,11,30,.367,27,30,.900,120,42,92,.457,30,59,.508,12,33,.364,15,20,.750,111
345,TOR,2019-01-22,120,,SAC,W 120-105,240,40,91,.440,24,51,.471,16,40,.400,24,35,.686,120,41,91,.451,34,70,.486,7,21,.333,16,22,.727,105
346,IND,2019-01-20,120,,CHO,W 120-95,240,47,100,.470,33,73,.452,14,27,.519,12,12,1.000,120,33,82,.402,21,47,.447,12,35,.343,17,25,.680,95
347,DET,2019-01-16,120,,ORL,W 120-115 (OT),265,44,92,.478,32,62,.516,12,30,.400,20,25,.800,120,47,94,.500,33,55,.600,14,39,.359,7,13,.538,115
348,MIN,2019-01-04,120,,ORL,W 120-103,240,47,91,.516,38,65,.585,9,26,.346,17,23,.739,120,42,88,.477,33,61,.541,9,27,.333,10,19,.526,103
349,SAS,2018-12-31,120,,BOS,W 120-111,240,45,91,.495,31,65,.477,14,26,.538,16,18,.889,120,43,88,.489,32,54,.593,11,34,.324,14,20,.700,111
350,MIN,2018-12-28,120,,ATL,L 120-123 (OT),265,44,98,.449,33,66,.500,11,32,.344,21,38,.553,120,47,100,.470,31,65,.477,16,35,.457,13,20,.650,123
351,ORL,2018-12-26,120,,PHO,L 120-122 (OT),265,44,96,.458,30,60,.500,14,36,.389,18,22,.818,120,48,95,.505,35,71,.493,13,24,.542,13,17,.765,122
352,GSW,2018-12-22,120,,DAL,W 120-116,240,45,98,.459,30,55,.545,15,43,.349,15,16,.938,120,42,92,.457,28,53,.528,14,39,.359,18,28,.643,116
353,LAL,2018-12-02,120,,PHO,W 120-96,240,46,92,.500,35,65,.538,11,27,.407,17,23,.739,120,37,93,.398,24,60,.400,13,33,.394,9,11,.818,96
354,MIN,2018-11-12,120,,BRK,W 120-113,240,42,80,.525,32,57,.561,10,23,.435,26,31,.839,120,40,101,.396,22,51,.431,18,50,.360,15,22,.682,113
355,LAC,2018-11-05,120,,MIN,W 120-109,240,43,88,.489,29,57,.509,14,31,.452,20,22,.909,120,40,85,.471,35,64,.547,5,21,.238,24,30,.800,109
356,BRK,2018-10-31,120,,DET,W 120-119 (OT),265,43,101,.426,31,63,.492,12,38,.316,22,30,.733,120,39,93,.419,28,59,.475,11,34,.324,30,39,.769,119
357,MIA,2018-10-27,120,,POR,W 120-111,240,44,96,.458,29,57,.509,15,39,.385,17,26,.654,120,37,88,.420,25,55,.455,12,33,.364,25,28,.893,111
358,OKC,2018-10-21,120,,SAC,L 120-131,240,46,104,.442,37,65,.569,9,39,.231,19,30,.633,120,50,91,.549,40,69,.580,10,22,.455,21,28,.750,131
359,UTA,2019-04-05,119,,SAC,W 119-98,240,44,85,.518,29,52,.558,15,33,.455,16,25,.640,119,38,92,.413,33,71,.465,5,21,.238,17,25,.680,98
360,DEN,2019-04-05,119,,POR,W 119-110,240,43,84,.512,36,57,.632,7,27,.259,26,29,.897,119,42,86,.488,32,57,.561,10,29,.345,16,20,.800,110
361,OKC,2019-04-02,119,,LAL,W 119-103,240,47,102,.461,34,58,.586,13,44,.295,12,20,.600,119,40,84,.476,24,45,.533,16,39,.410,7,10,.700,103
362,HOU,2019-03-30,119,,SAC,W 119-108,240,39,83,.470,22,31,.710,17,52,.327,24,27,.889,119,42,94,.447,27,65,.415,15,29,.517,9,15,.600,108
363,ORL,2019-03-25,119,,PHI,W 119-98,240,45,87,.517,34,58,.586,11,29,.379,18,23,.783,119,36,73,.493,30,50,.600,6,23,.261,20,26,.769,98
364,ORL,2019-03-20,119,,NOP,W 119-96,240,46,102,.451,31,64,.484,15,38,.395,12,14,.857,119,38,102,.373,28,68,.412,10,34,.294,10,13,.769,96
365,LAC,2019-03-17,119,,BRK,W 119-116,240,42,97,.433,30,66,.455,12,31,.387,23,28,.821,119,42,100,.420,28,62,.452,14,38,.368,18,25,.720,116
366,TOR,2019-03-01,119,,POR,W 119-117,240,45,81,.556,35,53,.660,10,28,.357,19,21,.905,119,42,85,.494,28,52,.538,14,33,.424,19,23,.826,117
367,HOU,2019-02-25,119,,ATL,W 119-111,240,39,90,.433,24,39,.615,15,51,.294,26,30,.867,119,39,80,.488,22,42,.524,17,38,.447,16,23,.696,111
368,WAS,2019-02-08,119,,CLE,W 119-106,240,46,92,.500,34,57,.596,12,35,.343,15,16,.938,119,36,96,.375,24,58,.414,12,38,.316,22,25,.880,106
369,TOR,2019-01-19,119,,MEM,W 119-90,240,44,90,.489,27,54,.500,17,36,.472,14,16,.875,119,34,80,.425,24,51,.471,10,29,.345,12,15,.800,90
370,BOS,2018-12-23,119,,CHO,W 119-103,240,43,86,.500,30,47,.638,13,39,.333,20,25,.800,119,38,88,.432,30,56,.536,8,32,.250,19,26,.731,103
371,PHO,2018-12-10,119,,LAC,L 119-123 (OT),265,47,94,.500,38,69,.551,9,25,.360,16,20,.800,119,45,85,.529,38,64,.594,7,21,.333,26,33,.788,123
372,DAL,2018-11-21,119,,BRK,W 119-113,240,38,78,.487,27,51,.529,11,27,.407,32,41,.780,119,42,94,.447,28,52,.538,14,42,.333,15,21,.714,113
373,ATL,2018-11-19,119,,LAC,L 119-127,240,45,101,.446,33,63,.524,12,38,.316,17,19,.895,119,40,93,.430,30,60,.500,10,33,.303,37,47,.787,127
374,PHI,2018-11-19,119,,PHO,W 119-114,240,41,84,.488,35,62,.565,6,22,.273,31,42,.738,119,44,87,.506,31,54,.574,13,33,.394,13,24,.542,114
375,CHO,2018-11-17,119,,PHI,L 119-122 (OT),265,42,99,.424,32,68,.471,10,31,.323,25,27,.926,119,39,93,.419,28,58,.483,11,35,.314,33,38,.868,122
376,BRK,2018-11-17,119,,LAC,L 119-127,240,40,88,.455,27,60,.450,13,28,.464,26,34,.765,119,48,95,.505,37,72,.514,11,23,.478,20,24,.833,127
377,WAS,2018-11-14,119,,CLE,W 119-95,240,44,92,.478,31,52,.596,13,40,.325,18,26,.692,119,35,77,.455,31,56,.554,4,21,.190,21,31,.677,95
378,NOP,2018-11-10,119,,PHO,W 119-99,240,42,86,.488,31,61,.508,11,25,.440,24,29,.828,119,35,86,.407,25,50,.500,10,36,.278,19,20,.950,99
379,DAL,2018-11-06,119,,WAS,W 119-100,240,39,82,.476,24,48,.500,15,34,.441,26,27,.963,119,37,87,.425,26,52,.500,11,35,.314,15,20,.750,100
380,DEN,2018-10-20,119,,PHO,W 119-91,240,43,85,.506,34,57,.596,9,28,.321,24,29,.828,119,29,77,.377,18,38,.474,11,39,.282,22,35,.629,91
381,UTA,2019-04-09,118,,DEN,W 118-108,240,41,78,.526,31,51,.608,10,27,.370,26,34,.765,118,41,88,.466,29,63,.460,12,25,.480,14,22,.636,108
382,PHI,2019-03-20,118,,BOS,W 118-115,240,34,90,.378,23,57,.404,11,33,.333,39,43,.907,118,45,96,.469,33,64,.516,12,32,.375,13,16,.813,115
383,HOU,2019-03-11,118,,CHO,W 118-106,240,38,91,.418,21,48,.438,17,43,.395,25,27,.926,118,38,89,.427,22,48,.458,16,41,.390,14,15,.933,106
384,LAC,2019-03-08,118,,OKC,W 118-110,240,39,86,.453,30,61,.492,9,25,.360,31,46,.674,118,41,102,.402,30,58,.517,11,44,.250,17,26,.654,110
385,CHI,2019-03-03,118,,ATL,L 118-123,240,47,92,.511,39,65,.600,8,27,.296,16,21,.762,118,42,89,.472,21,47,.447,21,42,.500,18,28,.643,123
386,PHO,2019-03-02,118,,LAL,W 118-109,240,39,76,.513,33,50,.660,6,26,.231,34,40,.850,118,43,89,.483,35,64,.547,8,25,.320,15,23,.652,109
387,NYK,2019-02-28,118,,CLE,L 118-125,240,46,95,.484,35,63,.556,11,32,.344,15,23,.652,118,41,80,.513,27,46,.587,14,34,.412,29,36,.806,125
388,TOR,2019-02-26,118,,BOS,W 118-95,240,46,94,.489,29,58,.500,17,36,.472,9,14,.643,118,33,86,.384,27,56,.482,6,30,.200,23,28,.821,95
389,BOS,2019-02-13,118,,DET,W 118-110,240,45,88,.511,29,49,.592,16,39,.410,12,15,.800,118,36,84,.429,23,44,.523,13,40,.325,25,34,.735,110
390,LAC,2019-01-28,118,,ATL,L 118-123,240,41,85,.482,31,58,.534,10,27,.370,26,28,.929,118,44,87,.506,34,53,.642,10,34,.294,25,29,.862,123
391,OKC,2019-01-27,118,,MIL,W 118-112,240,44,94,.468,28,62,.452,16,32,.500,14,25,.560,118,39,91,.429,24,54,.444,15,37,.405,19,28,.679,112
392,WAS,2019-01-24,118,,GSW,L 118-126,240,44,95,.463,29,53,.547,15,42,.357,15,21,.714,118,50,88,.568,43,68,.632,7,20,.350,19,21,.905,126
393,PHO,2018-12-29,118,,DEN,L 118-122,240,49,91,.538,38,62,.613,11,29,.379,9,14,.643,118,42,76,.553,24,41,.585,18,35,.514,20,26,.769,122
394,MIA,2018-12-28,118,,CLE,W 118-94,240,48,91,.527,38,60,.633,10,31,.323,12,16,.750,118,31,81,.383,18,44,.409,13,37,.351,19,22,.864,94
395,ATL,2018-12-18,118,,WAS,W 118-110,240,37,79,.468,25,47,.532,12,32,.375,32,39,.821,118,36,83,.434,23,43,.535,13,40,.325,25,36,.694,110
396,NOP,2018-12-12,118,,OKC,W 118-114,240,45,97,.464,41,79,.519,4,18,.222,24,30,.800,118,42,87,.483,29,44,.659,13,43,.302,17,27,.630,114
397,UTA,2018-12-06,118,,HOU,W 118-91,240,45,89,.506,37,57,.649,8,32,.250,20,27,.741,118,34,88,.386,26,52,.500,8,36,.222,15,17,.882,91
398,ORL,2018-12-05,118,,DEN,L 118-124 (OT),265,45,95,.474,25,46,.543,20,49,.408,8,8,1.000,118,45,82,.549,34,63,.540,11,19,.579,23,37,.622,124
399,DET,2018-11-25,118,,PHO,W 118-107,240,43,93,.462,27,52,.519,16,41,.390,16,25,.640,118,42,82,.512,34,57,.596,8,25,.320,15,21,.714,107
400,DAL,2018-11-14,118,,UTA,W 118-68,240,45,77,.584,33,49,.673,12,28,.429,16,24,.667,118,25,81,.309,19,46,.413,6,35,.171,12,19,.632,68
401,OKC,2018-11-12,118,,PHO,W 118-101,240,43,92,.467,30,65,.462,13,27,.481,19,20,.950,118,39,81,.481,32,55,.582,7,26,.269,16,19,.842,101
402,POR,2018-11-06,118,,MIL,W 118-103,240,48,91,.527,31,48,.646,17,43,.395,5,8,.625,118,40,92,.435,24,50,.480,16,42,.381,7,8,.875,103
403,MIL,2018-10-19,118,,IND,W 118-101,240,44,93,.473,27,47,.574,17,46,.370,13,21,.619,118,38,87,.437,32,69,.464,6,18,.333,19,27,.704,101
404,TOR,2019-04-07,117,,MIA,W 117-109 (OT),265,39,87,.448,23,46,.500,16,41,.390,23,27,.852,117,41,100,.410,28,66,.424,13,34,.382,14,19,.737,109
405,LAC,2019-04-05,117,,LAL,L 117-122,240,40,91,.440,30,62,.484,10,29,.345,27,31,.871,117,43,96,.448,29,64,.453,14,32,.438,22,27,.815,122
406,SAC,2019-04-04,117,,CLE,W 117-104,240,48,97,.495,34,59,.576,14,38,.368,7,10,.700,117,44,81,.543,33,56,.589,11,25,.440,5,9,.556,104
407,SAS,2019-04-02,117,,ATL,W 117-111,240,42,80,.525,28,50,.560,14,30,.467,19,22,.864,117,43,94,.457,31,60,.517,12,34,.353,13,20,.650,111
408,POR,2019-03-23,117,,DET,W 117-112,240,43,79,.544,32,53,.604,11,26,.423,20,27,.741,117,42,84,.500,28,50,.560,14,34,.412,14,14,1.000,112
409,ATL,2019-03-21,117,,UTA,W 117-114,240,41,87,.471,22,47,.468,19,40,.475,16,23,.696,117,43,94,.457,33,62,.532,10,32,.313,18,26,.692,114
410,HOU,2019-03-17,117,,MIN,W 117-102,240,43,94,.457,22,44,.500,21,50,.420,10,14,.714,117,38,92,.413,28,60,.467,10,32,.313,16,23,.696,102
411,MIL,2019-03-07,117,,IND,W 117-98,240,43,86,.500,29,51,.569,14,35,.400,17,21,.810,117,35,90,.389,21,53,.396,14,37,.378,14,20,.700,98
412,PHI,2019-03-02,117,,GSW,L 117-120,240,39,87,.448,25,56,.446,14,31,.452,25,29,.862,117,41,81,.506,27,48,.563,14,33,.424,24,34,.706,120
413,MIA,2019-03-02,117,,BRK,W 117-88,240,44,90,.489,30,56,.536,14,34,.412,15,22,.682,117,31,88,.352,22,46,.478,9,42,.214,17,22,.773,88
414,ATL,2019-02-12,117,,LAL,W 117-113,240,40,92,.435,24,50,.480,16,42,.381,21,26,.808,117,41,95,.432,27,55,.491,14,40,.350,17,25,.680,113
415,SAC,2019-02-10,117,,PHO,W 117-104,240,38,84,.452,29,53,.547,9,31,.290,32,44,.727,117,38,91,.418,32,64,.500,6,27,.222,22,30,.733,104
416,PHI,2019-02-08,117,,DEN,W 117-110,240,39,78,.500,29,56,.518,10,22,.455,29,32,.906,117,46,94,.489,40,68,.588,6,26,.231,12,13,.923,110
417,OKC,2019-02-07,117,,MEM,W 117-95,240,43,90,.478,26,46,.565,17,44,.386,14,22,.636,117,34,77,.442,27,53,.509,7,24,.292,20,23,.870,95
418,SAS,2019-01-31,117,,BRK,W 117-114,240,40,100,.400,28,67,.418,12,33,.364,25,29,.862,117,42,89,.472,31,55,.564,11,34,.324,19,29,.655,114
419,ORL,2019-01-29,117,,OKC,L 117-126,240,44,102,.431,30,61,.492,14,41,.341,15,18,.833,117,49,91,.538,40,70,.571,9,21,.429,19,26,.731,126
420,BOS,2019-01-16,117,,TOR,W 117-108,240,46,92,.500,32,62,.516,14,30,.467,11,13,.846,117,41,92,.446,34,63,.540,7,29,.241,19,21,.905,108
421,LAC,2019-01-14,117,,NOP,L 117-121,240,41,86,.477,23,50,.460,18,36,.500,17,24,.708,117,46,105,.438,38,80,.475,8,25,.320,21,28,.750,121
422,OKC,2019-01-08,117,,MIN,L 117-119,240,43,85,.506,31,55,.564,12,30,.400,19,26,.731,117,38,90,.422,27,59,.458,11,31,.355,32,40,.800,119
423,SAC,2018-12-27,117,,LAL,W 117-116,240,45,101,.446,35,72,.486,10,29,.345,17,21,.810,117,45,88,.511,35,63,.556,10,25,.400,16,23,.696,116
424,UTA,2018-12-25,117,,POR,W 117-96,240,46,83,.554,33,54,.611,13,29,.448,12,23,.522,117,35,89,.393,26,66,.394,9,23,.391,17,26,.654,96
425,ATL,2018-12-05,117,,WAS,L 117-131,240,41,92,.446,29,54,.537,12,38,.316,23,31,.742,117,46,95,.484,34,57,.596,12,38,.316,27,32,.844,131
426,PHI,2018-11-28,117,,NYK,W 117-91,240,47,87,.540,35,62,.565,12,25,.480,11,16,.688,117,32,92,.348,26,63,.413,6,29,.207,21,22,.955,91
427,DEN,2018-11-27,117,,LAL,W 117-85,240,47,97,.485,38,72,.528,9,25,.360,14,15,.933,117,34,87,.391,29,52,.558,5,35,.143,12,18,.667,85
428,CLE,2018-11-24,117,,HOU,W 117-108,240,44,90,.489,37,68,.544,7,22,.318,22,29,.759,117,37,74,.500,22,35,.629,15,39,.385,19,28,.679,108
429,GSW,2018-11-24,117,,SAC,W 117-116,240,41,88,.466,31,54,.574,10,34,.294,25,29,.862,117,42,97,.433,31,69,.449,11,28,.393,21,29,.724,116
430,CHO,2018-11-19,117,,BOS,W 117-112,240,43,89,.483,28,48,.583,15,41,.366,16,22,.727,117,45,89,.506,36,57,.632,9,32,.281,13,18,.722,112
431,SAC,2018-11-19,117,,OKC,W 117-113,240,45,102,.441,29,64,.453,16,38,.421,11,17,.647,117,45,108,.417,33,67,.493,12,41,.293,11,16,.688,113
432,WAS,2018-11-12,117,,ORL,W 117-109,240,40,79,.506,27,46,.587,13,33,.394,24,33,.727,117,43,89,.483,28,59,.475,15,30,.500,8,11,.727,109
433,ORL,2018-11-09,117,,WAS,W 117-108,240,44,86,.512,31,55,.564,13,31,.419,16,19,.842,117,42,82,.512,31,55,.564,11,27,.407,13,19,.684,108
434,UTA,2018-11-07,117,,DAL,W 117-102,240,43,89,.483,30,52,.577,13,37,.351,18,26,.692,117,29,73,.397,21,49,.429,8,24,.333,36,40,.900,102
435,GSW,2018-11-05,117,,MEM,W 117-101,240,41,81,.506,28,57,.491,13,24,.542,22,23,.957,117,38,83,.458,29,56,.518,9,27,.333,16,21,.762,101
436,BOS,2018-11-01,117,,MIL,W 117-113,240,41,92,.446,17,37,.459,24,55,.436,11,13,.846,117,41,85,.482,32,56,.571,9,29,.310,22,30,.733,113
437,OKC,2018-10-28,117,,PHO,W 117-110,240,43,85,.506,36,61,.590,7,24,.292,24,35,.686,117,38,86,.442,30,59,.508,8,27,.296,26,27,.963,110
438,MEM,2018-10-27,117,,PHO,W 117-96,240,44,79,.557,35,53,.660,9,26,.346,20,22,.909,117,36,78,.462,27,45,.600,9,33,.273,15,19,.789,96
439,NOP,2018-10-26,117,,BRK,W 117-115,240,44,98,.449,35,75,.467,9,23,.391,20,26,.769,117,43,98,.439,24,58,.414,19,40,.475,10,15,.667,115
440,SAC,2018-10-17,117,,UTA,L 117-123,240,49,95,.516,42,76,.553,7,19,.368,12,18,.667,117,41,79,.519,28,52,.538,13,27,.481,28,38,.737,123
441,MIL,2019-04-10,116,,OKC,L 116-127,240,43,100,.430,28,54,.519,15,46,.326,15,21,.714,116,48,99,.485,25,45,.556,23,54,.426,8,13,.615,127
442,POR,2019-04-03,116,,MEM,W 116-89,240,48,94,.511,38,63,.603,10,31,.323,10,16,.625,116,31,80,.388,20,47,.426,11,33,.333,16,19,.842,89
443,GSW,2019-04-02,116,,DEN,W 116-102,240,50,92,.543,37,58,.638,13,34,.382,3,8,.375,116,36,96,.375,29,66,.439,7,30,.233,23,29,.793,102
444,IND,2019-03-30,116,,ORL,L 116-121,240,48,90,.533,39,66,.591,9,24,.375,11,17,.647,116,47,92,.511,32,54,.593,15,38,.395,12,14,.857,121
445,SAS,2019-03-28,116,,CLE,W 116-110,240,45,85,.529,31,52,.596,14,33,.424,12,17,.706,116,45,92,.489,33,63,.524,12,29,.414,8,10,.800,110
446,MIL,2019-03-22,116,,MIA,W 116-87,240,43,85,.506,26,51,.510,17,34,.500,13,20,.650,116,32,85,.376,21,48,.438,11,37,.297,12,23,.522,87
447,SAC,2019-03-21,116,,DAL,W 116-100,240,41,87,.471,28,52,.538,13,35,.371,21,28,.750,116,36,92,.391,24,52,.462,12,40,.300,16,23,.696,100
448,NYK,2019-03-20,116,,UTA,L 116-137,240,45,86,.523,32,55,.582,13,31,.419,13,21,.619,116,48,85,.565,28,43,.651,20,42,.476,21,25,.840,137
449,SAS,2019-03-02,116,,OKC,W 116-102,240,45,91,.495,37,72,.514,8,19,.421,18,25,.720,116,40,88,.455,33,59,.559,7,29,.241,15,24,.625,102
450,PHO,2019-03-01,116,,NOP,L 116-130,240,40,94,.426,28,60,.467,12,34,.353,24,28,.857,116,50,87,.575,34,60,.567,16,27,.593,14,20,.700,130
451,BRK,2019-02-27,116,,WAS,L 116-125,240,39,85,.459,31,50,.620,8,35,.229,30,39,.769,116,44,96,.458,33,59,.559,11,37,.297,26,31,.839,125
452,OKC,2019-02-23,116,,SAC,L 116-119,240,40,105,.381,26,59,.441,14,46,.304,22,28,.786,116,44,97,.454,37,78,.474,7,19,.368,24,34,.706,119
453,IND,2019-02-07,116,,LAC,W 116-92,240,49,87,.563,40,65,.615,9,22,.409,9,11,.818,116,37,85,.435,31,68,.456,6,17,.353,12,19,.632,92
454,UTA,2019-02-06,116,,PHO,W 116-88,240,42,84,.500,31,56,.554,11,28,.393,21,32,.656,116,35,75,.467,32,58,.552,3,17,.176,15,19,.789,88
455,HOU,2019-01-29,116,,NOP,L 116-121,240,40,101,.396,21,45,.467,19,56,.339,17,24,.708,116,46,90,.511,37,59,.627,9,31,.290,20,25,.800,121
456,CLE,2019-01-29,116,,WAS,W 116-113,240,45,84,.536,30,50,.600,15,34,.441,11,24,.458,116,42,87,.483,30,51,.588,12,36,.333,17,23,.739,113
457,LAL,2019-01-27,116,,PHO,W 116-102,240,47,89,.528,37,66,.561,10,23,.435,12,18,.667,116,34,85,.400,27,59,.458,7,26,.269,27,32,.844,102
458,MIL,2019-01-21,116,,DAL,W 116-106,240,42,91,.462,30,59,.508,12,32,.375,20,22,.909,116,41,99,.414,27,59,.458,14,40,.350,10,17,.588,106
459,MIN,2019-01-20,116,,PHO,W 116-114,240,39,91,.429,33,67,.493,6,24,.250,32,40,.800,116,40,86,.465,28,47,.596,12,39,.308,22,32,.688,114
460,DEN,2019-01-13,116,,POR,W 116-113,240,45,81,.556,36,59,.610,9,22,.409,17,20,.850,116,40,88,.455,28,54,.519,12,34,.353,21,22,.955,113
461,ORL,2019-01-13,116,,HOU,W 116-109,240,41,85,.482,32,61,.525,9,24,.375,25,28,.893,116,38,86,.442,28,44,.636,10,42,.238,23,27,.852,109
462,BRK,2019-01-09,116,,ATL,W 116-100,240,43,95,.453,33,65,.508,10,30,.333,20,26,.769,116,36,99,.364,30,64,.469,6,35,.171,22,25,.880,100
463,BOS,2019-01-07,116,,BRK,W 116-95,240,47,93,.505,35,61,.574,12,32,.375,10,12,.833,116,32,79,.405,21,37,.568,11,42,.262,20,22,.909,95
464,MIL,2019-01-05,116,,TOR,L 116-123,240,40,81,.494,26,44,.591,14,37,.378,22,27,.815,116,42,82,.512,28,51,.549,14,31,.452,25,31,.806,123
465,CHI,2019-01-04,116,,IND,L 116-119 (OT),265,47,91,.516,35,63,.556,12,28,.429,10,13,.769,116,49,93,.527,40,65,.615,9,28,.321,12,17,.706,119
466,IND,2018-12-31,116,,ATL,W 116-108,240,42,84,.500,31,60,.517,11,24,.458,21,29,.724,116,41,95,.432,28,63,.444,13,32,.406,13,19,.684,108
467,ORL,2018-12-28,116,,TOR,W 116-87,240,44,93,.473,35,67,.522,9,26,.346,19,22,.864,116,28,95,.295,16,61,.262,12,34,.353,19,24,.792,87
468,PHI,2018-12-10,116,,DET,W 116-102,240,39,88,.443,24,51,.471,15,37,.405,23,35,.657,116,41,84,.488,32,63,.508,9,21,.429,11,21,.524,102
469,GSW,2018-12-10,116,,MIN,W 116-108,240,39,93,.419,20,50,.400,19,43,.442,19,21,.905,116,38,83,.458,31,58,.534,7,25,.280,25,31,.806,108
470,CLE,2018-12-08,116,,WAS,W 116-101,240,47,89,.528,32,58,.552,15,31,.484,7,10,.700,116,38,86,.442,24,48,.500,14,38,.368,11,16,.688,101
471,MIL,2018-11-28,116,,CHI,W 116-113,240,43,87,.494,31,52,.596,12,35,.343,18,24,.750,116,40,89,.449,29,52,.558,11,37,.297,22,29,.759,113
472,GSW,2018-11-26,116,,ORL,W 116-110,240,41,84,.488,28,49,.571,13,35,.371,21,23,.913,116,40,90,.444,26,60,.433,14,30,.467,16,21,.762,110
473,DET,2018-11-23,116,,HOU,W 116-111 (OT),265,40,88,.455,33,61,.541,7,27,.259,29,40,.725,116,41,98,.418,31,62,.500,10,36,.278,19,21,.905,111
474,LAC,2018-11-15,116,,SAS,W 116-111,240,40,85,.471,32,62,.516,8,23,.348,28,35,.800,116,41,102,.402,32,73,.438,9,29,.310,20,25,.800,111
475,PHO,2018-11-14,116,,SAS,W 116-96,240,47,84,.560,32,53,.604,15,31,.484,7,8,.875,116,35,83,.422,28,60,.467,7,23,.304,19,24,.792,96
476,GSW,2018-11-10,116,,BRK,W 116-100,240,46,83,.554,39,67,.582,7,16,.438,17,21,.810,116,36,77,.468,29,53,.547,7,24,.292,21,29,.724,100
477,POR,2018-11-08,116,,LAC,W 116-105,240,40,97,.412,30,71,.423,10,26,.385,26,28,.929,116,41,89,.461,33,66,.500,8,23,.348,15,20,.750,105
478,GSW,2018-11-02,116,,MIN,W 116-99,240,43,88,.489,30,54,.556,13,34,.382,17,22,.773,116,38,101,.376,25,56,.446,13,45,.289,10,14,.714,99
479,DEN,2018-10-29,116,,NOP,W 116-111,240,42,93,.452,31,58,.534,11,35,.314,21,23,.913,116,43,82,.524,32,58,.552,11,24,.458,14,20,.700,111
480,TOR,2018-10-26,116,,DAL,W 116-107,240,44,91,.484,33,64,.516,11,27,.407,17,20,.850,116,38,92,.413,26,62,.419,12,30,.400,19,24,.792,107
481,SAC,2018-10-26,116,,WAS,W 116-112,240,44,95,.463,30,58,.517,14,37,.378,14,23,.609,116,40,86,.465,26,44,.591,14,42,.333,18,23,.783,112
482,NOP,2018-10-23,116,,LAC,W 116-109,240,40,93,.430,34,69,.493,6,24,.250,30,40,.750,116,41,87,.471,36,67,.537,5,20,.250,22,27,.815,109
483,PHI,2018-10-20,116,,ORL,W 116-115,240,45,94,.479,28,61,.459,17,33,.515,9,10,.900,116,41,90,.456,25,61,.410,16,29,.552,17,22,.773,115
484,CHI,2018-10-20,116,,DET,L 116-118,240,44,87,.506,37,66,.561,7,21,.333,21,26,.808,116,41,101,.406,23,61,.377,18,40,.450,18,23,.783,118
485,TOR,2018-10-17,116,,CLE,W 116-104,240,45,92,.489,31,59,.525,14,33,.424,12,20,.600,116,34,85,.400,27,66,.409,7,19,.368,29,39,.744,104
486,POR,2019-04-07,115,,DEN,W 115-108,240,41,89,.461,32,61,.525,9,28,.321,24,29,.828,115,42,95,.442,29,62,.468,13,33,.394,11,20,.550,108
487,MIL,2019-04-07,115,,ATL,W 115-107,240,40,91,.440,31,50,.620,9,41,.220,26,34,.765,115,40,100,.400,23,55,.418,17,45,.378,10,19,.526,107
488,PHO,2019-03-30,115,,MEM,L 115-120,240,43,81,.531,31,53,.585,12,28,.429,17,23,.739,115,41,89,.461,33,64,.516,8,25,.320,30,40,.750,120
489,DET,2019-03-28,115,,ORL,W 115-98,240,46,86,.535,29,51,.569,17,35,.486,6,12,.500,115,37,94,.394,29,63,.460,8,31,.258,16,20,.800,98
490,UTA,2019-03-27,115,,LAL,W 115-100,240,41,83,.494,31,51,.608,10,32,.313,23,36,.639,115,37,97,.381,28,70,.400,9,27,.333,17,24,.708,100
491,MEM,2019-03-25,115,,OKC,W 115-103,240,40,89,.449,29,56,.518,11,33,.333,24,31,.774,115,38,95,.400,26,59,.441,12,36,.333,15,20,.750,103
492,LAC,2019-03-19,115,,IND,W 115-109,240,43,89,.483,33,55,.600,10,34,.294,19,27,.704,115,45,87,.517,38,66,.576,7,21,.333,12,17,.706,109
493,MIL,2019-03-19,115,,LAL,W 115-101,240,41,89,.461,26,42,.619,15,47,.319,18,27,.667,115,33,86,.384,17,43,.395,16,43,.372,19,23,.826,101
494,SAC,2019-03-04,115,,NYK,W 115-108,240,39,83,.470,28,54,.519,11,29,.379,26,33,.788,115,39,85,.459,27,56,.482,12,29,.414,18,28,.643,108
495,UTA,2019-03-02,115,,MIL,W 115-111,240,44,96,.458,32,67,.478,12,29,.414,15,26,.577,115,37,96,.385,22,57,.386,15,39,.385,22,30,.733,111
496,PHI,2019-02-23,115,,POR,L 115-130,240,42,87,.483,33,63,.524,9,24,.375,22,28,.786,115,49,99,.495,44,76,.579,5,23,.217,27,29,.931,130
497,CHO,2019-02-23,115,,BRK,L 115-117,240,39,86,.453,27,51,.529,12,35,.343,25,30,.833,115,40,87,.460,23,44,.523,17,43,.395,20,26,.769,117
498,GSW,2019-02-12,115,,UTA,W 115-108,240,44,89,.494,31,48,.646,13,41,.317,14,21,.667,115,41,87,.471,31,61,.508,10,26,.385,16,21,.762,108
499,CHO,2019-02-05,115,,LAC,L 115-117,240,39,93,.419,24,51,.471,15,42,.357,22,26,.846,115,42,87,.483,24,63,.381,18,24,.750,15,17,.882,117
500,WAS,2019-02-02,115,,MIL,L 115-131,240,43,93,.462,33,60,.550,10,33,.303,19,26,.731,115,45,91,.495,28,52,.538,17,39,.436,24,24,1.000,131
501,GSW,2019-02-02,115,,LAL,W 115-101,240,43,91,.473,32,57,.561,11,34,.324,18,19,.947,115,42,96,.438,35,69,.507,7,27,.259,10,17,.588,101
502,SAC,2019-02-02,115,,PHI,W 115-108,240,42,92,.457,31,62,.500,11,30,.367,20,24,.833,115,41,93,.441,34,60,.567,7,33,.212,19,25,.760,108
503,PHI,2019-01-19,115,,OKC,L 115-117,240,38,81,.469,27,49,.551,11,32,.344,28,39,.718,115,41,93,.441,29,62,.468,12,31,.387,23,26,.885,117
504,ORL,2019-01-18,115,,BRK,L 115-117,240,47,94,.500,37,68,.544,10,26,.385,11,14,.786,115,44,97,.454,25,51,.490,19,46,.413,10,15,.667,117
505,UTA,2019-01-18,115,,CLE,W 115-99,240,44,85,.518,31,48,.646,13,37,.351,14,15,.933,115,36,87,.414,29,63,.460,7,24,.292,20,26,.769,99
506,SAC,2019-01-14,115,,POR,W 115-107,240,43,87,.494,33,61,.541,10,26,.385,19,24,.792,115,37,92,.402,27,61,.443,10,31,.323,23,29,.793,107
507,MIN,2019-01-11,115,,DAL,L 115-119,240,47,102,.461,37,78,.474,10,24,.417,11,13,.846,115,44,97,.454,31,59,.525,13,38,.342,18,24,.750,119
508,MIA,2019-01-10,115,,BOS,W 115-99,240,46,96,.479,28,57,.491,18,39,.462,5,8,.625,115,36,89,.404,24,55,.436,12,34,.353,15,17,.882,99
509,CLE,2019-01-08,115,,IND,L 115-123,240,41,76,.539,28,47,.596,13,29,.448,20,23,.870,115,49,91,.538,39,65,.600,10,26,.385,15,19,.789,123
510,PHO,2019-01-08,115,,SAC,W 115-111,240,45,88,.511,35,63,.556,10,25,.400,15,19,.789,115,38,80,.475,23,51,.451,15,29,.517,20,29,.690,111
511,MIA,2019-01-04,115,,WAS,W 115-109,240,44,91,.484,35,62,.565,9,29,.310,18,25,.720,115,42,98,.429,32,62,.516,10,36,.278,15,19,.789,109
512,BOS,2019-01-02,115,,MIN,W 115-102,240,45,76,.592,33,46,.717,12,30,.400,13,15,.867,115,40,84,.476,33,61,.541,7,23,.304,15,21,.714,102
513,DEN,2019-01-01,115,,NYK,W 115-108,240,44,95,.463,32,61,.525,12,34,.353,15,23,.652,115,42,93,.452,31,66,.470,11,27,.407,13,18,.722,108
514,BRK,2018-12-18,115,,LAL,W 115-110,240,44,91,.484,30,57,.526,14,34,.412,13,19,.684,115,42,90,.467,29,50,.580,13,40,.325,13,23,.565,110
515,MIL,2018-12-05,115,,DET,W 115-92,240,38,82,.463,24,41,.585,14,41,.341,25,30,.833,115,35,95,.368,26,57,.456,9,38,.237,13,19,.684,92
516,LAC,2018-11-28,115,,PHO,W 115-99,240,40,86,.465,29,65,.446,11,21,.524,24,32,.750,115,39,89,.438,31,63,.492,8,26,.308,13,18,.722,99
517,POR,2018-11-28,115,,ORL,W 115-112,240,37,85,.435,18,46,.391,19,39,.487,22,32,.688,115,42,81,.519,28,51,.549,14,30,.467,14,15,.933,112
518,DET,2018-11-27,115,,NYK,W 115-108,240,38,80,.475,31,56,.554,7,24,.292,32,45,.711,115,36,91,.396,27,64,.422,9,27,.333,27,32,.844,108
519,HOU,2018-11-11,115,,IND,W 115-103,240,36,74,.486,16,27,.593,20,47,.426,23,32,.719,115,36,78,.462,25,49,.510,11,29,.379,20,26,.769,103
520,DET,2018-11-05,115,,MIA,L 115-120 (OT),265,43,105,.410,32,70,.457,11,35,.314,18,28,.643,115,44,98,.449,32,67,.478,12,31,.387,20,31,.645,120
521,DEN,2018-11-05,115,,BOS,W 115-107,240,41,90,.456,28,56,.500,13,34,.382,20,28,.714,115,44,87,.506,35,56,.625,9,31,.290,10,12,.833,107
522,NYK,2018-11-05,115,,CHI,L 115-116 (2OT),290,41,106,.387,34,80,.425,7,26,.269,26,29,.897,115,43,95,.453,35,65,.538,8,30,.267,22,30,.733,116
523,ATL,2018-11-01,115,,SAC,L 115-146,240,42,87,.483,34,56,.607,8,31,.258,23,34,.676,115,53,98,.541,39,63,.619,14,35,.400,26,32,.813,146
524,NYK,2018-10-29,115,,BRK,W 115-96,240,45,92,.489,36,68,.529,9,24,.375,16,18,.889,115,34,84,.405,23,46,.500,11,38,.289,17,22,.773,96
525,DAL,2018-10-22,115,,CHI,W 115-109,240,40,93,.430,25,46,.543,15,47,.319,20,21,.952,115,41,80,.513,28,57,.491,13,23,.565,14,21,.667,109
526,LAC,2018-10-21,115,,HOU,W 115-112,240,42,89,.472,37,64,.578,5,25,.200,26,26,1.000,115,43,89,.483,28,54,.519,15,35,.429,11,15,.733,112
527,LAL,2018-10-20,115,,HOU,L 115-124,240,48,100,.480,40,68,.588,8,32,.250,11,18,.611,115,44,96,.458,28,54,.519,16,42,.381,20,30,.667,124
528,CHO,2019-04-10,114,,ORL,L 114-122,240,41,78,.526,33,49,.673,8,29,.276,24,27,.889,114,48,88,.545,37,58,.638,11,30,.367,15,20,.750,122
529,ORL,2019-04-03,114,,NYK,W 114-100,240,45,99,.455,34,67,.507,11,32,.344,13,20,.650,114,38,85,.447,32,58,.552,6,27,.222,18,21,.857,100
530,WAS,2019-04-03,114,,CHI,L 114-115,240,45,97,.464,40,70,.571,5,27,.185,19,26,.731,114,48,90,.533,43,71,.606,5,19,.263,14,17,.824,115
531,BOS,2019-03-29,114,,IND,W 114-112,240,44,86,.512,31,59,.525,13,27,.481,13,17,.765,114,42,90,.467,30,63,.476,12,27,.444,16,23,.696,112
532,TOR,2019-03-24,114,,CHO,L 114-115,240,45,77,.584,34,51,.667,11,26,.423,13,13,1.000,114,41,93,.441,23,52,.442,18,41,.439,15,17,.882,115
533,OKC,2019-03-20,114,,TOR,L 114-123 (OT),265,43,103,.417,30,60,.500,13,43,.302,15,29,.517,114,45,87,.517,31,51,.608,14,36,.389,19,21,.905,123
534,CHO,2019-03-19,114,,PHI,L 114-118,240,36,83,.434,27,48,.563,9,35,.257,33,44,.750,114,43,86,.500,32,54,.593,11,32,.344,21,28,.750,118
535,UTA,2019-03-16,114,,BRK,W 114-98,240,39,91,.429,26,55,.473,13,36,.361,23,31,.742,114,33,95,.347,21,59,.356,12,36,.333,20,22,.909,98
536,MEM,2019-03-08,114,,UTA,W 114-104,240,46,90,.511,37,68,.544,9,22,.409,13,15,.867,114,35,82,.427,17,34,.500,18,48,.375,16,24,.667,104
537,PHI,2019-03-05,114,,ORL,W 114-106,240,42,89,.472,31,61,.508,11,28,.393,19,21,.905,114,42,93,.452,29,61,.475,13,32,.406,9,12,.750,106
538,MIA,2019-03-04,114,,ATL,W 114-113,240,44,79,.557,35,56,.625,9,23,.391,17,24,.708,114,38,91,.418,21,45,.467,17,46,.370,20,25,.800,113
539,PHO,2019-03-04,114,,MIL,W 114-105,240,41,91,.451,34,69,.493,7,22,.318,25,31,.806,114,35,95,.368,23,53,.434,12,42,.286,23,31,.742,105
540,NOP,2019-01-26,114,,SAS,L 114-126,240,45,96,.469,38,69,.551,7,27,.259,17,24,.708,114,47,91,.516,36,67,.537,11,24,.458,21,25,.840,126
541,BRK,2019-01-23,114,,ORL,W 114-110,240,43,90,.478,33,58,.569,10,32,.313,18,23,.783,114,38,89,.427,27,55,.491,11,34,.324,23,28,.821,110
542,UTA,2019-01-23,114,,DEN,W 114-108,240,38,88,.432,19,42,.452,19,46,.413,19,27,.704,114,42,88,.477,34,61,.557,8,27,.296,16,20,.800,108
543,CHO,2019-01-17,114,,SAC,W 114-95,240,39,87,.448,28,49,.571,11,38,.289,25,29,.862,114,39,88,.443,28,55,.509,11,33,.333,6,13,.462,95
544,ATL,2019-01-13,114,,MIL,L 114-133,240,39,96,.406,27,58,.466,12,38,.316,24,30,.800,114,49,92,.533,38,62,.613,11,30,.367,24,33,.727,133
545,DAL,2019-01-13,114,,GSW,L 114-119,240,38,91,.418,22,53,.415,16,38,.421,22,29,.759,114,45,99,.455,26,54,.481,19,45,.422,10,12,.833,119
546,NOP,2019-01-07,114,,MEM,W 114-95,240,44,79,.557,38,62,.613,6,17,.353,20,29,.690,114,35,78,.449,25,48,.521,10,30,.333,15,18,.833,95
547,MIL,2019-01-07,114,,UTA,W 114-102,240,46,98,.469,37,73,.507,9,25,.360,13,16,.813,114,36,86,.419,22,49,.449,14,37,.378,16,23,.696,102
548,BOS,2019-01-04,114,,DAL,W 114-93,240,42,96,.438,21,51,.412,21,45,.467,9,11,.818,114,34,88,.386,23,44,.523,11,44,.250,14,19,.737,93
549,WAS,2019-01-02,114,,ATL,W 114-98,240,43,92,.467,32,63,.508,11,29,.379,17,23,.739,114,40,95,.421,30,64,.469,10,31,.323,8,13,.615,98
550,NOP,2018-12-28,114,,DAL,W 114-112,240,44,96,.458,40,73,.548,4,23,.174,22,27,.815,114,37,78,.474,22,46,.478,15,32,.469,23,33,.697,112
551,DAL,2018-12-12,114,,ATL,W 114-107,240,35,75,.467,23,41,.561,12,34,.353,32,43,.744,114,43,93,.462,32,60,.533,11,33,.333,10,14,.714,107
552,CHI,2018-12-07,114,,OKC,W 114-112,240,43,82,.524,31,57,.544,12,25,.480,16,23,.696,114,43,94,.457,33,66,.500,10,28,.357,16,24,.667,112
553,DAL,2018-12-02,114,,LAC,W 114-110,240,42,95,.442,34,72,.472,8,23,.348,22,26,.846,114,42,95,.442,33,71,.465,9,24,.375,17,22,.773,110
554,LAL,2018-11-30,114,,DAL,W 114-103,240,42,86,.488,33,56,.589,9,30,.300,21,32,.656,114,34,86,.395,24,47,.511,10,39,.256,25,34,.735,103
555,MEM,2018-11-27,114,,TOR,L 114-122,240,43,85,.506,33,56,.589,10,29,.345,18,21,.857,114,42,69,.609,24,36,.667,18,33,.545,20,28,.714,122
556,NYK,2018-11-23,114,,NOP,W 114-109,240,41,91,.451,29,58,.500,12,33,.364,20,27,.741,114,40,101,.396,33,73,.452,7,28,.250,22,29,.759,109
557,MIL,2018-11-23,114,,PHO,L 114-116,240,42,87,.483,32,43,.744,10,44,.227,20,30,.667,114,45,90,.500,36,64,.563,9,26,.346,17,22,.773,116
558,NYK,2018-11-20,114,,POR,L 114-118,240,42,83,.506,29,54,.537,13,29,.448,17,22,.773,114,45,95,.474,29,60,.483,16,35,.457,12,17,.706,118
559,MIA,2018-11-12,114,,PHI,L 114-124,240,37,77,.481,24,46,.522,13,31,.419,27,33,.818,114,39,83,.470,24,47,.511,15,36,.417,31,39,.795,124
560,DEN,2018-11-11,114,,MIL,L 114-121,240,41,89,.461,23,51,.451,18,38,.474,14,20,.700,114,48,84,.571,31,50,.620,17,34,.500,8,13,.615,121
561,LAL,2018-11-07,114,,MIN,W 114-110,240,44,91,.484,29,57,.509,15,34,.441,11,14,.786,114,41,91,.451,21,51,.412,20,40,.500,8,9,.889,110
562,LAL,2018-10-31,114,,DAL,W 114-113,240,43,84,.512,33,67,.493,10,17,.588,18,24,.750,114,43,86,.500,30,57,.526,13,29,.448,14,19,.737,113
563,BRK,2018-10-28,114,,GSW,L 114-120,240,42,87,.483,22,45,.489,20,42,.476,10,15,.667,114,44,89,.494,33,56,.589,11,33,.333,21,24,.875,120
564,ORL,2018-10-25,114,,POR,L 114-128,240,43,86,.500,31,56,.554,12,30,.400,16,20,.800,114,48,87,.552,37,60,.617,11,27,.407,21,26,.808,128
565,BRK,2019-04-10,113,,MIA,W 113-94,240,43,114,.377,22,56,.393,21,58,.362,6,7,.857,113,38,98,.388,30,57,.526,8,41,.195,10,15,.667,94
566,LAL,2019-04-07,113,,UTA,W 113-109,240,46,89,.517,39,64,.609,7,25,.280,14,21,.667,113,38,84,.452,25,42,.595,13,42,.310,20,28,.714,109
567,NYK,2019-04-07,113,,WAS,W 113-110,240,41,80,.513,24,46,.522,17,34,.500,14,19,.737,113,43,103,.417,33,69,.478,10,34,.294,14,18,.778,110
568,CHO,2019-04-05,113,,TOR,W 113-111,240,44,94,.468,31,55,.564,13,39,.333,12,14,.857,113,43,80,.538,34,54,.630,9,26,.346,16,20,.800,111
569,DEN,2019-04-03,113,,SAS,W 113-85,240,47,87,.540,35,54,.648,12,33,.364,7,12,.583,113,31,81,.383,26,54,.481,5,27,.185,18,25,.720,85
570,NYK,2019-04-01,113,,CHI,W 113-105,240,37,74,.500,19,36,.528,18,38,.474,21,25,.840,113,42,94,.447,38,77,.494,4,17,.235,17,23,.739,105
571,LAC,2019-03-31,113,,MEM,W 113-96,240,36,75,.480,29,48,.604,7,27,.259,34,38,.895,113,32,85,.376,24,52,.462,8,33,.242,24,29,.828,96
572,NYK,2019-03-24,113,,LAC,L 113-124,240,41,86,.477,32,53,.604,9,33,.273,22,25,.880,113,38,86,.442,23,51,.451,15,35,.429,33,37,.892,124
573,CHO,2019-03-21,113,,MIN,W 113-106,240,43,100,.430,34,71,.479,9,29,.310,18,24,.750,113,39,88,.443,29,60,.483,10,28,.357,18,29,.621,106
574,NOP,2019-03-12,113,,MIL,L 113-130,240,46,107,.430,36,60,.600,10,47,.213,11,16,.688,113,48,97,.495,38,61,.623,10,36,.278,24,28,.857,130
575,BRK,2019-03-06,113,,CLE,W 113-107,240,43,91,.473,31,58,.534,12,33,.364,15,26,.577,113,35,87,.402,19,49,.388,16,38,.421,21,29,.724,107
576,CHO,2019-02-27,113,,HOU,L 113-118,240,39,83,.470,27,50,.540,12,33,.364,23,27,.852,113,42,91,.462,29,52,.558,13,39,.333,21,24,.875,118
577,DET,2019-02-25,113,,IND,W 113-109,240,39,88,.443,21,47,.447,18,41,.439,17,26,.654,113,40,87,.460,30,61,.492,10,26,.385,19,21,.905,109
578,SAS,2019-02-02,113,,NOP,W 113-108,240,44,92,.478,35,69,.507,9,23,.391,16,18,.889,113,43,96,.448,33,61,.541,10,35,.286,12,12,1.000,108
579,MIN,2019-01-18,113,,SAS,L 113-116,240,37,84,.440,30,58,.517,7,26,.269,32,38,.842,113,41,82,.500,30,58,.517,11,24,.458,23,29,.793,116
580,WAS,2019-01-11,113,,MIL,W 113-106,240,40,82,.488,22,49,.449,18,33,.545,15,20,.750,113,40,89,.449,27,49,.551,13,40,.325,13,17,.765,106
581,UTA,2019-01-11,113,,LAL,W 113-95,240,38,96,.396,23,54,.426,15,42,.357,22,32,.688,113,37,103,.359,32,76,.421,5,27,.185,16,24,.667,95
582,LAL,2019-01-09,113,,DET,W 113-100,240,46,82,.561,38,59,.644,8,23,.348,13,18,.722,113,39,86,.453,25,42,.595,14,44,.318,8,14,.571,100
583,PHO,2019-01-06,113,,CHO,L 113-119,240,43,83,.518,33,58,.569,10,25,.400,17,19,.895,113,44,91,.484,37,66,.561,7,25,.280,24,34,.706,119
584,SAC,2019-01-03,113,,DEN,L 113-117,240,45,90,.500,32,59,.542,13,31,.419,10,15,.667,113,41,89,.461,27,50,.540,14,39,.359,21,30,.700,117
585,LAC,2019-01-01,113,,PHI,L 113-119,240,42,91,.462,37,66,.561,5,25,.200,24,34,.706,113,42,87,.483,30,61,.492,12,26,.462,23,33,.697,119
586,HOU,2018-12-31,113,,MEM,W 113-101,240,31,70,.443,13,29,.448,18,41,.439,33,45,.733,113,38,82,.463,32,57,.561,6,25,.240,19,30,.633,101
587,HOU,2018-12-25,113,,OKC,W 113-109,240,44,97,.454,30,53,.566,14,44,.318,11,17,.647,113,43,98,.439,34,68,.500,9,30,.300,14,21,.667,109
588,SAC,2018-12-19,113,,OKC,L 113-132,240,39,93,.419,26,59,.441,13,34,.382,22,33,.667,113,51,102,.500,38,70,.543,13,32,.406,17,27,.630,132
589,DAL,2018-12-16,113,,SAC,L 113-120,240,40,96,.417,31,61,.508,9,35,.257,24,31,.774,113,46,98,.469,37,67,.552,9,31,.290,19,21,.905,120
590,DET,2018-12-15,113,,BOS,W 113-104,240,39,80,.488,29,50,.580,10,30,.333,25,35,.714,113,39,94,.415,30,61,.492,9,33,.273,17,23,.739,104
591,IND,2018-12-12,113,,MIL,W 113-97,240,43,91,.473,31,61,.508,12,30,.400,15,20,.750,113,38,91,.418,27,48,.563,11,43,.256,10,15,.667,97
592,CLE,2018-12-12,113,,NYK,W 113-106,240,43,91,.473,33,57,.579,10,34,.294,17,21,.810,113,41,94,.436,30,67,.448,11,27,.407,13,14,.929,106
593,BOS,2018-12-10,113,,NOP,W 113-100,240,44,90,.489,32,51,.627,12,39,.308,13,19,.684,113,39,87,.448,31,61,.508,8,26,.308,14,19,.737,100
594,POR,2018-12-08,113,,MIN,W 113-105,240,39,83,.470,29,50,.580,10,33,.303,25,30,.833,113,40,91,.440,33,75,.440,7,16,.438,18,22,.818,105
595,CHO,2018-12-07,113,,DEN,W 113-107,240,33,86,.384,20,51,.392,13,35,.371,34,38,.895,113,39,101,.386,31,66,.470,8,35,.229,21,26,.808,107
596,TOR,2018-12-05,113,,PHI,W 113-102,240,43,100,.430,35,71,.493,8,29,.276,19,22,.864,113,40,88,.455,29,53,.547,11,35,.314,11,14,.786,102
597,MIA,2018-11-27,113,,ATL,L 113-115,240,40,87,.460,27,49,.551,13,38,.342,20,30,.667,113,38,80,.475,26,49,.531,12,31,.387,27,32,.844,115
598,DAL,2018-11-24,113,,BOS,W 113-104,240,42,87,.483,26,46,.565,16,41,.390,13,21,.619,113,41,86,.477,31,58,.534,10,28,.357,12,13,.923,104
599,DET,2018-11-19,113,,CLE,W 113-102,240,41,89,.461,28,51,.549,13,38,.342,18,19,.947,113,35,79,.443,27,58,.466,8,21,.381,24,34,.706,102
600,PHI,2018-11-16,113,,UTA,W 113-107,240,41,81,.506,30,58,.517,11,23,.478,20,32,.625,113,41,88,.466,37,66,.561,4,22,.182,21,37,.568,107
01,MIL,2018-11-14,113,,MEM,L 113-116,240,41,81,.506,32,46,.696,9,35,.257,22,27,.815,113,42,83,.506,28,47,.596,14,36,.389,18,24,.750,116
602,CLE,2018-11-13,113,,CHO,W 113-89,240,45,85,.529,32,61,.525,13,24,.542,10,12,.833,113,33,95,.347,25,54,.463,8,41,.195,15,19,.789,89
603,CHO,2018-11-06,113,,ATL,W 113-102,240,45,92,.489,32,61,.525,13,31,.419,10,18,.556,113,41,85,.482,35,55,.636,6,30,.200,14,18,.778,102
604,PHI,2018-10-29,113,,ATL,W 113-92,240,41,99,.414,27,52,.519,14,47,.298,17,18,.944,113,35,94,.372,27,57,.474,8,37,.216,14,21,.667,92
605,MIA,2018-10-29,113,,SAC,L 113-123,240,38,92,.413,25,53,.472,13,39,.333,24,34,.706,113,48,97,.495,36,71,.507,12,26,.462,15,25,.600,123
606,SAS,2018-10-29,113,,DAL,W 113-108 (OT),265,42,91,.462,33,71,.465,9,20,.450,20,21,.952,113,43,91,.473,33,57,.579,10,34,.294,12,17,.706,108
607,MIL,2018-10-27,113,,ORL,W 113-91,240,41,82,.500,31,52,.596,10,30,.333,21,23,.913,113,33,101,.327,23,58,.397,10,43,.233,15,17,.882,91
608,HOU,2018-10-26,113,,LAC,L 113-133,240,38,98,.388,23,57,.404,15,41,.366,22,25,.880,113,43,79,.544,31,56,.554,12,23,.522,35,38,.921,133
609,PHO,2018-10-24,113,,LAL,L 113-131,240,44,84,.524,34,53,.642,10,31,.323,15,21,.714,113,52,100,.520,42,72,.583,10,28,.357,17,23,.739,131
610,WAS,2018-10-20,113,,TOR,L 113-117,240,37,89,.416,24,50,.480,13,39,.333,26,32,.813,113,39,88,.443,29,59,.492,10,29,.345,29,36,.806,117
611,TOR,2018-10-19,113,,BOS,W 113-101,240,43,92,.467,30,57,.526,13,35,.371,14,19,.737,113,40,99,.404,26,63,.413,14,36,.389,7,10,.700,101
612,OKC,2019-04-09,112,,HOU,W 112-111,240,40,96,.417,24,55,.436,16,41,.390,16,20,.800,112,38,88,.432,20,35,.571,18,53,.340,17,20,.850,111
613,DAL,2019-04-05,112,,MEM,L 112-122,240,41,96,.427,24,49,.490,17,47,.362,13,21,.619,112,46,96,.479,30,55,.545,16,41,.390,14,16,.875,122
614,WAS,2019-04-05,112,,SAS,L 112-129,240,42,88,.477,33,56,.589,9,32,.281,19,22,.864,112,51,91,.560,41,66,.621,10,25,.400,17,20,.850,129
615,HOU,2019-03-28,112,,DEN,W 112-85,240,40,87,.460,25,47,.532,15,40,.375,17,20,.850,112,31,84,.369,27,60,.450,4,24,.167,19,20,.950,85
616,TOR,2019-03-26,112,,CHI,W 112-103,240,42,86,.488,30,58,.517,12,28,.429,16,16,1.000,112,39,86,.453,31,63,.492,8,23,.348,17,20,.850,103
617,SAC,2019-03-23,112,,PHO,W 112-103,240,39,92,.424,22,54,.407,17,38,.447,17,22,.773,112,36,88,.409,27,54,.500,9,34,.265,22,26,.846,103
618,GSW,2019-03-21,112,,IND,W 112-89,240,44,89,.494,31,53,.585,13,36,.361,11,16,.688,112,35,91,.385,29,68,.426,6,23,.261,13,17,.765,89
619,ATL,2019-03-09,112,,BRK,L 112-114,240,39,105,.371,31,64,.484,8,41,.195,26,32,.813,112,33,86,.384,18,42,.429,15,44,.341,33,54,.611,114
620,CHO,2019-03-08,112,,WAS,W 112-111,240,40,96,.417,26,55,.473,14,41,.341,18,20,.900,112,40,86,.465,31,59,.525,9,27,.333,22,26,.846,111
621,UTA,2019-03-04,112,,NOP,L 112-115,240,43,92,.467,29,54,.537,14,38,.368,12,14,.857,112,46,96,.479,37,76,.487,9,20,.450,14,18,.778,115
622,DET,2019-03-03,112,,TOR,W 112-107 (OT),265,40,86,.465,28,53,.528,12,33,.364,20,29,.690,112,37,96,.385,23,57,.404,14,39,.359,19,24,.792,107
623,IND,2019-03-02,112,,ORL,L 112-117,240,42,77,.545,35,50,.700,7,27,.259,21,24,.875,112,46,91,.505,36,63,.571,10,28,.357,15,19,.789,117
624,DEN,2019-03-02,112,,NOP,L 112-120,240,39,92,.424,30,60,.500,9,32,.281,25,29,.862,112,45,92,.489,33,62,.532,12,30,.400,18,26,.692,120
625,BRK,2019-03-01,112,,CHO,L 112-123,240,44,86,.512,34,54,.630,10,32,.313,14,18,.778,112,50,94,.532,41,73,.562,9,21,.429,14,17,.824,123
626,MIN,2019-02-25,112,,SAC,W 112-105,240,42,83,.506,34,52,.654,8,31,.258,20,28,.714,112,37,95,.389,28,69,.406,9,26,.346,22,29,.759,105
627,CLE,2019-02-23,112,,MEM,W 112-107,240,39,88,.443,23,46,.500,16,42,.381,18,23,.783,112,40,90,.444,35,65,.538,5,25,.200,22,28,.786,107
628,WAS,2019-02-23,112,,IND,L 112-119,240,42,79,.532,29,44,.659,13,35,.371,15,21,.714,112,47,83,.566,36,58,.621,11,25,.440,14,22,.636,119
629,GSW,2019-02-23,112,,HOU,L 112-118,240,42,90,.467,28,54,.519,14,36,.389,14,20,.700,112,40,92,.435,24,49,.490,16,43,.372,22,24,.917,118
630,HOU,2019-02-09,112,,OKC,L 112-117,240,37,86,.430,21,41,.512,16,45,.356,22,30,.733,112,40,89,.449,27,55,.491,13,34,.382,24,30,.800,117
631,BOS,2019-02-09,112,,LAC,L 112-123,240,39,92,.424,30,66,.455,9,26,.346,25,31,.806,112,40,84,.476,28,54,.519,12,30,.400,31,40,.775,123
632,PHO,2019-02-02,112,,ATL,L 112-118,240,45,96,.469,33,64,.516,12,32,.375,10,18,.556,112,43,84,.512,29,52,.558,14,32,.438,18,26,.692,118
633,BOS,2019-01-28,112,,BRK,W 112-104,240,45,100,.450,32,60,.533,13,40,.325,9,10,.900,112,39,103,.379,26,69,.377,13,34,.382,13,16,.813,104
634,HOU,2019-01-14,112,,MEM,W 112-94,240,37,84,.440,19,36,.528,18,48,.375,20,22,.909,112,36,71,.507,26,49,.531,10,22,.455,12,22,.545,94
635,MIA,2019-01-12,112,,MEM,W 112-108,240,40,80,.500,25,49,.510,15,31,.484,17,24,.708,112,39,81,.481,30,52,.577,9,29,.310,21,27,.778,108
636,SAC,2019-01-10,112,,DET,W 112-102,240,44,86,.512,35,64,.547,9,22,.409,15,20,.750,112,35,82,.427,24,44,.545,11,38,.289,21,24,.875,102
637,LAL,2019-01-04,112,,NYK,L 112-119,240,43,98,.439,32,61,.525,11,37,.297,15,20,.750,112,37,99,.374,26,62,.419,11,37,.297,34,41,.829,119
638,MIL,2018-12-27,112,,NYK,W 112-96,240,42,93,.452,31,61,.508,11,32,.344,17,21,.810,112,36,97,.371,23,66,.348,13,31,.419,11,16,.688,96
639,OKC,2018-12-23,112,,MIN,L 112-114,240,43,90,.478,34,65,.523,9,25,.360,17,22,.773,112,41,83,.494,27,56,.482,14,27,.519,18,27,.667,114
640,LAL,2018-12-21,112,,NOP,W 112-104,240,43,92,.467,35,60,.583,8,32,.250,18,25,.720,112,44,102,.431,36,75,.480,8,27,.296,8,16,.500,104
641,BRK,2018-12-05,112,,OKC,L 112-114,240,37,86,.430,22,50,.440,15,36,.417,23,30,.767,112,43,99,.434,30,61,.492,13,38,.342,15,26,.577,114
642,POR,2018-11-30,112,,DEN,L 112-113,240,45,85,.529,39,63,.619,6,22,.273,16,21,.762,112,40,87,.460,26,57,.456,14,30,.467,19,26,.731,113
643,SAC,2018-11-25,112,,UTA,L 112-133,240,40,85,.471,31,62,.500,9,23,.391,23,31,.742,112,49,92,.533,39,62,.629,10,30,.333,25,33,.758,133
644,PHI,2018-11-23,112,,CLE,L 112-121,240,40,75,.533,28,42,.667,12,33,.364,20,26,.769,112,49,93,.527,38,71,.535,11,22,.500,12,16,.750,121
645,DEN,2018-11-23,112,,ORL,W 112-87,240,44,93,.473,35,65,.538,9,28,.321,15,17,.882,112,32,79,.405,24,47,.511,8,32,.250,15,19,.789,87
646,LAC,2018-11-23,112,,MEM,W 112-107 (OT),265,40,94,.426,32,71,.451,8,23,.348,24,27,.889,112,42,92,.457,33,65,.508,9,27,.333,14,18,.778,107
647,DAL,2018-11-17,112,,GSW,W 112-109,240,40,86,.465,30,52,.577,10,34,.294,22,34,.647,112,42,94,.447,33,61,.541,9,33,.273,16,17,.941,109
648,MEM,2018-11-16,112,,SAC,W 112-104,240,43,85,.506,32,60,.533,11,25,.440,15,24,.625,112,37,80,.463,25,47,.532,12,33,.364,18,24,.750,104
649,MIN,2018-11-16,112,,POR,W 112-96,240,46,92,.500,34,64,.531,12,28,.429,8,11,.727,112,37,88,.420,29,59,.492,8,29,.276,14,20,.700,96
650,MEM,2018-11-10,112,,PHI,W 112-106 (OT),265,45,103,.437,34,73,.466,11,30,.367,11,15,.733,112,44,85,.518,36,54,.667,8,31,.258,10,16,.625,106
651,TOR,2018-10-24,112,,MIN,W 112-105,240,46,89,.517,35,57,.614,11,32,.344,9,12,.750,112,40,96,.417,25,66,.379,15,30,.500,10,16,.625,105
652,CHI,2018-10-24,112,,CHO,W 112-110,240,37,77,.481,27,48,.563,10,29,.345,28,35,.800,112,37,85,.435,27,50,.540,10,35,.286,26,29,.897,110
653,MIA,2018-10-20,112,,CHO,L 112-113,240,41,89,.461,30,55,.545,11,34,.324,19,27,.704,112,41,93,.441,25,51,.490,16,42,.381,15,23,.652,113
654,WAS,2018-10-18,112,,MIA,L 112-113,240,38,81,.469,31,55,.564,7,26,.269,29,39,.744,112,38,97,.392,26,62,.419,12,35,.343,25,34,.735,113
655,CHO,2018-10-17,112,,MIL,L 112-113,240,41,92,.446,25,54,.463,16,38,.421,14,22,.636,112,42,85,.494,28,51,.549,14,34,.412,15,20,.750,113
656,HOU,2018-10-17,112,,NOP,L 112-131,240,39,92,.424,23,44,.523,16,48,.333,18,24,.750,112,52,98,.531,42,73,.575,10,25,.400,17,22,.773,131
657,SAS,2018-10-17,112,,MIN,W 112-108,240,40,93,.430,29,68,.426,11,25,.440,21,29,.724,112,39,91,.429,33,72,.458,6,19,.316,24,27,.889,108
658,MIN,2019-04-05,111,,MIA,W 111-109,240,43,86,.500,35,62,.565,8,24,.333,17,21,.810,111,45,88,.511,35,54,.648,10,34,.294,9,12,.750,109
659,IND,2019-04-01,111,,DET,W 111-102,240,42,77,.545,32,55,.582,10,22,.455,17,22,.773,111,38,88,.432,26,55,.473,12,33,.364,14,19,.737,102
660,UTA,2019-04-01,111,,CHO,W 111-102,240,38,79,.481,23,44,.523,15,35,.429,20,26,.769,111,36,90,.400,29,60,.483,7,30,.233,23,29,.793,102
661,MIN,2019-03-26,111,,LAC,L 111-122,240,41,94,.436,32,67,.478,9,27,.333,20,33,.606,111,46,85,.541,30,53,.566,16,32,.500,14,14,1.000,122
662,LAL,2019-03-24,111,,SAC,W 111-106,240,39,85,.459,26,45,.578,13,40,.325,20,24,.833,111,39,104,.375,25,71,.352,14,33,.424,14,23,.609,106
663,HOU,2019-03-22,111,,SAS,W 111-105,240,36,86,.419,22,49,.449,14,37,.378,25,32,.781,111,41,90,.456,34,66,.515,7,24,.292,16,17,.941,105
664,SAS,2019-03-18,111,,GSW,W 111-105,240,41,88,.466,31,62,.500,10,26,.385,19,22,.864,111,41,88,.466,28,49,.571,13,39,.333,10,12,.833,105
665,DET,2019-03-15,111,,LAL,W 111-97,240,37,86,.430,20,47,.426,17,39,.436,20,32,.625,111,36,86,.419,30,61,.492,6,25,.240,19,26,.731,97
666,TOR,2019-03-14,111,,LAL,W 111-98,240,36,91,.396,20,50,.400,16,41,.390,23,29,.793,111,38,85,.447,31,54,.574,7,31,.226,15,24,.625,98
667,GSW,2019-03-10,111,,PHO,L 111-115,240,42,95,.442,32,52,.615,10,43,.233,17,22,.773,111,42,86,.488,32,61,.525,10,25,.400,21,27,.778,115
668,ORL,2019-03-08,111,,DAL,W 111-106,240,42,87,.483,28,58,.483,14,29,.483,13,18,.722,111,42,89,.472,32,55,.582,10,34,.294,12,16,.750,106
669,UTA,2019-02-27,111,,LAC,W 111-105,240,38,92,.413,27,58,.466,11,34,.324,24,32,.750,111,37,94,.394,32,68,.471,5,26,.192,26,30,.867,105
670,LAL,2019-02-21,111,,HOU,W 111-106,240,38,86,.442,30,56,.536,8,30,.267,27,33,.818,111,40,88,.455,28,47,.596,12,41,.293,14,15,.933,106
671,CLE,2019-02-21,111,,PHO,W 111-98,240,42,85,.494,29,49,.592,13,36,.361,14,20,.700,111,35,84,.417,25,52,.481,10,32,.313,18,25,.720,98
672,NYK,2019-02-13,111,,PHI,L 111-126,240,40,100,.400,31,71,.437,9,29,.310,22,27,.815,111,42,78,.538,34,55,.618,8,23,.348,34,43,.791,126
673,MIN,2019-01-27,111,,UTA,L 111-125,240,37,77,.481,20,41,.488,17,36,.472,20,23,.870,111,46,86,.535,31,47,.660,15,39,.385,18,25,.720,125
674,BOS,2019-01-26,111,,GSW,L 111-115,240,41,99,.414,26,59,.441,15,40,.375,14,15,.933,111,37,83,.446,25,50,.500,12,33,.364,29,34,.853,115
675,LAL,2019-01-21,111,,GSW,L 111-130,240,42,84,.500,37,64,.578,5,20,.250,22,38,.579,111,50,98,.510,34,61,.557,16,37,.432,14,19,.737,130
676,IND,2019-01-19,111,,DAL,W 111-99,240,42,85,.494,34,61,.557,8,24,.333,19,24,.792,111,37,88,.420,28,51,.549,9,37,.243,16,20,.800,99
677,TOR,2019-01-17,111,,PHO,W 111-109,240,43,86,.500,36,58,.621,7,28,.250,18,25,.720,111,36,84,.429,27,54,.500,9,30,.300,28,36,.778,109
678,DEN,2019-01-15,111,,GSW,L 111-142,240,42,92,.457,28,58,.483,14,34,.412,13,16,.813,111,57,95,.600,36,56,.643,21,39,.538,7,10,.700,142
679,POR,2019-01-07,111,,NYK,W 111-101,240,40,85,.471,29,54,.537,11,31,.355,20,29,.690,111,36,89,.404,29,66,.439,7,23,.304,22,27,.815,101
680,SAC,2019-01-07,111,,ORL,W 111-95,240,45,98,.459,35,64,.547,10,34,.294,11,20,.550,111,32,87,.368,19,50,.380,13,37,.351,18,24,.750,95
681,PHO,2019-01-04,111,,LAC,L 111-121,240,41,77,.532,32,58,.552,9,19,.474,20,27,.741,111,43,84,.512,33,60,.550,10,24,.417,25,32,.781,121
682,ATL,2018-12-29,111,,CLE,W 111-108,240,43,98,.439,33,61,.541,10,37,.270,15,25,.600,111,40,85,.471,35,62,.565,5,23,.217,23,29,.793,108
683,LAC,2018-12-29,111,,SAS,L 111-122,240,36,82,.439,27,62,.435,9,20,.450,30,38,.789,111,44,87,.506,38,64,.594,6,23,.261,28,31,.903,122
684,SAS,2018-12-26,111,,DEN,W 111-103,240,42,90,.467,32,58,.552,10,32,.313,17,22,.773,111,35,90,.389,17,50,.340,18,40,.450,15,23,.652,103
685,BRK,2018-12-23,111,,PHO,W 111-103,240,40,85,.471,30,58,.517,10,27,.370,21,33,.636,111,43,89,.483,40,72,.556,3,17,.176,14,16,.875,103
686,UTA,2018-12-12,111,,MIA,W 111-84,240,40,76,.526,24,44,.545,16,32,.500,15,21,.714,111,29,77,.377,17,44,.386,12,33,.364,14,24,.583,84
687,HOU,2018-12-11,111,,POR,W 111-104,240,42,85,.494,33,56,.589,9,29,.310,18,27,.667,111,38,87,.437,28,62,.452,10,25,.400,18,21,.857,104
688,SAS,2018-12-11,111,,PHO,W 111-86,240,41,83,.494,28,62,.452,13,21,.619,16,19,.842,111,33,82,.402,25,54,.463,8,28,.286,12,14,.857,86
689,DET,2018-12-07,111,,PHI,L 111-117,240,37,89,.416,30,61,.492,7,28,.250,30,37,.811,111,44,90,.489,35,58,.603,9,32,.281,20,21,.952,117
690,DAL,2018-12-04,111,,POR,W 111-102,240,38,88,.432,27,58,.466,11,30,.367,24,35,.686,111,38,84,.452,31,60,.517,7,24,.292,19,23,.826,102
691,ATL,2018-12-03,111,,GSW,L 111-128,240,44,90,.489,39,64,.609,5,26,.192,18,24,.750,111,48,82,.585,35,58,.603,13,24,.542,19,22,.864,128
692,DET,2018-12-01,111,,GSW,W 111-102,240,43,98,.439,31,63,.492,12,35,.343,13,20,.650,111,39,85,.459,33,59,.559,6,26,.231,18,21,.857,102
693,SAC,2018-12-01,111,,IND,W 111-110,240,41,91,.451,28,62,.452,13,29,.448,16,24,.667,111,43,82,.524,33,58,.569,10,24,.417,14,18,.778,110
694,CHO,2018-11-30,111,,UTA,L 111-119,240,47,95,.495,38,67,.567,9,28,.321,8,13,.615,111,44,81,.543,26,41,.634,18,40,.450,13,18,.722,119
695,MIN,2018-11-24,111,,CHI,W 111-96,240,42,103,.408,35,69,.507,7,34,.206,20,23,.870,111,32,81,.395,22,48,.458,10,33,.303,22,31,.710,96
696,ORL,2018-11-14,111,,PHI,W 111-106,240,40,80,.500,28,52,.538,12,28,.429,19,22,.864,111,41,86,.477,27,57,.474,14,29,.483,10,15,.667,106
697,BOS,2018-11-14,111,,CHI,W 111-82,240,42,90,.467,27,56,.482,15,34,.441,12,14,.857,111,33,84,.393,26,61,.426,7,23,.304,9,9,1.000,82
698,DAL,2018-11-10,111,,OKC,W 111-96,240,43,77,.558,29,48,.604,14,29,.483,11,17,.647,111,38,97,.392,29,63,.460,9,34,.265,11,18,.611,96
699,GSW,2018-11-08,111,,MIL,L 111-134,240,42,87,.483,32,59,.542,10,28,.357,17,22,.773,111,52,101,.515,43,66,.652,9,35,.257,21,27,.778,134
700,UTA,2018-11-05,111,,TOR,L 111-124,240,38,86,.442,30,55,.545,8,31,.258,27,41,.659,111,49,86,.570,36,53,.679,13,33,.394,13,14,.929,124
701,POR,2018-11-04,111,,MIN,W 111-81,240,38,86,.442,31,58,.534,7,28,.250,28,32,.875,111,29,93,.312,22,63,.349,7,30,.233,16,21,.762,81
702,WAS,2018-11-02,111,,OKC,L 111-134,240,44,86,.512,35,56,.625,9,30,.300,14,18,.778,111,49,86,.570,34,54,.630,15,32,.469,21,26,.808,134
703,BRK,2018-11-02,111,,HOU,L 111-119,240,42,85,.494,27,51,.529,15,34,.441,12,20,.600,111,41,83,.494,26,44,.591,15,39,.385,22,32,.688,119
704,NOP,2018-10-27,111,,UTA,L 111-132,240,40,95,.421,31,61,.508,9,34,.265,22,29,.759,111,46,88,.523,36,56,.643,10,32,.313,30,37,.811,132
705,ATL,2018-10-24,111,,DAL,W 111-104,240,37,91,.407,22,53,.415,15,38,.395,22,31,.710,111,38,91,.418,26,51,.510,12,40,.300,16,26,.615,104
706,CLE,2018-10-21,111,,ATL,L 111-133,240,46,99,.465,36,72,.500,10,27,.370,9,14,.643,111,48,98,.490,26,51,.510,22,47,.468,15,19,.789,133
707,IND,2018-10-17,111,,MEM,W 111-83,240,47,83,.566,37,57,.649,10,26,.385,7,13,.538,111,25,84,.298,15,55,.273,10,29,.345,23,28,.821,83
708,WAS,2019-04-09,110,,BOS,L 110-116,240,41,97,.423,27,58,.466,14,39,.359,14,18,.778,110,45,99,.455,30,55,.545,15,44,.341,11,23,.478,116
709,BOS,2019-04-01,110,,MIA,W 110-105,240,36,91,.396,19,51,.373,17,40,.425,21,24,.875,110,40,88,.455,30,51,.588,10,37,.270,15,18,.833,105
710,BRK,2019-03-30,110,,BOS,W 110-96,240,38,83,.458,26,45,.578,12,38,.316,22,28,.786,110,35,83,.422,27,63,.429,8,20,.400,18,23,.783,96
711,DET,2019-03-17,110,,TOR,W 110-107,240,39,83,.470,31,56,.554,8,27,.296,24,27,.889,110,39,82,.476,21,46,.457,18,36,.500,11,14,.786,107
712,NOP,2019-03-15,110,,POR,L 110-122,240,45,94,.479,37,64,.578,8,30,.267,12,25,.480,110,43,96,.448,33,69,.478,10,27,.370,26,32,.813,122
713,WAS,2019-03-15,110,,CHO,L 110-116,240,41,84,.488,28,50,.560,13,34,.382,15,19,.789,110,46,101,.455,32,70,.457,14,31,.452,10,12,.833,116
714,DAL,2019-02-27,110,,IND,W 110-101,240,40,81,.494,24,44,.545,16,37,.432,14,23,.609,110,37,77,.481,27,49,.551,10,28,.357,17,21,.810,101
715,CHO,2019-02-25,110,,GSW,L 110-121,240,40,91,.440,33,58,.569,7,33,.212,23,26,.885,110,48,95,.505,34,54,.630,14,41,.341,11,13,.846,121
716,MEM,2019-02-25,110,,LAL,W 110-105,240,41,93,.441,32,57,.561,9,36,.250,19,23,.826,110,40,89,.449,30,62,.484,10,27,.370,15,20,.750,105
717,CLE,2019-02-25,110,,POR,L 110-123,240,37,89,.416,24,55,.436,13,34,.382,23,26,.885,110,44,78,.564,26,49,.531,18,29,.621,17,22,.773,123
718,NOP,2019-02-25,110,,PHI,L 110-111,240,44,104,.423,39,76,.513,5,28,.179,17,24,.708,110,44,101,.436,34,70,.486,10,31,.323,13,19,.684,111
719,PHO,2019-02-04,110,,HOU,L 110-118,240,45,84,.536,38,59,.644,7,25,.280,13,18,.722,110,43,87,.494,30,46,.652,13,41,.317,19,25,.760,118
720,IND,2019-01-23,110,,TOR,W 110-106,240,40,92,.435,31,66,.470,9,26,.346,21,25,.840,110,38,92,.413,26,53,.491,12,39,.308,18,23,.783,106
721,NYK,2019-01-23,110,,HOU,L 110-114,240,37,81,.457,26,51,.510,11,30,.367,25,30,.833,110,37,90,.411,26,46,.565,11,44,.250,29,38,.763,114
722,MIN,2019-01-12,110,,NOP,W 110-106,240,40,93,.430,29,54,.537,11,39,.282,19,24,.792,110,40,87,.460,35,63,.556,5,24,.208,21,24,.875,106
723,UTA,2019-01-12,110,,CHI,W 110-102,240,38,88,.432,22,43,.512,16,45,.356,18,25,.720,110,40,97,.412,33,72,.458,7,25,.280,15,17,.882,102
724,POR,2019-01-05,110,,HOU,W 110-101,240,43,94,.457,34,66,.515,9,28,.321,15,20,.750,110,39,84,.464,26,46,.565,13,38,.342,10,12,.833,101
725,CHO,2018-12-19,110,,CLE,W 110-99,240,47,92,.511,37,67,.552,10,25,.400,6,9,.667,110,41,85,.482,31,62,.500,10,23,.435,7,12,.583,99
726,NYK,2018-12-17,110,,PHO,L 110-128,240,40,99,.404,31,64,.484,9,35,.257,21,29,.724,110,48,92,.522,39,65,.600,9,27,.333,23,27,.852,128
727,GSW,2018-12-17,110,,MEM,W 110-93,240,37,85,.435,25,54,.463,12,31,.387,24,27,.889,110,36,79,.456,29,54,.537,7,25,.280,14,18,.778,93
728,IND,2018-12-16,110,,NYK,W 110-99,240,40,87,.460,28,53,.528,12,34,.353,18,23,.783,110,37,89,.416,27,57,.474,10,32,.313,15,22,.682,99
729,OKC,2018-12-15,110,,LAC,W 110-104,240,42,90,.467,33,68,.485,9,22,.409,17,24,.708,110,38,75,.507,25,50,.500,13,25,.520,15,22,.682,104
730,SAS,2018-12-09,110,,UTA,W 110-97,240,47,89,.528,42,75,.560,5,14,.357,11,12,.917,110,37,85,.435,28,56,.500,9,29,.310,14,19,.737,97
731,CLE,2018-12-07,110,,SAC,L 110-129,240,43,81,.531,33,55,.600,10,26,.385,14,19,.737,110,56,98,.571,43,69,.623,13,29,.448,4,7,.571,129
732,CHO,2018-11-26,110,,MIL,W 110-107,240,38,81,.469,25,52,.481,13,29,.448,21,30,.700,110,37,90,.411,21,44,.477,16,46,.348,17,21,.810,107
733,UTA,2018-11-21,110,,SAC,L 110-119,240,38,88,.432,26,49,.531,12,39,.308,22,31,.710,110,47,89,.528,36,64,.563,11,25,.440,14,19,.737,119
734,GSW,2018-11-13,110,,ATL,W 110-103,240,39,91,.429,27,64,.422,12,27,.444,20,21,.952,110,40,89,.449,28,57,.491,12,32,.375,11,15,.733,103
735,TOR,2018-11-12,110,,NOP,L 110-126,240,39,97,.402,26,52,.500,13,45,.289,19,22,.864,110,54,99,.545,44,72,.611,10,27,.370,8,13,.615,126
736,MIA,2018-11-10,110,,WAS,L 110-116,240,39,88,.443,27,55,.491,12,33,.364,20,26,.769,110,40,83,.482,32,61,.525,8,22,.364,28,38,.737,116
737,DEN,2018-11-09,110,,BRK,L 110-112,240,40,87,.460,35,69,.507,5,18,.278,25,34,.735,110,36,88,.409,24,55,.436,12,33,.364,28,42,.667,112
738,SAS,2018-11-04,110,,ORL,L 110-117,240,38,88,.432,26,53,.491,12,35,.343,22,25,.880,110,46,91,.505,34,59,.576,12,32,.375,13,18,.722,117
739,POR,2018-11-03,110,,LAL,L 110-114,240,44,104,.423,38,69,.551,6,35,.171,16,22,.727,110,45,86,.523,37,65,.569,8,21,.381,16,25,.640,114
740,SAS,2018-10-27,110,,LAL,W 110-106,240,44,91,.484,41,75,.547,3,16,.188,19,24,.792,110,41,86,.477,28,53,.528,13,33,.394,11,18,.611,106
741,DET,2018-10-25,110,,CLE,W 110-103,240,41,78,.526,30,50,.600,11,28,.393,17,29,.586,110,41,89,.461,33,65,.508,8,24,.333,13,15,.867,103
742,MIA,2018-10-24,110,,NYK,W 110-87,240,39,82,.476,26,53,.491,13,29,.448,19,28,.679,110,33,91,.363,21,58,.362,12,33,.364,9,14,.643,87
743,NOP,2019-04-03,109,,CHO,L 109-115,240,40,85,.471,25,44,.568,15,41,.366,14,17,.824,109,38,90,.422,26,56,.464,12,34,.353,27,32,.844,115
744,MIN,2019-03-30,109,,PHI,L 109-118,240,39,86,.453,28,60,.467,11,26,.423,20,25,.800,109,44,94,.468,29,63,.460,15,31,.484,15,21,.714,118
745,TOR,2019-03-22,109,,OKC,L 109-116,240,39,78,.500,26,53,.491,13,25,.520,18,21,.857,109,42,94,.447,22,51,.431,20,43,.465,12,14,.857,116
746,SAS,2019-03-15,109,,NYK,W 109-83,240,47,88,.534,40,67,.597,7,21,.333,8,10,.800,109,35,86,.407,27,66,.409,8,20,.400,5,9,.556,83
747,SAC,2019-03-06,109,,BOS,L 109-111,240,40,80,.500,27,51,.529,13,29,.448,16,22,.727,109,40,79,.506,27,46,.587,13,33,.394,18,21,.857,111
748,SAC,2019-03-01,109,,LAC,L 109-116,240,41,93,.441,35,72,.486,6,21,.286,21,25,.840,109,40,92,.435,28,61,.459,12,31,.387,24,33,.727,116
749,ORL,2019-02-22,109,,CHI,L 109-110,240,41,81,.506,27,47,.574,14,34,.412,13,24,.542,109,40,90,.444,28,61,.459,12,29,.414,18,19,.947,110
750,PHI,2019-02-12,109,,BOS,L 109-112,240,39,80,.488,30,53,.566,9,27,.333,22,31,.710,109,41,88,.466,28,59,.475,13,29,.448,17,21,.810,112
751,BRK,2019-01-25,109,,NYK,W 109-99,240,34,84,.405,25,51,.490,9,33,.273,32,47,.681,109,37,87,.425,29,56,.518,8,31,.258,17,26,.654,99
752,NYK,2019-01-21,109,,OKC,L 109-127,240,39,87,.448,32,64,.500,7,23,.304,24,32,.750,109,45,83,.542,30,54,.556,15,29,.517,22,27,.815,127
753,LAC,2019-01-16,109,,UTA,L 109-129,240,45,98,.459,35,76,.461,10,22,.455,9,14,.643,109,44,86,.512,33,53,.623,11,33,.333,30,37,.811,129
754,BRK,2019-01-14,109,,BOS,W 109-102,240,37,86,.430,24,48,.500,13,38,.342,22,25,.880,109,37,91,.407,26,55,.473,11,36,.306,17,23,.739,102
755,HOU,2019-01-09,109,,MIL,L 109-116,240,32,85,.376,14,37,.378,18,48,.375,27,32,.844,109,44,91,.484,36,64,.563,8,27,.296,20,24,.833,116
756,POR,2019-01-04,109,,OKC,L 109-111,240,41,95,.432,32,64,.500,9,31,.290,18,21,.857,109,40,94,.426,32,69,.464,8,25,.320,23,26,.885,111
757,PHO,2018-12-31,109,,GSW,L 109-132,240,37,85,.435,28,59,.475,9,26,.346,26,30,.867,109,46,84,.548,32,56,.571,14,28,.500,26,32,.813,132
758,ORL,2018-12-30,109,,DET,W 109-107,240,40,85,.471,33,61,.541,7,24,.292,22,24,.917,109,39,92,.424,31,61,.508,8,31,.258,21,23,.913,107
759,GSW,2018-12-27,109,,POR,L 109-110 (OT),265,45,106,.425,32,62,.516,13,44,.295,6,15,.400,109,38,105,.362,25,65,.385,13,40,.325,21,23,.913,110
760,DEN,2018-12-14,109,,OKC,W 109-98,240,42,83,.506,31,49,.633,11,34,.324,14,15,.933,109,37,90,.411,30,71,.423,7,19,.368,17,29,.586,98
761,IND,2018-12-10,109,,WAS,W 109-101,240,41,76,.539,31,56,.554,10,20,.500,17,22,.773,109,37,88,.420,27,58,.466,10,30,.333,17,24,.708,101
762,CHO,2018-12-02,109,,NOP,L 109-119,240,39,91,.429,29,55,.527,10,36,.278,21,28,.750,109,44,86,.512,33,54,.611,11,32,.344,20,24,.833,119
763,MIN,2018-12-01,109,,BOS,L 109-118,240,37,82,.451,28,54,.519,9,28,.321,26,32,.813,109,40,85,.471,23,41,.561,17,44,.386,21,21,1.000,118
764,OKC,2018-11-23,109,,CHO,W 109-104,240,41,93,.441,30,60,.500,11,33,.333,16,24,.667,109,43,94,.457,37,63,.587,6,31,.194,12,14,.857,104
765,BOS,2018-11-21,109,,NYK,L 109-117,240,38,97,.392,28,64,.438,10,33,.303,23,32,.719,109,44,89,.494,29,59,.492,15,30,.500,14,17,.824,117
766,WAS,2018-11-18,109,,POR,L 109-119,240,43,96,.448,30,64,.469,13,32,.406,10,21,.476,109,39,86,.453,28,56,.500,11,30,.367,30,35,.857,119
767,ATL,2018-11-09,109,,DET,L 109-124,240,36,79,.456,29,51,.569,7,28,.250,30,40,.750,109,46,97,.474,26,50,.520,20,47,.426,12,19,.632,124
768,PHO,2018-11-08,109,,BOS,L 109-116 (OT),265,41,93,.441,30,58,.517,11,35,.314,16,19,.842,109,39,97,.402,25,60,.417,14,37,.378,24,31,.774,116
769,PHI,2018-11-03,109,,DET,W 109-99,240,28,69,.406,19,40,.475,9,29,.310,44,51,.863,109,33,83,.398,28,53,.528,5,30,.167,28,41,.683,99
770,SAS,2018-11-03,109,,NOP,W 109-95,240,45,96,.469,37,73,.507,8,23,.348,11,14,.786,109,36,77,.468,30,56,.536,6,21,.286,17,30,.567,95
771,BOS,2019-04-07,108,,ORL,L 108-116,240,42,89,.472,30,58,.517,12,31,.387,12,14,.857,108,41,90,.456,29,57,.509,12,33,.364,22,22,1.000,116
772,DAL,2019-04-03,108,,MIN,L 108-110,240,43,94,.457,36,55,.655,7,39,.179,15,19,.789,108,42,86,.488,32,59,.542,10,27,.370,16,20,.800,110
773,MIL,2019-03-26,108,,HOU,W 108-94,240,42,94,.447,28,60,.467,14,34,.412,10,13,.769,108,36,99,.364,20,47,.426,16,52,.308,6,7,.857,94
774,WAS,2019-03-23,108,,MIA,L 108-113,240,41,96,.427,32,66,.485,9,30,.300,17,23,.739,108,44,88,.500,32,49,.653,12,39,.308,13,19,.684,113
775,CLE,2019-03-22,108,,LAC,L 108-110,240,43,90,.478,31,59,.525,12,31,.387,10,13,.769,108,42,82,.512,36,56,.643,6,26,.231,20,23,.870,110
776,WAS,2019-03-21,108,,DEN,L 108-113,240,40,79,.506,32,51,.627,8,28,.286,20,21,.952,108,46,87,.529,32,57,.561,14,30,.467,7,11,.636,113
777,SAS,2019-03-16,108,,POR,W 108-103,240,37,79,.468,29,62,.468,8,17,.471,26,30,.867,108,42,101,.416,35,73,.479,7,28,.250,12,14,.857,103
778,HOU,2019-03-15,108,,PHO,W 108-102,240,36,83,.434,25,43,.581,11,40,.275,25,33,.758,108,38,89,.427,31,63,.492,7,26,.269,19,25,.760,102
779,IND,2019-03-14,108,,OKC,W 108-106,240,37,82,.451,30,60,.500,7,22,.318,27,32,.844,108,38,86,.442,24,56,.429,14,30,.467,16,20,.800,106
780,MIA,2019-03-13,108,,DET,W 108-74,240,39,84,.464,28,56,.500,11,28,.393,19,24,.792,108,27,77,.351,19,40,.475,8,37,.216,12,18,.667,74
781,OKC,2019-03-13,108,,BRK,W 108-96,240,41,96,.427,30,68,.441,11,28,.393,15,19,.789,108,35,84,.417,22,49,.449,13,35,.371,13,19,.684,96
782,CHI,2019-03-06,108,,PHI,W 108-107,240,41,93,.441,35,70,.500,6,23,.261,20,27,.741,108,40,87,.460,32,63,.508,8,24,.333,19,24,.792,107
783,CHO,2019-03-03,108,,POR,L 108-118,240,37,83,.446,23,50,.460,14,33,.424,20,23,.870,108,43,96,.448,32,64,.500,11,32,.344,21,23,.913,118
784,NYK,2019-02-26,108,,ORL,W 108-103,240,38,89,.427,31,65,.477,7,24,.292,25,32,.781,108,39,89,.438,28,57,.491,11,32,.344,14,20,.700,103
785,ATL,2019-02-10,108,,ORL,L 108-124,240,37,80,.463,24,48,.500,13,32,.406,21,25,.840,108,43,91,.473,30,54,.556,13,37,.351,25,28,.893,124
786,POR,2019-02-05,108,,MIA,L 108-118,240,42,93,.452,27,54,.500,15,39,.385,9,12,.750,108,45,83,.542,38,61,.623,7,22,.318,21,25,.840,118
787,MEM,2019-02-05,108,,MIN,W 108-106,240,36,86,.419,21,52,.404,15,34,.441,21,29,.724,108,39,87,.448,30,58,.517,9,29,.310,19,20,.950,106
788,MIL,2019-01-25,108,,CHO,W 108-99,240,41,89,.461,35,58,.603,6,31,.194,20,23,.870,108,36,90,.400,26,51,.510,10,39,.256,17,25,.680,99
789,ORL,2019-01-19,108,,MIL,L 108-118,240,44,93,.473,30,61,.492,14,32,.438,6,9,.667,108,47,85,.553,35,55,.636,12,30,.400,12,15,.800,118
790,MIN,2019-01-06,108,,LAL,W 108-86,240,41,89,.461,30,57,.526,11,32,.344,15,21,.714,108,32,87,.368,27,65,.415,5,22,.227,17,28,.607,86
791,SAS,2019-01-05,108,,MEM,W 108-88,240,36,73,.493,29,51,.569,7,22,.318,29,35,.829,108,31,82,.378,20,54,.370,11,28,.393,15,19,.789,88
792,SAC,2019-01-01,108,,POR,L 108-113 (OT),265,44,115,.383,33,82,.402,11,33,.333,9,12,.750,108,39,90,.433,30,58,.517,9,32,.281,26,30,.867,113
793,HOU,2018-12-22,108,,SAS,W 108-101,240,37,95,.389,18,41,.439,19,54,.352,15,21,.714,108,42,88,.477,32,64,.500,10,24,.417,7,11,.636,101
794,UTA,2018-12-19,108,,GSW,W 108-103,240,37,93,.398,21,51,.412,16,42,.381,18,22,.818,108,38,95,.400,28,64,.438,10,31,.323,17,18,.944,103
795,CHO,2018-12-12,108,,DET,W 108-107,240,35,85,.412,26,57,.456,9,28,.321,29,37,.784,108,40,86,.465,27,52,.519,13,34,.382,14,21,.667,107
796,LAL,2018-12-10,108,,MIA,W 108-105,240,41,90,.456,27,58,.466,14,32,.438,12,20,.600,108,42,94,.447,31,60,.517,11,34,.324,10,13,.769,105
797,MIL,2018-12-10,108,,CLE,W 108-92,240,42,96,.438,27,60,.450,15,36,.417,9,11,.818,108,36,96,.375,26,66,.394,10,30,.333,10,15,.667,92
798,DET,2018-12-09,108,,NOP,L 108-116,240,43,98,.439,34,69,.493,9,29,.310,13,24,.542,108,42,79,.532,30,49,.612,12,30,.400,20,23,.870,116
799,POR,2018-12-06,108,,PHO,W 108-86,240,41,85,.482,32,58,.552,9,27,.333,17,27,.630,108,35,91,.385,30,64,.469,5,27,.185,11,14,.786,86
800,CHO,2018-11-28,108,,ATL,W 108-94,240,38,83,.458,34,63,.540,4,20,.200,28,37,.757,108,32,93,.344,21,49,.429,11,44,.250,19,22,.864,94
801,CHO,2018-11-28,108,,ATL,W 108-94,240,38,83,.458,34,63,.540,4,20,.200,28,37,.757,108,32,93,.344,21,49,.429,11,44,.250,19,22,.864,94
802,ATL,2018-11-21,108,,TOR,L 108-124,240,42,93,.452,32,57,.561,10,36,.278,14,18,.778,108,48,90,.533,37,61,.607,11,29,.379,17,23,.739,124
803,WAS,2018-11-04,108,,NYK,W 108-95,240,36,83,.434,30,57,.526,6,26,.231,30,39,.769,108,39,93,.419,34,66,.515,5,27,.185,12,16,.750,95
804,BOS,2018-10-30,108,,DET,W 108-105,240,37,84,.440,28,53,.528,9,31,.290,25,32,.781,108,37,88,.420,29,58,.500,8,30,.267,23,27,.852,105
805,LAC,2018-10-19,108,,OKC,W 108-92,240,35,81,.432,24,55,.436,11,26,.423,27,36,.750,108,34,95,.358,27,62,.435,7,33,.212,17,23,.739,92
806,GSW,2018-10-16,108,,OKC,W 108-100,240,42,95,.442,35,69,.507,7,26,.269,17,18,.944,108,33,91,.363,23,54,.426,10,37,.270,24,37,.649,100
807,OKC,2019-03-27,107,,IND,W 107-99,240,41,92,.446,28,56,.500,13,36,.361,12,19,.632,107,40,92,.435,27,61,.443,13,31,.419,6,11,.545,99
808,CLE,2019-03-20,107,,MIL,W 107-102,240,39,93,.419,28,54,.519,11,39,.282,18,24,.750,107,36,91,.396,23,59,.390,13,32,.406,17,21,.810,102
809,MIN,2019-03-19,107,,GSW,L 107-117,240,36,89,.404,27,53,.509,9,36,.250,26,32,.813,107,44,91,.484,25,49,.510,19,42,.452,10,14,.714,117
810,OKC,2019-03-18,107,,MIA,L 107-116,240,38,87,.437,28,50,.560,10,37,.270,21,27,.778,107,46,97,.474,37,68,.544,9,29,.310,15,16,.938,116
811,CHI,2019-03-12,107,,LAL,L 107-123,240,42,91,.462,31,64,.484,11,27,.407,12,12,1.000,107,47,86,.547,34,53,.642,13,33,.394,16,20,.800,123
812,LAL,2019-03-09,107,,BOS,L 107-120,240,44,91,.484,39,64,.609,5,27,.185,14,18,.778,107,48,93,.516,34,55,.618,14,38,.368,10,14,.714,120
813,HOU,2019-03-08,107,,PHI,W 107-91,240,42,85,.494,29,44,.659,13,41,.317,10,15,.667,107,35,95,.368,32,69,.464,3,26,.115,18,23,.783,91
814,PHO,2019-03-06,107,,NYK,W 107-96,240,39,81,.481,27,52,.519,12,29,.414,17,22,.773,107,35,77,.455,29,62,.468,6,15,.400,20,25,.800,96
815,CLE,2019-03-03,107,,ORL,W 107-93,240,36,83,.434,22,40,.550,14,43,.326,21,23,.913,107,39,88,.443,33,62,.532,6,26,.231,9,11,.818,93
816,BOS,2019-03-01,107,,WAS,W 107-96,240,42,94,.447,32,59,.542,10,35,.286,13,17,.765,107,36,89,.404,26,51,.510,10,38,.263,14,19,.737,96
817,MEM,2019-02-27,107,,CHI,L 107-109,240,41,94,.436,32,67,.478,9,27,.333,16,18,.889,107,39,82,.476,31,58,.534,8,24,.333,23,25,.920,109
818,MEM,2019-02-12,107,,SAS,L 107-108,240,44,89,.494,36,65,.554,8,24,.333,11,16,.688,107,36,86,.419,23,65,.354,13,21,.619,23,29,.793,108
819,CLE,2019-02-11,107,,NYK,W 107-104,240,38,95,.400,24,51,.471,14,44,.318,17,19,.895,107,42,92,.457,35,66,.530,7,26,.269,13,20,.650,104
820,DAL,2019-02-08,107,,MIL,L 107-122,240,36,87,.414,14,34,.412,22,53,.415,13,20,.650,107,51,93,.548,41,57,.719,10,36,.278,10,12,.833,122
821,PHO,2019-02-08,107,,GSW,L 107-117,240,39,101,.386,33,70,.471,6,31,.194,23,30,.767,107,41,81,.506,31,52,.596,10,29,.345,25,35,.714,117
822,PHI,2019-02-05,107,,TOR,L 107-119,240,31,70,.443,24,46,.522,7,24,.292,38,41,.927,107,41,89,.461,30,58,.517,11,31,.355,26,32,.813,119
823,NOP,2019-02-04,107,,IND,L 107-109,240,39,90,.433,30,52,.577,9,38,.237,20,24,.833,107,41,91,.451,31,63,.492,10,28,.357,17,24,.708,109
824,ORL,2019-01-31,107,,IND,W 107-100,240,38,82,.463,27,57,.474,11,25,.440,20,22,.909,107,41,91,.451,37,72,.514,4,19,.211,14,16,.875,100
825,WAS,2019-01-30,107,,IND,W 107-89,240,41,78,.526,29,50,.580,12,28,.429,13,21,.619,107,33,84,.393,24,53,.453,9,31,.290,14,18,.778,89
826,MEM,2019-01-23,107,,CHO,L 107-118,240,38,81,.469,29,50,.580,9,31,.290,22,24,.917,107,41,77,.532,29,47,.617,12,30,.400,24,31,.774,118
827,BOS,2019-01-21,107,,MIA,W 107-99,240,43,87,.494,31,57,.544,12,30,.400,9,10,.900,107,36,86,.419,25,51,.490,11,35,.314,16,18,.889,99
828,LAL,2019-01-15,107,,CHI,W 107-100,240,38,82,.463,30,56,.536,8,26,.308,23,34,.676,107,37,92,.402,28,61,.459,9,31,.290,17,24,.708,100
829,DET,2019-01-07,107,,SAS,L 107-119,240,42,85,.494,33,53,.623,9,32,.281,14,17,.824,107,43,79,.544,36,59,.610,7,20,.350,26,32,.813,119
830,LAL,2018-12-28,107,,LAC,L 107-118,240,36,87,.414,25,57,.439,11,30,.367,24,35,.686,107,40,91,.440,34,72,.472,6,19,.316,32,34,.941,118
831,NYK,2018-12-21,107,,ATL,L 107-114,240,41,84,.488,33,57,.579,8,27,.296,17,24,.708,107,43,91,.473,33,62,.532,10,29,.345,18,24,.750,114
832,BOS,2018-12-21,107,,MIL,L 107-120,240,35,91,.385,25,57,.439,10,34,.294,27,36,.750,107,41,80,.513,25,40,.625,16,40,.400,22,28,.786,120
833,PHO,2018-12-15,107,,MIN,W 107-99,240,41,90,.456,32,62,.516,9,28,.321,16,20,.800,107,39,96,.406,32,61,.525,7,35,.200,14,19,.737,99
834,NYK,2018-12-09,107,,CHO,L 107-119,240,44,93,.473,31,67,.463,13,26,.500,6,7,.857,107,42,87,.483,30,53,.566,12,34,.353,23,27,.852,119
835,DAL,2018-12-08,107,,HOU,W 107-104,240,41,83,.494,29,53,.547,12,30,.400,13,16,.813,107,39,86,.453,24,39,.615,15,47,.319,11,13,.846,104
836,IND,2018-12-08,107,,SAC,W 107-97,240,40,92,.435,32,62,.516,8,30,.267,19,22,.864,107,38,90,.422,29,58,.500,9,32,.281,12,15,.800,97
837,NYK,2018-12-03,107,,WAS,L 107-110,240,37,90,.411,25,56,.446,12,34,.353,21,28,.750,107,44,92,.478,31,60,.517,13,32,.406,9,12,.750,110
838,DET,2018-11-30,107,,CHI,W 107-88,240,41,92,.446,28,58,.483,13,34,.382,12,16,.750,107,37,86,.430,34,65,.523,3,21,.143,11,14,.786,88
839,NOP,2018-11-26,107,,BOS,L 107-124,240,34,77,.442,22,45,.489,12,32,.375,27,29,.931,107,48,97,.495,29,58,.500,19,39,.487,9,10,.900,124
840,CHI,2018-11-26,107,,SAS,L 107-108,240,42,90,.467,28,57,.491,14,33,.424,9,11,.818,107,45,93,.484,35,63,.556,10,30,.333,8,9,.889,108
841,HOU,2018-11-15,107,,GSW,W 107-86,240,35,87,.402,19,40,.475,16,47,.340,21,26,.808,107,32,76,.421,28,58,.483,4,18,.222,18,22,.818,86
842,MIN,2018-11-14,107,,NOP,W 107-100,240,37,90,.411,23,58,.397,14,32,.438,19,24,.792,107,40,94,.426,31,66,.470,9,28,.321,11,18,.611,100
843,BRK,2018-11-14,107,,MIA,L 107-120,240,41,101,.406,33,73,.452,8,28,.286,17,24,.708,107,46,85,.541,38,56,.679,8,29,.276,20,28,.714,120
844,LAL,2018-11-11,107,,ATL,W 107-106,240,39,92,.424,25,54,.463,14,38,.368,15,24,.625,107,41,95,.432,28,58,.483,13,37,.351,11,13,.846,106
845,ATL,2018-11-07,107,,NYK,L 107-112,240,37,92,.402,26,54,.481,11,38,.289,22,29,.759,107,34,77,.442,23,47,.489,11,30,.367,33,47,.702,112
846,NOP,2018-11-07,107,,CHI,W 107-98,240,42,94,.447,31,64,.484,11,30,.367,12,17,.706,107,38,96,.396,29,65,.446,9,31,.290,13,17,.765,98
847,LAL,2018-11-04,107,,TOR,L 107-121,240,39,85,.459,33,61,.541,6,24,.250,23,29,.793,107,49,98,.500,39,63,.619,10,35,.286,13,14,.929,121
848,CHO,2018-11-01,107,,OKC,L 107-111,240,38,93,.409,27,52,.519,11,41,.268,20,22,.909,107,41,96,.427,33,59,.559,8,37,.216,21,29,.724,111
849,CHI,2018-10-31,107,,DEN,L 107-108 (OT),265,39,92,.424,23,58,.397,16,34,.471,13,18,.722,107,45,99,.455,38,73,.521,7,26,.269,11,18,.611,108
850,MEM,2018-10-30,107,,WAS,W 107-95,240,36,74,.486,23,46,.500,13,28,.464,22,31,.710,107,32,74,.432,18,39,.462,14,35,.400,17,20,.850,95
851,CLE,2018-10-27,107,,IND,L 107-119,240,40,86,.465,33,61,.541,7,25,.280,20,22,.909,107,48,74,.649,43,61,.705,5,13,.385,18,26,.692,119
852,BRK,2018-10-19,107,,NYK,W 107-105,240,37,75,.493,25,45,.556,12,30,.400,21,24,.875,107,39,97,.402,30,69,.435,9,28,.321,18,20,.900,105
853,SAS,2019-03-31,106,,SAC,L 106-113,240,44,94,.468,36,67,.537,8,27,.296,10,14,.714,106,39,81,.481,28,56,.500,11,25,.440,24,28,.857,113
854,CLE,2019-03-26,106,,BOS,L 106-116,240,39,80,.488,30,52,.577,9,28,.321,19,25,.760,106,46,91,.505,36,66,.545,10,25,.400,14,19,.737,116
855,LAL,2019-03-22,106,,BRK,L 106-111,240,37,96,.385,28,60,.467,9,36,.250,23,32,.719,106,37,92,.402,21,50,.420,16,42,.381,21,28,.750,111
856,POR,2019-03-18,106,,IND,W 106-98,240,37,79,.468,24,47,.511,13,32,.406,19,21,.905,106,35,83,.422,25,59,.424,10,24,.417,18,22,.818,98
857,PHI,2019-03-12,106,,CLE,W 106-99,240,42,85,.494,34,62,.548,8,23,.348,14,17,.824,106,40,101,.396,27,63,.429,13,38,.342,6,8,.750,99
858,PHI,2019-03-10,106,,IND,W 106-89,240,38,87,.437,31,64,.484,7,23,.304,23,30,.767,106,31,83,.373,26,67,.388,5,16,.313,22,37,.595,89
859,CHI,2019-02-25,106,,MIL,L 106-117,240,41,92,.446,32,66,.485,9,26,.346,15,22,.682,106,42,91,.462,25,42,.595,17,49,.347,16,23,.696,117
860,MEM,2019-02-22,106,,LAC,L 106-112,240,33,90,.367,24,58,.414,9,32,.281,31,36,.861,106,35,75,.467,29,50,.580,6,25,.240,36,42,.857,112
861,PHI,2019-02-21,106,,MIA,W 106-102,240,37,82,.451,30,56,.536,7,26,.269,25,35,.714,106,45,94,.479,39,72,.542,6,22,.273,6,12,.500,102
862,BRK,2019-02-08,106,,CHI,L 106-125,240,39,94,.415,26,53,.491,13,41,.317,15,16,.938,106,46,85,.541,32,57,.561,14,28,.500,19,24,.792,125
863,MIN,2019-02-02,106,,DEN,L 106-107,240,42,89,.472,31,55,.564,11,34,.324,11,16,.688,106,42,89,.472,29,56,.518,13,33,.394,10,14,.714,107
864,MEM,2019-01-26,106,,IND,W 106-103,240,39,80,.488,30,52,.577,9,28,.321,19,28,.679,106,32,74,.432,23,47,.489,9,27,.333,30,36,.833,103
865,DAL,2019-01-25,106,,DET,W 106-101,240,37,81,.457,23,45,.511,14,36,.389,18,30,.600,106,35,85,.412,23,47,.489,12,38,.316,19,25,.760,101
866,UTA,2019-01-25,106,,MIN,W 106-102,240,37,94,.394,24,54,.444,13,40,.325,19,25,.760,106,38,90,.422,30,64,.469,8,26,.308,18,21,.857,102
867,PHO,2019-01-24,106,,POR,L 106-120,240,36,88,.409,23,50,.460,13,38,.342,21,27,.778,106,44,94,.468,32,68,.471,12,26,.462,20,20,1.000,120
868,DAL,2019-01-22,106,,LAC,W 106-98,240,38,81,.469,28,47,.596,10,34,.294,20,29,.690,106,33,91,.363,23,55,.418,10,36,.278,22,29,.759,98
869,NYK,2019-01-11,106,,IND,L 106-121,240,39,88,.443,25,49,.510,14,39,.359,14,16,.875,106,49,94,.521,37,68,.544,12,26,.462,11,11,1.000,121
870,UTA,2019-01-09,106,,ORL,W 106-93,240,41,84,.488,29,51,.569,12,33,.364,12,14,.857,106,33,83,.398,20,50,.400,13,33,.394,14,20,.700,93
871,LAC,2019-01-06,106,,ORL,W 106-96,240,40,93,.430,32,71,.451,8,22,.364,18,23,.783,106,33,89,.371,24,58,.414,9,31,.290,21,29,.724,96
872,ATL,2019-01-06,106,,MIA,W 106-82,240,43,91,.473,33,67,.493,10,24,.417,10,13,.769,106,31,87,.356,26,53,.491,5,34,.147,15,27,.556,82
873,PHI,2019-01-05,106,,DAL,W 106-100,240,39,83,.470,33,57,.579,6,26,.231,22,33,.667,106,38,88,.432,29,57,.509,9,31,.290,15,23,.652,100
874,DET,2018-12-26,106,,WAS,W 106-95,240,37,80,.463,23,43,.535,14,37,.378,18,19,.947,106,38,83,.458,29,50,.580,9,33,.273,10,13,.769,95
875,UTA,2018-12-22,106,,OKC,L 106-107,240,42,93,.452,31,59,.525,11,34,.324,11,18,.611,106,42,89,.472,33,64,.516,9,25,.360,14,22,.636,107
876,BRK,2018-12-21,106,,IND,L 106-114,240,33,72,.458,17,41,.415,16,31,.516,24,34,.706,106,44,82,.537,33,56,.589,11,26,.423,15,18,.833,114
877,ATL,2018-12-08,106,,DEN,W 106-98,240,40,93,.430,25,51,.490,15,42,.357,11,16,.688,106,36,97,.371,27,61,.443,9,36,.250,17,21,.810,98
878,BRK,2018-12-07,106,,TOR,W 106-105 (OT),265,43,98,.439,32,63,.508,11,35,.314,9,13,.692,106,35,89,.393,24,54,.444,11,35,.314,24,29,.828,105
879,MIA,2018-11-30,106,,NOP,W 106-101,240,40,93,.430,29,60,.483,11,33,.333,15,24,.625,106,35,82,.427,29,54,.537,6,28,.214,25,29,.862,101
880,DAL,2018-11-02,106,,NYK,L 106-118,240,40,81,.494,29,52,.558,11,29,.379,15,24,.625,106,46,84,.548,39,55,.709,7,29,.241,19,26,.731,118
881,SAS,2019-04-10,105,,DAL,W 105-94,240,41,88,.466,33,64,.516,8,24,.333,15,18,.833,105,37,91,.407,26,54,.481,11,37,.297,9,12,.750,94
882,BRK,2019-04-03,105,,TOR,L 105-115,240,41,86,.477,31,54,.574,10,32,.313,13,21,.619,105,44,105,.419,29,67,.433,15,38,.395,12,14,.857,115
883,SAC,2019-04-02,105,,HOU,L 105-130,240,42,95,.442,35,72,.486,7,23,.304,14,20,.700,105,46,94,.489,20,33,.606,26,61,.426,12,17,.706,130
884,OKC,2019-03-29,105,,DEN,L 105-115,240,43,88,.489,35,61,.574,8,27,.296,11,16,.688,105,48,85,.565,34,52,.654,14,33,.424,5,6,.833,115
885,MIA,2019-03-28,105,,DAL,W 105-99,240,39,89,.438,32,59,.542,7,30,.233,20,27,.741,105,36,92,.391,20,45,.444,16,47,.340,11,17,.647,99
886,SAS,2019-03-20,105,,MIA,L 105-110,240,38,88,.432,24,54,.444,14,34,.412,15,21,.714,105,40,86,.465,24,51,.471,16,35,.457,14,18,.778,110
887,ATL,2019-03-19,105,,HOU,L 105-121,240,39,84,.464,24,44,.545,15,40,.375,12,15,.800,105,40,78,.513,21,31,.677,19,47,.404,22,30,.733,121
888,BOS,2019-03-18,105,,DEN,L 105-114,240,39,93,.419,27,54,.500,12,39,.308,15,19,.789,105,46,94,.489,32,55,.582,14,39,.359,8,10,.800,114
889,DAL,2019-03-12,105,,SAS,L 105-112,240,38,82,.463,24,43,.558,14,39,.359,15,26,.577,105,43,82,.524,35,60,.583,8,22,.364,18,18,1.000,112
890,MEM,2019-03-10,105,,ORL,W 105-97,240,34,82,.415,25,51,.490,9,31,.290,28,31,.903,105,31,87,.356,19,49,.388,12,38,.316,23,27,.852,97
891,IND,2019-03-05,105,,CHI,W 105-96,240,38,84,.452,27,59,.458,11,25,.440,18,24,.750,105,36,93,.387,32,68,.471,4,25,.160,20,24,.833,96
892,LAL,2019-03-04,105,,LAC,L 105-113,240,38,91,.418,28,53,.528,10,38,.263,19,24,.792,105,41,83,.494,30,54,.556,11,29,.379,20,24,.833,113
893,SAS,2019-02-27,105,,DET,W 105-93,240,42,81,.519,33,64,.516,9,17,.529,12,17,.706,105,36,100,.360,21,62,.339,15,38,.395,6,7,.857,93
894,IND,2019-02-09,105,,CLE,W 105-90,240,45,84,.536,36,58,.621,9,26,.346,6,10,.600,105,35,79,.443,19,43,.442,16,36,.444,4,9,.444,90
895,DET,2019-01-29,105,,MIL,L 105-115,240,42,89,.472,30,52,.577,12,37,.324,9,12,.750,105,47,87,.540,34,55,.618,13,32,.406,8,10,.800,115
896,LAL,2019-01-29,105,,PHI,L 105-121,240,43,92,.467,36,69,.522,7,23,.304,12,16,.750,105,42,93,.452,27,57,.474,15,36,.417,22,28,.786,121
897,LAL,2019-01-24,105,,MIN,L 105-120,240,44,87,.506,36,59,.610,8,28,.286,9,14,.643,105,44,102,.431,34,69,.493,10,33,.303,22,25,.880,120
898,ATL,2019-01-19,105,,BOS,L 105-113,240,40,92,.435,28,51,.549,12,41,.293,13,14,.929,105,39,88,.443,27,56,.482,12,32,.375,23,25,.920,113
899,NYK,2019-01-13,105,,PHI,L 105-108,240,37,86,.430,27,55,.491,10,31,.323,21,30,.700,105,40,87,.460,34,67,.507,6,20,.300,22,30,.733,108
900,ORL,2019-01-12,105,,BOS,W 105-103,240,36,84,.429,25,46,.543,11,38,.289,22,24,.917,105,38,90,.422,30,58,.517,8,32,.250,19,28,.679,103
901,DET,2019-01-05,105,,UTA,L 105-110,240,39,82,.476,28,57,.491,11,25,.440,16,20,.800,105,39,82,.476,32,61,.525,7,21,.333,25,32,.781,110
902,DAL,2018-12-30,105,,OKC,W 105-103,240,37,81,.457,23,42,.548,14,39,.359,17,22,.773,105,40,93,.430,31,55,.564,9,38,.237,14,21,.667,103
903,POR,2018-12-29,105,,GSW,L 105-115,240,39,91,.429,30,60,.500,9,31,.290,18,22,.818,105,40,80,.500,28,55,.509,12,25,.480,23,28,.821,115
904,IND,2018-12-23,105,,WAS,W 105-89,240,43,97,.443,34,67,.507,9,30,.300,10,12,.833,105,28,76,.368,19,41,.463,9,35,.257,24,26,.923,89
905,CLE,2018-12-16,105,,PHI,L 105-128,240,41,88,.466,29,58,.500,12,30,.400,11,17,.647,105,51,91,.560,40,64,.625,11,27,.407,15,20,.750,128
906,DEN,2018-12-10,105,,MEM,W 105-99,240,39,77,.506,30,49,.612,9,28,.321,18,23,.783,105,37,74,.500,28,47,.596,9,27,.333,16,17,.941,99
907,CLE,2018-12-05,105,,GSW,L 105-129,240,39,89,.438,28,57,.491,11,32,.344,16,23,.696,105,45,85,.529,27,51,.529,18,34,.529,21,24,.875,129
908,PHO,2018-12-04,105,,SAC,L 105-122,240,38,87,.437,26,44,.591,12,43,.279,17,21,.810,105,45,84,.536,34,60,.567,11,24,.458,21,32,.656,122
909,SAS,2018-11-30,105,,HOU,L 105-136,240,39,86,.453,29,58,.500,10,28,.357,17,20,.850,105,49,98,.500,27,44,.614,22,54,.407,16,20,.800,136
910,CLE,2018-11-21,105,,LAL,L 105-109,240,39,102,.382,26,68,.382,13,34,.382,14,15,.933,105,40,78,.513,31,53,.585,9,25,.360,20,28,.714,109
911,SAC,2018-11-07,105,,TOR,L 105-114,240,42,88,.477,34,65,.523,8,23,.348,13,18,.722,105,41,89,.461,30,53,.566,11,36,.306,21,23,.913,114
912,CHI,2018-11-02,105,,IND,L 105-107,240,42,89,.472,29,58,.500,13,31,.419,8,9,.889,105,40,85,.471,33,59,.559,7,26,.269,20,22,.909,107
913,PHI,2018-10-27,105,,CHO,W 105-103,240,35,91,.385,25,63,.397,10,28,.357,25,30,.833,105,37,95,.389,28,60,.467,9,35,.257,20,24,.833,103
914,BOS,2018-10-16,105,,PHI,W 105-87,240,42,97,.433,31,60,.517,11,37,.297,10,14,.714,105,34,87,.391,29,61,.475,5,26,.192,14,23,.609,87
915,HOU,2019-03-13,104,,GSW,L 104-106,240,37,78,.474,26,37,.703,11,41,.268,19,23,.826,104,42,85,.494,30,53,.566,12,32,.375,10,10,1.000,106
916,LAC,2019-03-12,104,,POR,L 104-125,240,38,95,.400,29,80,.363,9,15,.600,19,27,.704,104,47,96,.490,35,65,.538,12,31,.387,19,26,.731,125
917,MIA,2019-03-10,104,,TOR,L 104-125,240,42,92,.457,34,65,.523,8,27,.296,12,21,.571,104,42,74,.568,21,34,.618,21,40,.525,20,26,.769,125
918,NOP,2019-03-08,104,,TOR,L 104-127,240,43,105,.410,33,66,.500,10,39,.256,8,13,.615,104,53,99,.535,40,62,.645,13,37,.351,8,9,.889,127
919,CHI,2019-03-08,104,,DET,L 104-112,240,42,82,.512,37,65,.569,5,17,.294,15,23,.652,104,45,83,.542,36,56,.643,9,27,.333,13,21,.619,112
920,NOP,2019-03-06,104,,UTA,L 104-114,240,41,89,.461,32,65,.492,9,24,.375,13,20,.650,104,46,88,.523,38,58,.655,8,30,.267,14,22,.636,114
921,ATL,2019-03-06,104,,SAS,L 104-111,240,36,92,.391,23,49,.469,13,43,.302,19,24,.792,104,44,89,.494,34,56,.607,10,33,.303,13,18,.722,111
922,SAS,2019-03-04,104,,DEN,W 104-103,240,41,85,.482,33,60,.550,8,25,.320,14,19,.737,104,41,95,.432,24,55,.436,17,40,.425,4,4,1.000,103
923,BOS,2019-03-03,104,,HOU,L 104-115,240,37,77,.481,29,49,.592,8,28,.286,22,29,.759,104,38,80,.475,17,29,.586,21,51,.412,18,29,.621,115
924,DEN,2019-02-28,104,,UTA,L 104-111,240,40,99,.404,33,74,.446,7,25,.280,17,24,.708,104,37,84,.440,21,41,.512,16,43,.372,21,33,.636,111
925,OKC,2019-02-28,104,,PHI,L 104-108,240,38,87,.437,30,60,.500,8,27,.296,20,28,.714,104,42,91,.462,30,61,.492,12,30,.400,12,19,.632,108
926,NYK,2019-02-22,104,,MIN,L 104-115,240,37,86,.430,26,57,.456,11,29,.379,19,24,.792,104,41,87,.471,30,63,.476,11,24,.458,22,32,.688,115
927,DAL,2019-02-22,104,,DEN,L 104-114,240,34,84,.405,24,43,.558,10,41,.244,26,33,.788,104,42,103,.408,28,66,.424,14,37,.378,16,25,.640,114
928,GSW,2019-01-31,104,,PHI,L 104-113,240,41,88,.466,30,50,.600,11,38,.289,11,16,.688,104,41,88,.466,29,51,.569,12,37,.324,19,24,.792,113
929,UTA,2019-01-21,104,,POR,L 104-109,240,36,91,.396,29,58,.500,7,33,.212,25,31,.806,104,45,90,.500,37,72,.514,8,18,.444,11,15,.733,109
930,LAC,2019-01-12,104,,DET,L 104-109,240,36,74,.486,27,56,.482,9,18,.500,23,29,.793,104,37,85,.435,21,48,.438,16,37,.432,19,22,.864,109
931,SAC,2019-01-12,104,,CHO,W 104-97,240,41,99,.414,27,62,.435,14,37,.378,8,12,.667,104,36,88,.409,24,52,.462,12,36,.333,13,22,.591,97
932,DAL,2019-01-09,104,,PHO,W 104-94,240,30,70,.429,18,36,.500,12,34,.353,32,45,.711,104,36,84,.429,29,59,.492,7,25,.280,15,21,.714,94
933,TOR,2019-01-08,104,,ATL,W 104-101,240,37,80,.463,27,48,.563,10,32,.313,20,27,.741,104,40,87,.460,30,60,.500,10,27,.370,11,16,.688,101
934,MIA,2018-12-30,104,,MIN,L 104-113,240,37,90,.411,29,66,.439,8,24,.333,22,28,.786,104,38,94,.404,30,70,.429,8,24,.333,29,36,.806,113
935,NOP,2018-12-29,104,,HOU,L 104-108,240,41,92,.446,32,64,.500,9,28,.321,13,17,.765,104,35,81,.432,19,35,.543,16,46,.348,22,28,.786,108
936,MIA,2018-12-26,104,,TOR,L 104-106,240,43,83,.518,31,54,.574,12,29,.414,6,12,.500,104,37,79,.468,24,49,.490,13,30,.433,19,23,.826,106
937,DET,2018-12-17,104,,MIL,L 104-107,240,39,88,.443,25,53,.472,14,35,.400,12,15,.800,104,44,88,.500,35,63,.556,9,25,.360,10,15,.667,107
938,NYK,2018-12-08,104,,BRK,L 104-112,240,39,83,.470,31,57,.544,8,26,.308,18,30,.600,104,43,88,.489,32,66,.485,11,22,.500,15,25,.600,112
939,LAL,2018-11-29,104,,IND,W 104-96,240,42,86,.488,35,62,.565,7,24,.292,13,23,.565,104,32,86,.372,22,63,.349,10,23,.435,22,27,.815,96
940,PHO,2018-11-27,104,,IND,L 104-109,240,41,92,.446,31,62,.500,10,30,.333,12,18,.667,104,38,90,.422,27,64,.422,11,26,.423,22,29,.759,109
941,LAL,2018-11-25,104,,ORL,L 104-108,240,37,79,.468,27,53,.509,10,26,.385,20,31,.645,104,42,93,.452,31,62,.500,11,31,.355,13,14,.929,108
942,MIL,2018-11-19,104,,DEN,W 104-98,240,40,88,.455,29,52,.558,11,36,.306,13,22,.591,104,40,94,.426,28,53,.528,12,41,.293,6,9,.667,98
943,SAS,2018-11-18,104,,GSW,W 104-92,240,41,92,.446,31,68,.456,10,24,.417,12,17,.706,104,35,86,.407,30,60,.500,5,26,.192,17,21,.810,92
944,WAS,2018-11-16,104,,BRK,L 104-115,240,37,87,.425,34,69,.493,3,18,.167,27,34,.794,104,38,90,.422,29,57,.509,9,33,.273,30,38,.789,115
945,TOR,2018-11-14,104,,DET,L 104-106,240,45,92,.489,41,72,.569,4,20,.200,10,17,.588,104,44,91,.484,34,58,.586,10,33,.303,8,13,.615,106
946,SAC,2018-11-12,104,,SAS,W 104-99,240,43,86,.500,32,62,.516,11,24,.458,7,12,.583,104,38,87,.437,28,56,.500,10,31,.323,13,16,.813,99
947,DAL,2018-10-28,104,,UTA,L 104-113,240,38,91,.418,29,63,.460,9,28,.321,19,25,.760,104,42,80,.525,32,55,.582,10,25,.400,19,22,.864,113
948,ORL,2018-10-17,104,,MIA,W 104-101,240,39,94,.415,32,69,.464,7,25,.280,19,31,.613,104,38,97,.392,29,64,.453,9,33,.273,16,22,.727,101
949,NOP,2019-04-09,103,,GSW,L 103-112,240,44,99,.444,35,66,.530,9,33,.273,6,10,.600,103,43,89,.483,31,59,.525,12,30,.400,14,21,.667,112
950,LAC,2019-04-03,103,,HOU,L 103-135,240,38,82,.463,30,56,.536,8,26,.308,19,31,.613,103,47,88,.534,29,50,.580,18,38,.474,23,29,.793,135
951,OKC,2019-03-31,103,,DAL,L 103-106,240,38,98,.388,27,55,.491,11,43,.256,16,22,.727,103,37,87,.425,21,43,.488,16,44,.364,16,23,.696,106
952,MEM,2019-03-27,103,,GSW,L 103-118,240,39,100,.390,29,69,.420,10,31,.323,15,21,.714,103,45,84,.536,30,53,.566,15,31,.484,13,15,.867,118
953,IND,2019-03-12,103,,NYK,W 103-98,240,37,85,.435,29,57,.509,8,28,.286,21,29,.724,103,35,80,.438,22,52,.423,13,28,.464,15,18,.833,98
954,BRK,2019-03-11,103,,DET,W 103-75,240,39,79,.494,28,48,.583,11,31,.355,14,22,.636,103,27,97,.278,19,63,.302,8,34,.235,13,16,.813,75
955,MIN,2019-03-10,103,,NYK,W 103-92,240,42,94,.447,33,64,.516,9,30,.300,10,13,.769,103,37,86,.430,27,61,.443,10,25,.400,8,14,.571,92
956,ORL,2019-02-28,103,,GSW,W 103-96,240,40,89,.449,29,58,.500,11,31,.355,12,15,.800,103,39,97,.402,30,57,.526,9,40,.225,9,10,.900,96
957,DEN,2019-02-11,103,,MIA,W 103-87,240,38,89,.427,22,52,.423,16,37,.432,11,13,.846,103,34,82,.415,25,49,.510,9,33,.273,10,16,.625,87
958,HOU,2019-01-27,103,,ORL,W 103-98,240,38,80,.475,26,44,.591,12,36,.333,15,21,.714,103,39,97,.402,29,62,.468,10,35,.286,10,17,.588,98
959,ATL,2019-01-21,103,,ORL,L 103-122,240,39,86,.453,30,56,.536,9,30,.300,16,23,.696,103,46,91,.505,35,62,.565,11,29,.379,19,21,.905,122
960,CHI,2019-01-19,103,,MIA,L 103-117,240,35,89,.393,23,62,.371,12,27,.444,21,26,.808,103,45,79,.570,32,47,.681,13,32,.406,14,23,.609,117
961,MEM,2018-12-29,103,,BOS,L 103-112,240,36,76,.474,29,50,.580,7,26,.269,24,29,.828,103,40,80,.500,24,44,.545,16,36,.444,16,18,.889,112
962,BOS,2018-12-19,103,,PHO,L 103-111,240,38,85,.447,23,46,.500,15,39,.385,12,14,.857,103,41,96,.427,30,69,.435,11,27,.407,18,22,.818,111
963,NOP,2018-12-07,103,,MEM,L 103-107,240,38,84,.452,31,55,.564,7,29,.241,20,24,.833,103,39,83,.470,31,64,.484,8,19,.421,21,28,.750,107
964,TOR,2018-12-03,103,,DEN,L 103-106,240,40,87,.460,29,46,.630,11,41,.268,12,12,1.000,103,40,89,.449,29,61,.475,11,28,.393,15,24,.625,106
965,MIN,2018-12-03,103,,HOU,W 103-91,240,36,82,.439,25,60,.417,11,22,.500,20,28,.714,103,32,74,.432,21,35,.600,11,39,.282,16,19,.842,91
966,PHI,2018-12-02,103,,MEM,W 103-95,240,36,74,.486,28,52,.538,8,22,.364,23,30,.767,103,33,79,.418,22,51,.431,11,28,.393,18,23,.783,95
967,SAS,2018-11-21,103,,MEM,L 103-104,240,35,82,.427,28,60,.467,7,22,.318,26,30,.867,103,39,81,.481,31,56,.554,8,25,.320,18,21,.857,104
968,DET,2018-11-11,103,,CHO,L 103-113,240,38,104,.365,26,60,.433,12,44,.273,15,19,.789,103,43,85,.506,32,57,.561,11,28,.393,16,18,.889,113
969,DEN,2018-11-03,103,,UTA,W 103-88,240,41,83,.494,32,55,.582,9,28,.321,12,19,.632,103,33,81,.407,27,50,.540,6,31,.194,16,24,.667,88
970,DET,2018-10-17,103,,BRK,W 103-100,240,39,92,.424,33,68,.485,6,24,.250,19,22,.864,103,40,82,.488,35,55,.636,5,27,.185,15,22,.682,100
971,MIA,2019-04-03,102,,BOS,L 102-112,240,39,95,.411,27,59,.458,12,36,.333,12,20,.600,102,38,80,.475,29,56,.518,9,24,.375,27,31,.871,112
972,NOP,2019-03-31,102,,LAL,L 102-130,240,38,83,.458,30,52,.577,8,31,.258,18,21,.857,102,48,101,.475,33,63,.524,15,38,.395,19,22,.864,130
973,DEN,2019-03-16,102,,IND,W 102-100,240,39,82,.476,28,44,.636,11,38,.289,13,20,.650,102,34,75,.453,28,51,.549,6,24,.250,26,37,.703,100
974,DAL,2019-02-10,102,,POR,W 102-101,240,36,87,.414,24,50,.480,12,37,.324,18,23,.783,102,42,86,.488,33,57,.579,9,29,.310,8,14,.571,101
975,SAC,2019-02-08,102,,MIA,W 102-96,240,37,90,.411,28,64,.438,9,26,.346,19,25,.760,102,38,88,.432,27,55,.491,11,33,.333,9,19,.474,96
976,ORL,2019-02-02,102,,BRK,W 102-89,240,41,94,.436,31,67,.463,10,27,.370,10,12,.833,102,33,91,.363,23,53,.434,10,38,.263,13,16,.813,89
977,MIA,2019-02-01,102,,OKC,L 102-118,240,41,92,.446,30,56,.536,11,36,.306,9,14,.643,102,44,91,.484,28,61,.459,16,30,.533,14,19,.737,118
978,PHO,2019-01-12,102,,DEN,W 102-93,240,38,92,.413,30,66,.455,8,26,.308,18,25,.720,102,34,88,.386,24,57,.421,10,31,.323,15,22,.682,93
979,DEN,2018-12-28,102,,SAS,W 102-99,240,39,85,.459,29,56,.518,10,29,.345,14,17,.824,102,40,89,.449,32,62,.516,8,27,.296,11,20,.550,99
980,PHO,2018-12-28,102,,OKC,L 102-118,240,39,90,.433,30,61,.492,9,29,.310,15,16,.938,102,51,95,.537,44,75,.587,7,20,.350,9,13,.692,118
981,SAC,2018-12-21,102,,MEM,W 102-99,240,33,88,.375,18,47,.383,15,41,.366,21,29,.724,102,37,80,.463,21,48,.438,16,32,.500,9,10,.900,99
982,HOU,2018-12-17,102,,UTA,W 102-97,240,32,86,.372,20,49,.408,12,37,.324,26,31,.839,102,32,82,.390,22,47,.468,10,35,.286,23,31,.742,97
983,CLE,2018-12-14,102,,MIL,L 102-114,240,35,87,.402,22,51,.431,13,36,.361,19,21,.905,102,40,94,.426,28,53,.528,12,41,.293,22,28,.786,114
984,MIA,2018-12-02,102,,UTA,W 102-100,240,36,91,.396,23,60,.383,13,31,.419,17,24,.708,102,39,89,.438,28,56,.500,11,33,.333,11,15,.733,100
985,WAS,2018-12-01,102,,BRK,W 102-88,240,41,79,.519,33,53,.623,8,26,.308,12,18,.667,102,30,81,.370,22,48,.458,8,33,.242,20,25,.800,88
986,BRK,2018-11-23,102,,MIN,L 102-112,240,33,79,.418,19,34,.559,14,45,.311,22,26,.846,102,44,92,.478,35,67,.522,9,25,.360,15,17,.882,112
987,MIA,2018-11-09,102,,IND,L 102-110,240,36,80,.450,22,53,.415,14,27,.519,16,27,.593,102,43,79,.544,36,59,.610,7,20,.350,17,29,.586,110
988,ORL,2018-11-05,102,,CLE,W 102-100,240,39,87,.448,28,53,.528,11,34,.324,13,15,.867,102,41,80,.513,31,57,.544,10,23,.435,8,12,.667,100
989,PHO,2018-11-04,102,,MEM,W 102-100,240,33,64,.516,19,32,.594,14,32,.438,22,26,.846,102,36,76,.474,29,53,.547,7,23,.304,21,29,.724,100
990,IND,2018-11-03,102,,BOS,W 102-101,240,36,86,.419,25,54,.463,11,32,.344,19,25,.760,102,38,88,.432,19,42,.452,19,46,.413,6,9,.667,101
991,LAL,2019-04-09,101,,POR,L 101-104,240,40,94,.426,30,65,.462,10,29,.345,11,17,.647,101,37,90,.411,26,53,.491,11,37,.297,19,22,.864,104
992,CHI,2019-03-30,101,,TOR,L 101-124,240,41,97,.423,32,67,.478,9,30,.300,10,16,.625,101,46,89,.517,28,51,.549,18,38,.474,14,18,.778,124
993,PHO,2019-03-18,101,,CHI,L 101-116,240,39,84,.464,32,58,.552,7,26,.269,16,26,.615,101,46,89,.517,42,73,.575,4,16,.250,20,24,.833,116
994,ORL,2019-03-17,101,,ATL,W 101-91,240,33,85,.388,24,48,.500,9,37,.243,26,33,.788,101,38,91,.418,30,56,.536,8,35,.229,7,10,.700,91
995,BRK,2019-02-25,101,,SAS,W 101-85,240,35,81,.432,16,31,.516,19,50,.380,12,16,.750,101,35,96,.365,31,72,.431,4,24,.167,11,12,.917,85
996,DAL,2019-02-13,101,,MIA,L 101-112,240,34,88,.386,19,36,.528,15,52,.288,18,22,.818,101,44,81,.543,32,51,.627,12,30,.400,12,16,.750,112
997,ATL,2019-02-07,101,,TOR,L 101-119,240,36,80,.450,20,45,.444,16,35,.457,13,25,.520,101,40,87,.460,27,47,.574,13,40,.325,26,33,.788,119
998,SAC,2019-02-06,101,,HOU,L 101-127,240,39,91,.429,28,58,.483,11,33,.333,12,20,.600,101,45,100,.450,25,49,.510,20,51,.392,17,18,.944,127
999,DET,2019-02-02,101,,LAC,L 101-111,240,35,83,.422,18,41,.439,17,42,.405,14,20,.700,101,40,82,.488,30,62,.484,10,20,.500,21,34,.618,111
1000,CHO,2019-01-28,101,,NYK,W 101-92,240,39,94,.415,28,60,.467,11,34,.324,12,16,.750,101,34,85,.400,27,62,.435,7,23,.304,17,26,.654,92
1001,CHI,2019-01-27,101,,CLE,L 101-104,240,39,88,.443,30,62,.484,9,26,.346,14,17,.824,101,39,92,.424,26,58,.448,13,34,.382,13,15,.867,104
1002,CHI,2019-01-25,101,,LAC,L 101-106,240,40,102,.392,30,67,.448,10,35,.286,11,12,.917,101,38,82,.463,30,61,.492,8,21,.381,22,29,.759,106
1003,CHI,2019-01-23,101,,ATL,L 101-121,240,35,79,.443,27,53,.509,8,26,.308,23,27,.852,101,45,90,.500,30,50,.600,15,40,.375,16,21,.762,121
1004,WAS,2019-01-21,101,,DET,W 101-87,240,36,79,.456,28,56,.500,8,23,.348,21,27,.778,101,31,77,.403,20,43,.465,11,34,.324,14,18,.778,87
1005,DET,2019-01-19,101,,SAC,L 101-103,240,36,82,.439,26,53,.491,10,29,.345,19,25,.760,101,40,89,.449,30,64,.469,10,25,.400,13,18,.722,103
1006,WAS,2019-01-17,101,,NYK,W 101-100,240,40,92,.435,33,65,.508,7,27,.259,14,20,.700,101,39,87,.448,27,58,.466,12,29,.414,10,12,.833,100
1007,MEM,2019-01-16,101,,MIL,L 101-111,240,37,95,.389,27,64,.422,10,31,.323,17,25,.680,101,40,84,.476,28,50,.560,12,34,.353,19,22,.864,111
1008,DAL,2019-01-16,101,,SAS,L 101-105,240,37,86,.430,22,44,.500,15,42,.357,12,16,.750,101,41,83,.494,28,53,.528,13,30,.433,10,12,.833,105
1009,GSW,2018-12-25,101,,LAL,L 101-127,240,38,93,.409,29,57,.509,9,36,.250,16,21,.762,101,47,85,.553,34,52,.654,13,33,.394,20,27,.741,127
1010,MIA,2018-12-20,101,,HOU,W 101-99,240,36,93,.387,27,54,.500,9,39,.231,20,34,.588,101,29,82,.354,11,28,.393,18,54,.333,23,30,.767,99
1011,PHI,2018-12-14,101,,IND,L 101-113,240,36,88,.409,27,52,.519,9,36,.250,20,27,.741,101,42,95,.442,34,75,.453,8,20,.400,21,24,.875,113
1012,DAL,2018-12-10,101,,ORL,W 101-76,240,35,82,.427,25,47,.532,10,35,.286,21,25,.840,101,32,89,.360,24,61,.393,8,28,.286,4,5,.800,76
1013,MIN,2018-11-21,101,,DEN,L 101-103,240,35,79,.443,26,47,.553,9,32,.281,22,26,.846,101,42,89,.472,28,54,.519,14,35,.400,5,6,.833,103
1014,NYK,2018-10-31,101,,IND,L 101-107,240,34,79,.430,22,54,.407,12,25,.480,21,24,.875,101,45,83,.542,39,63,.619,6,20,.300,11,17,.647,107
1015,MIN,2018-10-22,101,,IND,W 101-91,240,36,85,.424,29,52,.558,7,33,.212,22,24,.917,101,36,92,.391,28,66,.424,8,26,.308,11,16,.688,91
1016,NYK,2018-10-20,101,,BOS,L 101-103,240,36,87,.414,24,52,.462,12,35,.343,17,27,.630,101,33,82,.402,24,57,.421,9,25,.360,28,33,.848,103
1017,MIN,2019-04-09,100,,TOR,L 100-120,240,38,91,.418,25,49,.510,13,42,.310,11,14,.786,100,46,88,.523,30,51,.588,16,37,.432,12,17,.706,120
1018,DET,2019-04-09,100,,MEM,W 100-93,240,35,88,.398,25,54,.463,10,34,.294,20,28,.714,100,33,69,.478,23,45,.511,10,24,.417,17,21,.810,93
1019,DEN,2019-03-14,100,,DAL,W 100-99,240,39,81,.481,31,52,.596,8,29,.276,14,17,.824,100,37,87,.425,25,50,.500,12,37,.324,13,17,.765,99
1020,WAS,2019-03-13,100,,ORL,W 100-90,240,42,90,.467,34,63,.540,8,27,.296,8,12,.667,100,35,90,.389,23,57,.404,12,33,.364,8,9,.889,90
1021,CHO,2019-02-01,100,,MEM,W 100-92,240,32,73,.438,20,44,.455,12,29,.414,24,28,.857,100,35,80,.438,26,51,.510,9,29,.310,13,17,.765,92
1022,IND,2019-01-28,100,,GSW,L 100-132,240,40,94,.426,28,64,.438,12,30,.400,8,10,.800,100,53,98,.541,40,67,.597,13,31,.419,13,16,.813,132
1023,UTA,2019-01-14,100,,DET,W 100-94,240,31,80,.388,19,43,.442,12,37,.324,26,36,.722,100,35,90,.389,24,54,.444,11,36,.306,13,16,.813,94
1024,CHI,2019-01-06,100,,BRK,L 100-117,240,41,88,.466,34,70,.486,7,18,.389,11,15,.733,100,42,83,.506,26,37,.703,16,46,.348,17,22,.773,117
1025,MEM,2019-01-04,100,,BRK,L 100-109,240,42,93,.452,37,69,.536,5,24,.208,11,15,.733,100,36,79,.456,23,45,.511,13,34,.382,24,26,.923,109
1026,LAL,2019-01-02,100,,OKC,L 100-107,240,37,89,.416,30,62,.484,7,27,.259,19,32,.594,100,40,105,.381,33,74,.446,7,31,.226,20,31,.645,107
1027,CHO,2018-12-28,100,,BRK,W 100-87,240,41,100,.410,30,67,.448,11,33,.333,7,10,.700,100,33,83,.398,29,56,.518,4,27,.148,17,20,.850,87
1028,CHO,2018-12-15,100,,LAL,L 100-128,240,39,92,.424,32,63,.508,7,29,.241,15,18,.833,100,49,92,.533,35,58,.603,14,34,.412,16,24,.667,128
1029,OKC,2018-11-28,100,,CLE,W 100-83,240,41,86,.477,35,59,.593,6,27,.222,12,15,.800,100,35,89,.393,26,66,.394,9,23,.391,4,9,.444,83
1030,POR,2018-11-25,100,,LAC,L 100-104,240,42,97,.433,34,59,.576,8,38,.211,8,10,.800,100,38,90,.422,33,65,.508,5,25,.200,23,34,.676,104
1031,IND,2018-11-23,100,,SAS,L 100-111,240,46,99,.465,43,75,.573,3,24,.125,5,9,.556,100,42,83,.506,32,62,.516,10,21,.476,17,24,.708,111
1032,PHO,2018-11-17,100,,OKC,L 100-110,240,37,82,.451,25,53,.472,12,29,.414,14,21,.667,100,38,85,.447,31,61,.508,7,24,.292,27,32,.844,110
1033,POR,2018-11-11,100,,BOS,W 100-94,240,39,86,.453,25,50,.500,14,36,.389,8,10,.800,100,36,93,.387,22,51,.431,14,42,.333,8,10,.800,94
1034,UTA,2018-11-02,100,,MEM,L 100-110,240,36,77,.468,22,41,.537,14,36,.389,14,25,.560,100,38,75,.507,25,49,.510,13,26,.500,21,34,.618,110
1035,NYK,2018-10-26,100,,GSW,L 100-128,240,39,90,.433,26,51,.510,13,39,.333,9,12,.750,100,51,87,.586,35,54,.648,16,33,.485,10,12,.833,128
1036,DEN,2018-10-21,100,,GSW,W 100-98,240,35,86,.407,29,54,.537,6,32,.188,24,42,.571,100,36,79,.456,29,50,.580,7,29,.241,19,24,.792,98
1037,DEN,2019-04-10,99,,MIN,W 99-95,240,39,87,.448,29,54,.537,10,33,.303,11,17,.647,99,39,91,.429,26,59,.441,13,32,.406,4,6,.667,95
1038,DET,2019-03-30,99,,POR,W 99-90,240,37,86,.430,32,61,.525,5,25,.200,20,26,.769,99,38,102,.373,34,81,.420,4,21,.190,10,11,.909,90
1039,MIA,2019-03-26,99,,ORL,L 99-104,240,36,86,.419,26,53,.491,10,33,.303,17,21,.810,99,37,89,.416,23,47,.489,14,42,.333,16,23,.696,104
1040,MEM,2019-03-23,99,,MIN,L 99-112,240,36,96,.375,26,63,.413,10,33,.303,17,22,.773,99,40,83,.482,28,57,.491,12,26,.462,20,21,.952,112
1041,LAL,2019-03-06,99,,DEN,L 99-115,240,40,84,.476,33,53,.623,7,31,.226,12,23,.522,99,45,98,.459,32,56,.571,13,42,.310,12,17,.706,115
1042,OKC,2019-03-03,99,,MEM,W 99-95,240,33,93,.355,24,63,.381,9,30,.300,24,33,.727,99,35,79,.443,28,57,.491,7,22,.318,18,19,.947,95
1043,BRK,2019-02-21,99,,POR,L 99-113,240,36,92,.391,29,56,.518,7,36,.194,20,26,.769,99,46,105,.438,39,73,.534,7,32,.219,14,16,.875,113
1044,CHI,2019-02-11,99,,MIL,L 99-112,240,37,96,.385,28,68,.412,9,28,.321,16,18,.889,99,38,80,.475,26,42,.619,12,38,.316,24,29,.828,112
1045,IND,2019-02-11,99,,CHO,W 99-90,240,38,74,.514,30,49,.612,8,25,.320,15,17,.882,99,29,90,.322,22,50,.440,7,40,.175,25,33,.758,90
1046,MEM,2019-02-09,99,,NOP,W 99-90,240,38,88,.432,30,59,.508,8,29,.276,15,18,.833,99,34,86,.395,28,53,.528,6,33,.182,16,27,.593,90
1047,NYK,2019-02-09,99,,TOR,L 99-104,240,39,94,.415,29,69,.420,10,25,.400,11,19,.579,99,33,86,.384,19,51,.373,14,35,.400,24,29,.828,104
1048,DAL,2019-02-06,99,,CHO,W 99-93,240,38,94,.404,27,58,.466,11,36,.306,12,17,.706,99,36,89,.404,27,52,.519,9,37,.243,12,17,.706,93
1049,NYK,2019-02-01,99,,BOS,L 99-113,240,39,86,.453,30,55,.545,9,31,.290,12,12,1.000,99,46,100,.460,33,63,.524,13,37,.351,8,10,.800,113
1050,MIN,2019-01-30,99,,MEM,W 99-97 (OT),265,37,95,.389,29,60,.483,8,35,.229,17,22,.773,99,36,87,.414,30,64,.469,6,23,.261,19,22,.864,97
1051,NOP,2019-01-30,99,,DEN,L 99-105,240,37,89,.416,22,53,.415,15,36,.417,10,13,.769,99,42,89,.472,33,59,.559,9,30,.300,12,19,.632,105
1052,MIA,2019-01-23,99,,LAC,L 99-111,240,39,83,.470,31,55,.564,8,28,.286,13,22,.591,99,45,85,.529,38,63,.603,7,22,.318,14,21,.667,111
1053,MIA,2019-01-08,99,,DEN,L 99-103,240,38,83,.458,30,52,.577,8,31,.258,15,25,.600,99,41,87,.471,32,60,.533,9,27,.333,12,17,.706,103
1054,LAL,2018-12-23,99,,MEM,L 99-107,240,37,75,.493,27,45,.600,10,30,.333,15,22,.682,99,42,90,.467,28,64,.438,14,26,.538,9,14,.643,107
1055,TOR,2018-12-19,99,,IND,W 99-96,240,38,93,.409,31,63,.492,7,30,.233,16,21,.762,99,38,80,.475,29,60,.483,9,20,.450,11,16,.688,96
1056,POR,2018-12-19,99,,MEM,W 99-92,240,35,75,.467,24,49,.490,11,26,.423,18,20,.900,99,33,78,.423,24,51,.471,9,27,.333,17,19,.895,92
1057,PHO,2018-12-13,99,,DAL,W 99-89,240,37,92,.402,27,65,.415,10,27,.370,15,18,.833,99,31,78,.397,26,45,.578,5,33,.152,22,33,.667,89
1058,LAC,2018-12-11,99,,TOR,L 99-123,240,38,86,.442,31,61,.508,7,25,.280,16,19,.842,99,50,96,.521,36,67,.537,14,29,.483,9,12,.750,123
1059,TOR,2018-12-09,99,,MIL,L 99-104,240,39,94,.415,24,50,.480,15,44,.341,6,7,.857,99,36,87,.414,21,48,.438,15,39,.385,17,20,.850,104
1060,IND,2018-11-16,99,,MIA,W 99-91,240,36,81,.444,22,54,.407,14,27,.519,13,15,.867,99,35,93,.376,21,57,.368,14,36,.389,7,10,.700,91
1061,DEN,2018-11-13,99,,HOU,L 99-109,240,38,76,.500,27,51,.529,11,25,.440,12,16,.750,99,39,71,.549,26,34,.765,13,37,.351,18,26,.692,109
1062,CHI,2018-11-10,99,,CLE,W 99-98,240,39,82,.476,32,64,.500,7,18,.389,14,21,.667,99,39,91,.429,31,70,.443,8,21,.381,12,18,.667,98
1063,ORL,2018-10-30,99,,SAC,L 99-107,240,36,91,.396,25,48,.521,11,43,.256,16,22,.727,99,41,84,.488,33,62,.532,8,22,.364,17,26,.654,107
1064,ATL,2019-03-29,98,,POR,L 98-118,240,38,94,.404,29,56,.518,9,38,.237,13,14,.929,98,45,96,.469,36,64,.563,9,32,.281,19,22,.864,118
1065,CHI,2019-03-27,98,,POR,L 98-118,240,39,91,.429,34,68,.500,5,23,.217,15,19,.789,98,43,83,.518,32,51,.627,11,32,.344,21,25,.840,118
1066,PHO,2019-03-21,98,,DET,L 98-118,240,35,73,.479,28,47,.596,7,26,.269,21,26,.808,98,38,90,.422,21,48,.438,17,42,.405,25,34,.735,118
1067,MIA,2019-03-15,98,,MIL,L 98-113,240,38,93,.409,30,71,.423,8,22,.364,14,25,.560,98,42,88,.477,30,55,.545,12,33,.364,17,24,.708,113
1068,TOR,2019-02-24,98,,ORL,L 98-113,240,38,91,.418,27,63,.429,11,28,.393,11,14,.786,98,42,91,.462,28,55,.509,14,36,.389,15,20,.750,113
1069,MIL,2019-02-21,98,,BOS,W 98-97,240,37,88,.420,23,49,.469,14,39,.359,10,14,.714,98,39,102,.382,25,62,.403,14,40,.350,5,6,.833,97
1070,CLE,2019-02-02,98,,DAL,L 98-111,240,34,85,.400,30,62,.484,4,23,.174,26,33,.788,98,40,84,.476,24,45,.533,16,39,.410,15,19,.789,111
1071,UTA,2019-02-02,98,,HOU,L 98-125,240,31,86,.360,20,45,.444,11,41,.268,25,36,.694,98,40,87,.460,25,48,.521,15,39,.385,30,37,.811,125
1072,DET,2019-01-18,98,,MIA,W 98-93,240,35,82,.427,22,49,.449,13,33,.394,15,18,.833,98,39,77,.506,29,48,.604,10,29,.345,5,19,.263,93
1073,OKC,2019-01-06,98,,WAS,L 98-116,240,38,88,.432,28,63,.444,10,25,.400,12,19,.632,98,44,101,.436,34,64,.531,10,37,.270,18,22,.818,116
1074,CLE,2019-01-05,98,,NOP,L 98-133,240,36,88,.409,24,55,.436,12,33,.364,14,18,.778,98,47,81,.580,33,54,.611,14,27,.519,25,29,.862,133
1075,CHO,2018-12-21,98,,DET,W 98-86,240,33,75,.440,21,51,.412,12,24,.500,20,28,.714,98,32,82,.390,24,48,.500,8,34,.235,14,22,.636,86
1076,LAC,2018-12-08,98,,MIA,L 98-121,240,33,89,.371,26,60,.433,7,29,.241,25,31,.806,98,40,92,.435,27,53,.509,13,39,.333,28,39,.718,121
1077,PHO,2018-12-07,98,,MIA,L 98-115,240,36,79,.456,22,45,.489,14,34,.412,12,16,.750,98,42,86,.488,27,49,.551,15,37,.405,16,18,.889,115
1078,MEM,2018-11-25,98,,NYK,L 98-103,240,38,86,.442,27,56,.482,11,30,.367,11,19,.579,98,34,91,.374,26,69,.377,8,22,.364,27,32,.844,103
1079,OKC,2018-11-24,98,,DEN,L 98-105,240,37,103,.359,28,64,.438,9,39,.231,15,23,.652,98,39,95,.411,29,65,.446,10,30,.333,17,24,.708,105
1080,MEM,2018-11-19,98,,DAL,W 98-88,240,37,79,.468,25,49,.510,12,30,.400,12,14,.857,98,30,88,.341,20,56,.357,10,32,.313,18,21,.857,88
1081,CHI,2018-11-12,98,,DAL,L 98-103,240,35,89,.393,27,56,.482,8,33,.242,20,22,.909,98,37,79,.468,27,46,.587,10,33,.303,19,29,.655,103
1082,OKC,2018-11-08,98,,HOU,W 98-80,240,36,81,.444,27,44,.614,9,37,.243,17,24,.708,98,31,82,.378,20,40,.500,11,42,.262,7,10,.700,80
1083,PHO,2018-11-02,98,,TOR,L 98-107,240,40,91,.440,32,65,.492,8,26,.308,10,18,.556,98,41,81,.506,29,48,.604,12,33,.364,13,21,.619,107
1084,LAC,2018-10-17,98,,DEN,L 98-107,240,35,88,.398,27,60,.450,8,28,.286,20,24,.833,98,33,87,.379,25,63,.397,8,24,.333,33,42,.786,107
1085,CLE,2019-04-09,97,,CHO,L 97-124,240,40,89,.449,29,59,.492,11,30,.367,6,8,.750,97,45,78,.577,23,34,.676,22,44,.500,12,17,.706,124
1086,IND,2019-04-05,97,,BOS,L 97-117,240,38,92,.413,28,69,.406,10,23,.435,11,19,.579,97,48,92,.522,41,65,.631,7,27,.259,14,16,.875,117
1087,PHO,2019-04-03,97,,UTA,L 97-118,240,42,91,.462,37,70,.529,5,21,.238,8,13,.615,97,44,77,.571,28,45,.622,16,32,.500,14,18,.778,118
1088,PHO,2019-03-13,97,,UTA,L 97-114,240,36,82,.439,29,63,.460,7,19,.368,18,23,.783,97,42,90,.467,30,57,.526,12,33,.364,18,25,.720,114
1089,IND,2019-02-13,97,,MIL,L 97-106,240,37,88,.420,27,61,.443,10,27,.370,13,15,.867,97,38,86,.442,29,55,.527,9,31,.290,21,29,.724,106
1090,NYK,2019-01-27,97,,MIA,L 97-106,240,36,84,.429,29,58,.500,7,26,.269,18,24,.750,97,39,84,.464,27,51,.529,12,33,.364,16,18,.889,106
1091,DAL,2019-01-07,97,,LAL,L 97-107,240,36,86,.419,28,56,.500,8,30,.267,17,24,.708,97,41,94,.436,33,65,.508,8,29,.276,17,27,.630,107
1092,UTA,2018-12-27,97,,PHI,L 97-114,240,33,86,.384,22,51,.431,11,35,.314,20,27,.741,97,43,86,.500,30,51,.588,13,35,.371,15,18,.833,114
1093,MEM,2018-12-15,97,,HOU,L 97-105,240,40,75,.533,35,52,.673,5,23,.217,12,17,.706,97,35,73,.479,22,36,.611,13,37,.351,22,25,.880,105
1094,MEM,2018-12-14,97,,MIA,L 97-100,240,35,83,.422,27,54,.500,8,29,.276,19,25,.760,97,36,82,.439,21,43,.488,15,39,.385,13,18,.722,100
1095,ORL,2018-12-13,97,,CHI,W 97-91,240,34,82,.415,23,49,.469,11,33,.333,18,23,.783,97,34,71,.479,24,53,.453,10,18,.556,13,20,.650,91
1096,BRK,2018-12-03,97,,CLE,L 97-99,240,39,99,.394,29,59,.492,10,40,.250,9,16,.563,97,38,88,.432,34,73,.466,4,15,.267,19,20,.950,99
1097,MIA,2018-11-18,97,,LAL,L 97-113,240,35,87,.402,22,55,.400,13,32,.406,14,19,.737,97,42,95,.442,31,68,.456,11,27,.407,18,21,.857,113
1098,IND,2018-11-17,97,,ATL,W 97-89,240,35,87,.402,23,57,.404,12,30,.400,15,21,.714,97,31,87,.356,23,58,.397,8,29,.276,19,27,.704,89
1099,SAC,2018-10-24,97,,MEM,W 97-92,240,35,83,.422,29,65,.446,6,18,.333,21,33,.636,97,36,94,.383,26,57,.456,10,37,.270,10,13,.769,92
1100,IND,2019-04-07,96,,BRK,L 96-108,240,41,85,.482,31,58,.534,10,27,.370,4,7,.571,96,40,88,.455,29,52,.558,11,36,.306,17,22,.773,108
1101,CHI,2019-04-06,96,,PHI,L 96-116,240,38,89,.427,30,64,.469,8,25,.320,12,15,.800,96,46,88,.523,37,61,.607,9,27,.333,15,26,.577,116
1102,BOS,2019-03-24,96,,SAS,L 96-115,240,38,94,.404,31,59,.525,7,35,.200,13,16,.813,96,50,98,.510,42,74,.568,8,24,.333,7,8,.875,115
1103,MIA,2019-02-23,96,,DET,L 96-119,240,35,82,.427,28,54,.519,7,28,.250,19,27,.704,96,42,80,.525,28,47,.596,14,33,.424,21,26,.808,119
1104,CLE,2019-02-05,96,,BOS,L 96-103,240,40,96,.417,31,63,.492,9,33,.273,7,8,.875,96,40,82,.488,31,56,.554,9,26,.346,14,14,1.000,103
1105,MEM,2019-01-25,96,,SAC,L 96-99,240,34,80,.425,28,60,.467,6,20,.300,22,27,.815,96,37,91,.407,25,58,.431,12,33,.364,13,17,.765,99
1106,IND,2019-01-17,96,,PHI,L 96-120,240,39,97,.402,30,68,.441,9,29,.310,9,12,.750,96,46,87,.529,28,53,.528,18,34,.529,10,11,.909,120
1107,MEM,2019-01-09,96,,SAS,W 96-86,240,37,90,.411,29,57,.509,8,33,.242,14,20,.700,96,30,83,.361,19,56,.339,11,27,.407,15,23,.652,86
1108,NOP,2018-12-16,96,,MIA,L 96-102,240,35,86,.407,22,50,.440,13,36,.361,13,17,.765,96,38,91,.418,28,56,.500,10,35,.286,16,23,.696,102
1109,ORL,2018-12-15,96,,UTA,W 96-89,240,34,72,.472,23,48,.479,11,24,.458,17,20,.850,96,28,89,.315,21,60,.350,7,29,.241,26,28,.929,89
1110,MEM,2018-12-05,96,,LAC,W 96-86,240,37,85,.435,30,57,.526,7,28,.250,15,24,.625,96,25,74,.338,17,51,.333,8,23,.348,28,35,.800,86
1111,IND,2018-12-04,96,,CHI,W 96-90,240,35,76,.461,29,54,.537,6,22,.273,20,24,.833,96,37,94,.394,26,63,.413,11,31,.355,5,5,1.000,90
1112,CHI,2018-11-23,96,,MIA,L 96-103,240,35,94,.372,28,66,.424,7,28,.250,19,20,.950,96,37,87,.425,27,53,.509,10,34,.294,19,31,.613,103
1113,ATL,2018-11-23,96,,BOS,L 96-114,240,35,81,.432,29,46,.630,6,35,.171,20,29,.690,96,42,91,.462,29,51,.569,13,40,.325,17,21,.810,114
1114,SAS,2018-11-10,96,,HOU,W 96-89,240,33,74,.446,23,54,.426,10,20,.500,20,27,.741,96,30,90,.333,21,49,.429,9,41,.220,20,29,.690,89
1115,ORL,2018-11-07,96,,DET,L 96-103,240,40,87,.460,31,60,.517,9,27,.333,7,9,.778,96,37,90,.411,26,53,.491,11,37,.297,18,20,.900,103
1116,SAS,2018-10-24,96,,IND,L 96-116,240,35,87,.402,29,68,.426,6,19,.316,20,21,.952,96,46,87,.529,29,55,.527,17,32,.531,7,8,.875,116
1117,DEN,2019-03-26,95,,DET,W 95-92,240,37,87,.425,30,60,.500,7,27,.259,14,20,.700,95,36,102,.353,25,60,.417,11,42,.262,9,13,.692,92
1118,WAS,2019-03-18,95,,UTA,L 95-116,240,34,81,.420,26,54,.481,8,27,.296,19,22,.864,95,49,91,.538,35,54,.648,14,37,.378,4,6,.667,116
1119,GSW,2019-03-05,95,,BOS,L 95-128,240,34,85,.400,26,50,.520,8,35,.229,19,23,.826,95,49,96,.510,35,62,.565,14,34,.412,16,17,.941,128
1120,TOR,2019-03-05,95,,HOU,L 95-107,240,37,89,.416,28,57,.491,9,32,.281,12,16,.750,95,38,85,.447,23,51,.451,15,34,.441,16,18,.889,107
1121,SAS,2019-01-20,95,,LAC,L 95-103,240,39,84,.464,31,65,.477,8,19,.421,9,17,.529,95,39,85,.459,28,64,.438,11,21,.524,14,24,.583,103
1122,LAL,2019-01-13,95,,CLE,L 95-101,240,36,91,.396,29,57,.509,7,34,.206,16,27,.593,95,38,89,.427,30,68,.441,8,21,.381,17,23,.739,101
1123,TOR,2018-12-30,95,,CHI,W 95-89,240,34,92,.370,25,59,.424,9,33,.273,18,20,.900,95,33,80,.413,26,60,.433,7,20,.350,16,18,.889,89
1124,MEM,2018-12-26,95,,CLE,W 95-87,240,36,72,.500,31,50,.620,5,22,.227,18,24,.750,95,33,93,.355,24,64,.375,9,29,.310,12,15,.800,87
1125,NYK,2018-12-25,95,,MIL,L 95-109,240,35,97,.361,27,68,.397,8,29,.276,17,21,.810,95,40,89,.449,34,57,.596,6,32,.188,23,34,.676,109
1126,DET,2018-12-23,95,,ATL,L 95-98,240,34,83,.410,24,54,.444,10,29,.345,17,27,.630,95,36,91,.396,30,68,.441,6,23,.261,20,25,.800,98
1127,DEN,2018-12-16,95,,TOR,W 95-86,240,36,85,.424,26,55,.473,10,30,.333,13,16,.813,95,35,88,.398,28,53,.528,7,35,.200,9,14,.643,86
1128,MIL,2018-12-07,95,,GSW,L 95-105,240,36,92,.391,29,53,.547,7,39,.179,16,23,.696,95,40,89,.449,21,43,.488,19,46,.413,6,7,.857,105
1129,CLE,2018-12-01,95,,TOR,L 95-106,240,34,88,.386,29,66,.439,5,22,.227,22,25,.880,95,39,80,.488,32,54,.593,7,26,.269,21,25,.840,106
1130,CLE,2018-11-26,95,,MIN,L 95-102,240,36,86,.419,26,55,.473,10,31,.323,13,14,.929,95,40,86,.465,32,60,.533,8,26,.308,14,19,.737,102
1131,GSW,2018-11-21,95,,OKC,L 95-123,240,36,83,.434,29,54,.537,7,29,.241,16,24,.667,95,51,106,.481,38,71,.535,13,35,.371,8,15,.533,123
1132,MIA,2018-11-07,95,,SAS,W 95-88,240,36,93,.387,26,61,.426,10,32,.313,13,18,.722,95,31,94,.330,18,62,.290,13,32,.406,13,14,.929,88
1133,ORL,2018-11-02,95,,LAC,L 95-120,240,40,90,.444,36,73,.493,4,17,.235,11,19,.579,95,41,86,.477,28,60,.467,13,26,.500,25,33,.758,120
1134,MIN,2018-10-26,95,,MIL,L 95-125,240,36,112,.321,26,69,.377,10,43,.233,13,18,.722,95,49,92,.533,30,46,.652,19,46,.413,8,11,.727,125
1135,OKC,2018-10-25,95,,BOS,L 95-101,240,37,94,.394,30,66,.455,7,28,.250,14,25,.560,95,33,86,.384,22,54,.407,11,32,.344,24,33,.727,101
1136,NYK,2019-03-09,94,,SAC,L 94-102,240,35,94,.372,25,59,.424,10,35,.286,14,21,.667,94,36,95,.379,24,59,.407,12,36,.333,18,22,.818,102
1137,BRK,2019-02-04,94,,MIL,L 94-113,240,33,102,.324,28,60,.467,5,42,.119,23,28,.821,94,43,101,.426,33,62,.532,10,39,.256,17,25,.680,113
1138,CLE,2019-01-25,94,,MIA,L 94-100,240,37,85,.435,27,55,.491,10,30,.333,10,13,.769,94,37,79,.468,28,56,.500,9,23,.391,17,25,.680,100
1139,NOP,2019-01-23,94,,DET,L 94-98,240,42,91,.462,36,69,.522,6,22,.273,4,9,.444,94,36,89,.404,23,50,.460,13,39,.333,13,19,.684,98
1140,LAC,2019-01-18,94,,GSW,L 94-112,240,31,85,.365,27,60,.450,4,25,.160,28,35,.800,94,42,86,.488,33,49,.673,9,37,.243,19,27,.704,112
1141,MEM,2019-01-02,94,,DET,L 94-101,240,36,78,.462,32,60,.533,4,18,.222,18,21,.857,94,36,83,.434,20,43,.465,16,40,.400,13,22,.591,101
1142,CHI,2018-12-26,94,,MIN,L 94-119,240,39,95,.411,33,72,.458,6,23,.261,10,16,.625,94,46,93,.495,35,61,.574,11,32,.344,16,19,.842,119
1143,MIA,2018-12-22,94,,MIL,W 94-87,240,34,89,.382,24,57,.421,10,32,.313,16,23,.696,94,31,84,.369,22,41,.537,9,43,.209,16,22,.727,87
1144,IND,2018-11-07,94,,PHI,L 94-100,240,37,94,.394,29,63,.460,8,31,.258,12,17,.706,94,36,79,.456,26,47,.553,10,32,.313,18,22,.818,100
1145,IND,2018-11-05,94,,HOU,L 94-98,240,33,75,.440,25,47,.532,8,28,.286,20,30,.667,94,34,76,.447,19,29,.655,15,47,.319,15,16,.938,98
1146,NYK,2019-03-22,93,,DEN,L 93-111,240,34,90,.378,25,58,.431,9,32,.281,16,21,.762,93,40,96,.417,25,58,.431,15,38,.395,16,19,.842,111
1147,MIA,2019-03-17,93,,CHO,W 93-75,240,34,86,.395,21,53,.396,13,33,.394,12,19,.632,93,26,83,.313,19,47,.404,7,36,.194,16,18,.889,75
1148,DAL,2019-03-10,93,,HOU,L 93-94,240,31,75,.413,22,43,.512,9,32,.281,22,27,.815,93,32,88,.364,16,36,.444,16,52,.308,14,22,.636,94
1149,CLE,2019-03-02,93,,DET,L 93-129,240,27,79,.342,14,45,.311,13,34,.382,26,32,.813,93,47,87,.540,27,50,.540,20,37,.541,15,17,.882,129
1150,DET,2019-01-31,93,,DAL,W 93-89,240,33,86,.384,24,53,.453,9,33,.273,18,23,.783,93,36,88,.409,29,63,.460,7,25,.280,10,14,.714,89
1151,SAS,2019-01-14,93,,CHO,L 93-108,240,38,82,.463,31,62,.500,7,20,.350,10,12,.833,93,43,92,.467,30,56,.536,13,36,.361,9,11,.818,108
1152,CHI,2018-12-19,93,,BRK,L 93-96,240,40,91,.440,34,72,.472,6,19,.316,7,10,.700,93,34,74,.459,26,49,.531,8,25,.320,20,25,.800,96
1153,SAS,2018-12-15,93,,CHI,L 93-98,240,32,73,.438,25,52,.481,7,21,.333,22,26,.846,93,37,86,.430,31,57,.544,6,29,.207,18,21,.857,98
1154,GSW,2018-12-12,93,,TOR,L 93-113,240,39,82,.476,33,56,.589,6,26,.231,9,13,.692,93,44,91,.484,35,63,.556,9,28,.321,16,19,.842,113
1155,IND,2018-10-29,93,,POR,L 93-103,240,37,90,.411,31,71,.437,6,19,.316,13,20,.650,93,38,78,.487,28,52,.538,10,26,.385,17,18,.944,103
1156,NYK,2019-03-30,92,,MIA,L 92-100,240,31,77,.403,22,39,.564,9,38,.237,21,25,.840,92,39,90,.433,30,58,.517,9,32,.281,13,17,.765,100
1157,NYK,2019-03-28,92,,TOR,L 92-117,240,31,85,.365,25,59,.424,6,26,.231,24,32,.750,92,40,89,.449,20,42,.476,20,47,.426,17,22,.773,117
1158,BOS,2019-02-27,92,,POR,L 92-97,240,40,86,.465,35,58,.603,5,28,.179,7,10,.700,92,38,90,.422,32,57,.561,6,33,.182,15,20,.750,97
1159,NYK,2019-02-05,92,,DET,L 92-105,240,36,90,.400,27,57,.474,9,33,.273,11,15,.733,92,37,79,.468,25,45,.556,12,34,.353,19,24,.792,105
1160,TOR,2019-01-31,92,,MIL,L 92-105,240,37,93,.398,30,66,.455,7,27,.259,11,13,.846,92,39,79,.494,25,41,.610,14,38,.368,13,17,.765,105
1161,MEM,2019-01-28,92,,DEN,L 92-95,240,35,78,.449,26,46,.565,9,32,.281,13,19,.684,92,37,84,.440,29,48,.604,8,36,.222,13,14,.929,95
1162,CLE,2019-01-02,92,,MIA,L 92-117,240,34,75,.453,21,44,.477,13,31,.419,11,13,.846,92,44,86,.512,28,55,.509,16,31,.516,13,17,.765,117
1163,WAS,2018-12-28,92,,CHI,L 92-101,240,34,85,.400,25,55,.455,9,30,.300,15,18,.833,92,37,79,.468,29,57,.509,8,22,.364,19,25,.760,101
1164,CLE,2018-12-23,92,,CHI,L 92-112,240,38,84,.452,31,61,.508,7,23,.304,9,14,.643,92,43,78,.551,32,56,.571,11,22,.500,15,17,.882,112
1165,MEM,2018-12-12,92,,POR,W 92-83,240,34,82,.415,26,58,.448,8,24,.333,16,24,.667,92,32,87,.368,26,65,.400,6,22,.273,13,16,.813,83
1166,MIA,2018-11-20,92,,BRK,L 92-104,240,36,100,.360,29,68,.426,7,32,.219,13,20,.650,92,38,88,.432,30,57,.526,8,31,.258,20,26,.769,104
1167,DET,2019-04-07,91,,CHO,L 91-104,240,34,92,.370,24,51,.471,10,41,.244,13,15,.867,91,38,88,.432,28,57,.491,10,31,.323,18,23,.783,104
1168,GSW,2019-03-23,91,,DAL,L 91-126,240,36,90,.400,32,60,.533,4,30,.133,15,21,.714,91,44,83,.530,23,34,.676,21,49,.429,17,22,.773,126
1169,ATL,2019-02-14,91,,NYK,L 91-106,240,33,91,.363,23,53,.434,10,38,.263,15,19,.789,91,38,84,.452,26,53,.491,12,31,.387,18,26,.692,106
1170,ORL,2019-01-25,91,,WAS,L 91-95,240,38,84,.452,31,51,.608,7,33,.212,8,12,.667,91,35,79,.443,20,52,.385,15,27,.556,10,12,.833,95
1171,PHO,2019-01-22,91,,MIN,L 91-118,240,37,87,.425,30,53,.566,7,34,.206,10,18,.556,91,45,103,.437,30,61,.492,15,42,.357,13,19,.684,118
1172,CLE,2019-01-04,91,,UTA,L 91-117,240,32,82,.390,21,61,.344,11,21,.524,16,17,.941,91,42,82,.512,28,47,.596,14,35,.400,19,22,.864,117
1173,ORL,2018-12-23,91,,MIA,L 91-115,240,29,70,.414,19,42,.452,10,28,.357,23,32,.719,91,43,85,.506,27,54,.500,16,31,.516,13,19,.684,115
1174,IND,2018-12-18,91,,CLE,L 91-92,240,37,93,.398,33,71,.465,4,22,.182,13,21,.619,91,38,91,.418,32,60,.533,6,31,.194,10,13,.769,92
1175,BRK,2018-11-28,91,,UTA,L 91-101,240,30,86,.349,19,56,.339,11,30,.367,20,28,.714,91,39,82,.476,30,54,.556,9,28,.321,14,21,.667,101
1176,ORL,2018-11-20,91,,TOR,L 91-93,240,34,84,.405,26,54,.481,8,30,.267,15,19,.789,91,39,87,.448,30,53,.566,9,34,.265,6,8,.750,93
1177,CLE,2018-11-01,91,,DEN,L 91-110,240,34,83,.410,29,65,.446,5,18,.278,18,19,.947,91,41,85,.482,31,59,.525,10,26,.385,18,21,.857,110
1178,CLE,2019-04-07,90,,SAS,L 90-112,240,31,79,.392,23,50,.460,8,29,.276,20,27,.741,90,43,82,.524,34,60,.567,9,22,.409,17,22,.773,112
1179,LAL,2019-04-04,90,,GSW,L 90-108,240,37,104,.356,29,67,.433,8,37,.216,8,14,.571,90,43,98,.439,25,52,.481,18,46,.391,4,5,.800,108
1180,DEN,2019-03-31,90,,WAS,L 90-95,240,35,93,.376,28,57,.491,7,36,.194,13,20,.650,90,37,92,.402,31,68,.456,6,24,.250,15,20,.750,95
1181,NOP,2019-03-24,90,,HOU,L 90-113,240,38,92,.413,31,64,.484,7,28,.250,7,10,.700,90,42,86,.488,21,37,.568,21,49,.429,8,9,.889,113
1182,NYK,2019-01-30,90,,DAL,L 90-114,240,32,78,.410,26,52,.500,6,26,.231,20,28,.714,90,45,84,.536,30,46,.652,15,38,.395,9,11,.818,114
1183,POR,2018-12-21,90,,UTA,L 90-120,240,35,87,.402,25,55,.455,10,32,.313,10,18,.556,90,47,85,.553,31,54,.574,16,31,.516,10,17,.588,120
1184,CHI,2018-12-21,90,,ORL,W 90-80,240,33,75,.440,28,58,.483,5,17,.294,19,26,.731,90,28,86,.326,20,53,.377,8,33,.242,16,24,.667,80
1185,ORL,2018-12-19,90,,SAS,L 90-129,240,34,89,.382,22,58,.379,12,31,.387,10,17,.588,90,50,77,.649,38,58,.655,12,19,.632,17,21,.810,129
1186,ORL,2018-12-07,90,,IND,L 90-112,240,36,89,.404,28,56,.500,8,33,.242,10,13,.769,90,44,93,.473,35,67,.522,9,26,.346,15,18,.833,112
1187,MIA,2018-12-04,90,,ORL,L 90-105,240,38,91,.418,26,56,.464,12,35,.343,2,5,.400,90,38,86,.442,24,58,.414,14,28,.500,15,20,.750,105
1188,LAL,2018-11-23,90,,UTA,W 90-83,240,36,79,.456,29,56,.518,7,23,.304,11,18,.611,90,33,85,.388,29,62,.468,4,23,.174,13,17,.765,83
1189,PHO,2018-10-31,90,,SAS,L 90-120,240,35,90,.389,29,66,.439,6,24,.250,14,18,.778,90,46,83,.554,42,65,.646,4,18,.222,24,26,.923,120
1190,BOS,2018-10-22,90,,ORL,L 90-93,240,37,91,.407,28,51,.549,9,40,.225,7,9,.778,90,38,93,.409,28,58,.483,10,35,.286,7,10,.700,93
1191,NYK,2019-04-10,89,,DET,L 89-115,240,31,77,.403,22,47,.468,9,30,.300,18,25,.720,89,41,85,.482,27,52,.519,14,33,.424,19,20,.950,115
1192,DET,2019-04-03,89,,IND,L 89-108,240,31,80,.388,20,39,.513,11,41,.268,16,24,.667,89,43,92,.467,37,71,.521,6,21,.286,16,22,.727,108
1193,UTA,2019-03-11,89,,OKC,L 89-98,240,32,88,.364,19,45,.422,13,43,.302,12,17,.706,89,36,79,.456,29,57,.509,7,22,.318,19,27,.704,98
1194,MIA,2019-01-30,89,,CHI,L 89-105,240,34,89,.382,22,47,.468,12,42,.286,9,13,.692,89,40,78,.513,32,59,.542,8,19,.421,17,21,.810,105
1195,CHI,2018-12-10,89,,SAC,L 89-108,240,34,76,.447,26,48,.542,8,28,.286,13,13,1.000,89,40,88,.455,24,51,.471,16,37,.432,12,15,.800,108
1196,NYK,2018-11-11,89,,ORL,L 89-115,240,31,88,.352,26,60,.433,5,28,.179,22,30,.733,89,44,98,.449,27,56,.482,17,42,.405,10,11,.909,115
1197,MEM,2018-11-07,89,,DEN,W 89-87,240,30,70,.429,22,49,.449,8,21,.381,21,25,.840,89,32,82,.390,24,50,.480,8,32,.250,15,19,.789,87
1198,DET,2018-10-27,89,,BOS,L 89-109,240,33,89,.371,26,52,.500,7,37,.189,16,20,.800,89,39,86,.453,25,52,.481,14,34,.412,17,25,.680,109
1199,HOU,2018-10-24,89,,UTA,L 89-100,240,35,87,.402,24,47,.511,11,40,.275,8,14,.571,89,34,78,.436,24,49,.490,10,29,.345,22,28,.786,100
1200,OKC,2019-03-16,88,,GSW,L 88-110,240,31,96,.323,18,55,.327,13,41,.317,13,23,.565,88,39,83,.470,24,48,.500,15,35,.429,17,22,.773,110
1201,NOP,2019-02-12,88,,ORL,L 88-118,240,36,94,.383,26,65,.400,10,29,.345,6,8,.750,88,42,95,.442,29,63,.460,13,32,.406,21,22,.955,118
1202,MIA,2019-02-02,88,,IND,L 88-95,240,30,71,.423,21,41,.512,9,30,.300,19,26,.731,88,38,89,.427,31,65,.477,7,24,.292,12,17,.706,95
1203,CLE,2019-01-21,88,,CHI,L 88-104,240,31,87,.356,25,60,.417,6,27,.222,20,29,.690,88,36,76,.474,21,46,.457,15,30,.500,17,22,.773,104
1204,MEM,2018-12-08,88,,LAL,L 88-111,240,34,84,.405,28,54,.519,6,30,.200,14,18,.778,88,43,97,.443,27,57,.474,16,40,.400,9,12,.750,111
1205,UTA,2018-11-26,88,,IND,L 88-121,240,34,81,.420,26,50,.520,8,31,.258,12,17,.706,88,49,84,.583,40,66,.606,9,18,.500,14,17,.824,121
1206,MEM,2018-11-12,88,,UTA,L 88-96,240,33,79,.418,29,55,.527,4,24,.167,18,23,.783,88,32,82,.390,23,50,.460,9,32,.281,23,30,.767,96
1207,CHI,2018-11-03,88,,HOU,L 88-96,240,28,71,.394,22,48,.458,6,23,.261,26,27,.963,88,35,83,.422,22,41,.537,13,42,.310,13,20,.650,96
1208,ORL,2018-10-19,88,,CHO,L 88-120,240,36,94,.383,30,63,.476,6,31,.194,10,14,.714,88,43,92,.467,26,54,.481,17,38,.447,17,20,.850,120
1209,MIN,2018-11-18,87,,MEM,L 87-100,240,31,80,.388,19,51,.373,12,29,.414,13,16,.813,87,35,82,.427,23,54,.426,12,28,.429,18,25,.720,100
1210,CHI,2019-04-09,86,,NYK,L 86-96,240,30,83,.361,23,61,.377,7,22,.318,19,29,.655,86,37,93,.398,23,53,.434,14,40,.350,8,13,.615,96
1211,BOS,2018-11-17,86,,UTA,L 86-98,240,35,91,.385,30,58,.517,5,33,.152,11,20,.550,86,35,78,.449,24,40,.600,11,38,.289,17,27,.630,98
1212,SAC,2018-11-10,86,,LAL,L 86-101,240,32,92,.348,26,67,.388,6,25,.240,16,20,.800,86,41,99,.414,29,61,.475,12,38,.316,7,17,.412,101
1213,CLE,2018-11-07,86,,OKC,L 86-95,240,33,89,.371,24,58,.414,9,31,.290,11,13,.846,86,35,84,.417,28,57,.491,7,27,.259,18,26,.692,95
1214,CLE,2018-10-24,86,,BRK,L 86-102,240,34,89,.382,31,71,.437,3,18,.167,15,16,.938,86,38,87,.437,24,53,.453,14,34,.412,12,15,.800,102
1215,MEM,2019-01-21,85,,NOP,L 85-105,240,33,88,.375,24,53,.453,9,35,.257,10,17,.588,85,39,74,.527,30,48,.625,9,26,.346,18,26,.692,105
1216,PHO,2018-11-30,85,,ORL,L 85-99,240,34,84,.405,27,56,.482,7,28,.250,10,14,.714,85,39,82,.476,31,55,.564,8,27,.296,13,18,.722,99
1217,HOU,2018-10-30,85,,POR,L 85-104,240,31,96,.323,21,53,.396,10,43,.233,13,23,.565,85,38,80,.475,30,60,.500,8,20,.400,20,23,.870,104
1218,ATL,2018-10-27,85,,CHI,L 85-97,240,27,84,.321,15,44,.341,12,40,.300,19,23,.826,85,36,83,.434,24,50,.480,12,33,.364,13,16,.813,97
1219,CHO,2019-03-06,84,,MIA,L 84-91,240,30,82,.366,16,46,.348,14,36,.389,10,15,.667,84,38,90,.422,29,64,.453,9,26,.346,6,11,.545,91
1220,NYK,2019-02-03,84,,MEM,L 84-96,240,28,74,.378,16,34,.471,12,40,.300,16,22,.727,84,37,91,.407,28,65,.431,9,26,.346,13,18,.722,96
1221,CHI,2019-01-02,84,,ORL,L 84-112,240,36,86,.419,29,66,.439,7,20,.350,5,8,.625,84,44,76,.579,33,50,.660,11,26,.423,13,18,.722,112
1222,CHO,2019-01-02,84,,DAL,L 84-122,240,32,90,.356,26,58,.448,6,32,.188,14,19,.737,84,44,95,.463,26,50,.520,18,45,.400,16,18,.889,122
1223,UTA,2018-10-22,84,,MEM,L 84-92,240,29,82,.354,21,50,.420,8,32,.250,18,23,.783,84,31,84,.369,22,56,.393,9,28,.321,21,26,.808,92
1224,CHI,2019-03-23,83,,UTA,L 83-114,240,33,92,.359,31,76,.408,2,16,.125,15,20,.750,83,46,95,.484,35,63,.556,11,32,.344,11,15,.733,114
1225,MIL,2019-02-09,83,,ORL,L 83-103,240,31,95,.326,25,60,.417,6,35,.171,15,18,.833,83,44,94,.468,34,67,.507,10,27,.370,5,6,.833,103
1226,DET,2018-12-03,83,,OKC,L 83-110,240,31,94,.330,25,62,.403,6,32,.188,15,19,.789,83,43,85,.506,36,60,.600,7,25,.280,17,20,.850,110
1227,CHI,2018-11-17,83,,TOR,L 83-122,240,30,86,.349,22,59,.373,8,27,.296,15,21,.714,83,48,89,.539,34,54,.630,14,35,.400,12,13,.923,122
1228,PHO,2018-11-06,82,,BRK,L 82-104,240,28,81,.346,19,56,.339,9,25,.360,17,20,.850,82,41,92,.446,32,56,.571,9,36,.250,13,19,.684,104
1229,DAL,2019-03-02,81,,MEM,L 81-111,240,26,85,.306,19,45,.422,7,40,.175,22,33,.667,81,39,78,.500,25,44,.568,14,34,.412,19,24,.792,111
1230,CHI,2018-12-08,77,,BOS,L 77-133,240,31,81,.383,25,57,.439,6,24,.250,9,14,.643,77,50,93,.538,28,50,.560,22,43,.512,11,15,.733,133
