Rk,Team,Date,PTS,,Opp,Result,MP,FG,FGA,FG%,2P,2PA,2P%,3P,3PA,3P%,FT,FTA,FT%,PTS,FG,FGA,FG%,2P,2PA,2P%,3P,3PA,3P%,FT,FTA,FT%,PTS
1,MIN,2016-04-13,144,,NOP,W 144-109,240,56,86,.651,43,58,.741,13,28,.464,19,23,.826,144,40,92,.435,29,62,.468,11,30,.367,18,22,.818,109
2,CHI,2015-12-18,144,,DET,L 144-147 (4OT),340,50,120,.417,45,98,.459,5,22,.227,39,44,.886,144,56,124,.452,48,95,.505,8,29,.276,27,46,.587,147
3,SAC,2016-01-02,142,,PHO,W 142-119,240,53,87,.609,44,64,.688,9,23,.391,27,34,.794,142,43,83,.518,33,54,.611,10,29,.345,23,28,.821,119
4,LAC,2016-01-18,140,,HOU,W 140-132 (OT),265,47,91,.516,25,54,.463,22,37,.595,24,33,.727,140,44,88,.500,33,56,.589,11,32,.344,33,52,.635,132
5,ORL,2016-03-29,139,,BRK,W 139-105,240,56,91,.615,42,64,.656,14,27,.519,13,19,.684,139,37,79,.468,32,65,.492,5,14,.357,26,39,.667,105
6,BOS,2016-02-10,139,,LAC,W 139-134 (OT),265,47,95,.495,34,62,.548,13,33,.394,32,37,.865,139,44,85,.518,32,55,.582,12,30,.400,34,50,.680,134
7,POR,2016-02-19,137,,GSW,W 137-105,240,52,97,.536,35,67,.522,17,30,.567,16,23,.696,137,36,92,.391,24,58,.414,12,34,.353,21,28,.750,105
8,GSW,2016-04-03,136,,POR,W 136-111,240,50,88,.568,32,58,.552,18,30,.600,18,22,.818,136,38,85,.447,29,61,.475,9,24,.375,26,33,.788,111
9,ORL,2015-10-30,136,,OKC,L 136-139 (2OT),290,47,106,.443,35,73,.479,12,33,.364,30,38,.789,136,50,110,.455,42,83,.506,8,27,.296,31,38,.816,139
10,SAC,2016-03-27,133,,DAL,W 133-111,240,51,82,.622,42,62,.677,9,20,.450,22,30,.733,133,42,88,.477,34,64,.531,8,24,.333,19,24,.792,111
11,DAL,2016-03-20,132,,POR,W 132-120 (OT),265,49,89,.551,34,64,.531,15,25,.600,19,23,.826,132,42,104,.404,24,58,.414,18,46,.391,18,28,.643,120
12,MIN,2016-03-05,132,,BRK,W 132-118,240,52,76,.684,42,58,.724,10,18,.556,18,22,.818,132,45,92,.489,36,66,.545,9,26,.346,19,26,.731,118
13,SAC,2015-10-30,132,,LAL,W 132-114,240,52,101,.515,46,79,.582,6,22,.273,22,30,.733,132,41,89,.461,30,55,.545,11,34,.324,21,27,.778,114
14,BRK,2016-03-15,131,,PHI,W 131-114,240,47,90,.522,37,66,.561,10,24,.417,27,31,.871,131,41,88,.466,30,58,.517,11,30,.367,21,26,.808,114
15,OKC,2015-12-29,131,,MIL,W 131-123,240,43,86,.500,35,64,.547,8,22,.364,37,40,.925,131,49,100,.490,39,84,.464,10,16,.625,15,22,.682,123
16,HOU,2016-04-10,130,,LAL,W 130-110,240,50,98,.510,33,57,.579,17,41,.415,13,18,.722,130,41,83,.494,29,55,.527,12,28,.429,16,19,.842,110
17,HOU,2016-03-14,130,,MEM,W 130-81,240,46,85,.541,30,52,.577,16,33,.485,22,34,.647,130,30,101,.297,26,84,.310,4,17,.235,17,28,.607,81
18,ORL,2016-02-28,130,,PHI,W 130-116,240,49,86,.570,39,70,.557,10,16,.625,22,25,.880,130,41,77,.532,36,55,.655,5,22,.227,29,37,.784,116
19,SAS,2016-01-27,130,,HOU,W 130-99,240,50,90,.556,38,67,.567,12,23,.522,18,21,.857,130,28,73,.384,20,43,.465,8,30,.267,35,52,.673,99
20,LAC,2016-01-02,130,,PHI,W 130-99,240,49,81,.605,37,58,.638,12,23,.522,20,25,.800,130,41,89,.461,32,66,.485,9,23,.391,8,17,.471,99
21,CHO,2015-11-03,130,,CHI,W 130-105,240,47,91,.516,33,68,.485,14,23,.609,22,23,.957,130,44,90,.489,30,60,.500,14,30,.467,3,8,.375,105
22,IND,2016-04-10,129,,BRK,W 129-105,240,48,86,.558,37,59,.627,11,27,.407,22,27,.815,129,35,91,.385,21,54,.389,14,37,.378,21,26,.808,105
23,WAS,2016-03-25,129,,MIN,L 129-132 (2OT),290,50,100,.500,37,71,.521,13,29,.448,16,23,.696,129,51,96,.531,43,70,.614,8,26,.308,22,22,1.000,132
24,MIA,2016-03-01,129,,CHI,W 129-111,240,52,77,.675,46,65,.708,6,12,.500,19,25,.760,129,41,90,.456,30,67,.448,11,23,.478,18,26,.692,111
25,DAL,2016-02-21,129,,PHI,W 129-103,240,41,85,.482,28,51,.549,13,34,.382,34,36,.944,129,37,77,.481,25,49,.510,12,28,.429,17,27,.630,103
26,DEN,2016-01-17,129,,IND,W 129-126,240,46,91,.505,36,65,.554,10,26,.385,27,38,.711,129,48,82,.585,39,62,.629,9,20,.450,21,30,.700,126
27,GSW,2016-03-25,128,,DAL,W 128-120,240,43,88,.489,22,43,.512,21,45,.467,21,23,.913,128,43,96,.448,25,61,.410,18,35,.514,16,21,.762,120
28,OKC,2016-03-14,128,,POR,W 128-94,240,49,83,.590,40,66,.606,9,17,.529,21,26,.808,128,31,91,.341,24,64,.375,7,27,.259,25,27,.926,94
29,GSW,2016-03-11,128,,POR,W 128-112,240,40,89,.449,22,49,.449,18,40,.450,30,39,.769,128,37,86,.430,18,50,.360,19,36,.528,19,23,.826,112
30,MIL,2016-02-29,128,,HOU,W 128-121,240,48,81,.593,40,66,.606,8,15,.533,24,33,.727,128,41,87,.471,26,51,.510,15,36,.417,24,35,.686,121
31,DAL,2016-02-28,128,,MIN,W 128-101,240,47,89,.528,34,53,.642,13,36,.361,21,21,1.000,128,34,90,.378,27,67,.403,7,23,.304,26,37,.703,101
32,MEM,2016-02-24,128,,LAL,W 128-119,240,48,85,.565,35,58,.603,13,27,.481,19,29,.655,128,39,88,.443,22,49,.449,17,39,.436,24,33,.727,119
33,BOS,2016-02-07,128,,SAC,W 128-119,240,51,91,.560,38,67,.567,13,24,.542,13,15,.867,128,47,95,.495,37,69,.536,10,26,.385,15,19,.789,119
34,BRK,2016-02-05,128,,SAC,W 128-119,240,48,86,.558,30,58,.517,18,28,.643,14,15,.933,128,45,89,.506,37,63,.587,8,26,.308,21,22,.955,119
35,SAC,2016-01-25,128,,CHO,L 128-129 (2OT),290,48,91,.527,41,68,.603,7,23,.304,25,32,.781,128,44,110,.400,24,66,.364,20,44,.455,21,26,.808,129
36,GSW,2015-12-16,128,,PHO,W 128-103,240,46,88,.523,31,56,.554,15,32,.469,21,27,.778,128,41,91,.451,36,69,.522,5,22,.227,16,18,.889,103
37,GSW,2016-01-27,127,,DAL,W 127-107,240,47,81,.580,33,52,.635,14,29,.483,19,21,.905,127,44,87,.506,33,56,.589,11,31,.355,8,12,.667,107
38,ATL,2015-12-16,127,,PHI,W 127-106,240,48,78,.615,38,57,.667,10,21,.476,21,24,.875,127,39,75,.520,27,49,.551,12,26,.462,16,24,.667,106
39,DET,2015-12-02,127,,PHO,W 127-122 (OT),265,44,87,.506,32,60,.533,12,27,.444,27,44,.614,127,47,97,.485,33,64,.516,14,33,.424,14,15,.933,122
40,CHO,2015-11-23,127,,SAC,W 127-122 (OT),265,49,98,.500,40,69,.580,9,29,.310,20,26,.769,127,52,104,.500,44,73,.603,8,31,.258,10,16,.625,122
41,CHO,2016-03-01,126,,PHO,W 126-92,240,45,93,.484,32,66,.485,13,27,.481,23,27,.852,126,33,91,.363,27,64,.422,6,27,.222,20,27,.741,92
42,CHI,2016-02-21,126,,LAL,W 126-115,240,44,79,.557,31,60,.517,13,19,.684,25,26,.962,126,43,93,.462,36,72,.500,7,21,.333,22,33,.667,115
43,HOU,2015-12-12,126,,LAL,W 126-97,240,47,90,.522,32,57,.561,15,33,.455,17,28,.607,126,35,88,.398,25,56,.446,10,32,.313,17,20,.850,97
44,GSW,2016-04-13,125,,MEM,W 125-104,240,46,87,.529,26,40,.650,20,47,.426,13,16,.813,125,42,98,.429,34,74,.459,8,24,.333,12,16,.750,104
45,GSW,2016-03-14,125,,NOP,W 125-107,240,47,81,.580,35,56,.625,12,25,.480,19,23,.826,125,35,93,.376,28,68,.412,7,25,.280,30,34,.882,107
46,CHO,2016-03-12,125,,HOU,W 125-109,240,48,88,.545,33,57,.579,15,31,.484,14,16,.875,125,43,93,.462,38,67,.567,5,26,.192,18,28,.643,109
47,DEN,2015-12-20,125,,NOP,L 125-130,240,45,96,.469,28,61,.459,17,35,.486,18,22,.818,125,44,78,.564,33,54,.611,11,24,.458,31,39,.795,130
48,BOS,2016-04-08,124,,MIL,W 124-109,240,44,78,.564,38,64,.594,6,14,.429,30,38,.789,124,41,84,.488,34,67,.507,7,17,.412,20,29,.690,109
49,CLE,2016-03-21,124,,DEN,W 124-91,240,48,86,.558,33,55,.600,15,31,.484,13,17,.765,124,32,81,.395,24,59,.407,8,22,.364,19,25,.760,91
50,MIA,2016-03-14,124,,DEN,W 124-119,240,47,79,.595,39,62,.629,8,17,.471,22,28,.786,124,49,93,.527,42,73,.575,7,20,.350,14,20,.700,119
51,WAS,2016-03-14,124,,DET,W 124-81,240,51,90,.567,43,72,.597,8,18,.444,14,18,.778,124,32,79,.405,29,56,.518,3,23,.130,14,22,.636,81
52,LAC,2016-02-22,124,,PHO,W 124-84,240,44,80,.550,31,56,.554,13,24,.542,23,35,.657,124,31,88,.352,24,64,.375,7,24,.292,15,20,.750,84
53,MIN,2016-02-22,124,,BOS,W 124-122,240,43,83,.518,35,68,.515,8,15,.533,30,40,.750,124,49,101,.485,39,73,.534,10,28,.357,14,17,.824,122
54,CHO,2016-01-18,124,,UTA,W 124-119 (2OT),290,41,88,.466,27,61,.443,14,27,.519,28,32,.875,124,44,104,.423,29,59,.492,15,45,.333,16,20,.800,119
55,OKC,2015-11-08,124,,PHO,W 124-103,240,49,94,.521,45,74,.608,4,20,.200,22,30,.733,124,38,84,.452,31,68,.456,7,16,.438,20,26,.769,103
56,IND,2016-04-06,123,,CLE,W 123-109,240,45,80,.563,29,49,.592,16,31,.516,17,22,.773,123,35,74,.473,27,45,.600,8,29,.276,31,34,.912,109
57,UTA,2016-03-28,123,,LAL,W 123-75,240,46,89,.517,29,57,.509,17,32,.531,14,19,.737,123,26,85,.306,19,65,.292,7,20,.350,16,22,.727,75
58,GSW,2016-03-12,123,,PHO,W 123-116,240,42,84,.500,31,51,.608,11,33,.333,28,33,.848,123,45,92,.489,34,63,.540,11,29,.379,15,20,.750,116
59,DET,2016-03-06,123,,POR,W 123-103,240,44,84,.524,32,62,.516,12,22,.545,23,28,.821,123,35,78,.449,24,47,.511,11,31,.355,22,23,.957,103
60,NOP,2016-02-25,123,,OKC,W 123-119,240,47,90,.522,35,70,.500,12,20,.600,17,18,.944,123,47,86,.547,39,67,.582,8,19,.421,17,22,.773,119
61,GSW,2016-02-09,123,,HOU,W 123-110,240,44,94,.468,32,60,.533,12,34,.353,23,26,.885,123,37,87,.425,24,54,.444,13,33,.394,23,35,.657,110
62,MIN,2016-01-27,123,,OKC,L 123-126,240,50,90,.556,45,76,.592,5,14,.357,18,28,.643,123,48,91,.527,38,71,.535,10,20,.500,20,21,.952,126
63,SAS,2016-01-06,123,,UTA,W 123-98,240,52,86,.605,43,65,.662,9,21,.429,10,13,.769,123,37,79,.468,30,61,.492,7,18,.389,17,18,.944,98
64,MIN,2015-12-09,123,,LAL,W 123-122 (OT),265,46,93,.495,39,74,.527,7,19,.368,24,31,.774,123,48,93,.516,39,70,.557,9,23,.391,17,27,.630,122
65,IND,2015-12-08,123,,GSW,L 123-131,240,44,100,.440,30,67,.448,14,33,.424,21,26,.808,123,52,95,.547,36,60,.600,16,35,.457,11,15,.733,131
66,POR,2015-12-03,123,,IND,W 123-111,240,44,85,.518,26,49,.531,18,36,.500,17,20,.850,123,38,88,.432,25,58,.431,13,30,.433,22,24,.917,111
67,IND,2015-11-21,123,,MIL,W 123-86,240,47,91,.516,32,61,.525,15,30,.500,14,23,.609,123,34,79,.430,29,62,.468,5,17,.294,13,19,.684,86
68,TOR,2016-04-12,122,,PHI,W 122-98,240,48,95,.505,38,70,.543,10,25,.400,16,19,.842,122,35,77,.455,20,42,.476,15,35,.429,13,25,.520,98
69,MIA,2016-03-19,122,,CLE,W 122-101,240,46,84,.548,35,65,.538,11,19,.579,19,23,.826,122,40,76,.526,30,52,.577,10,24,.417,11,13,.846,101
70,CHO,2016-03-09,122,,NOP,W 122-113,240,38,82,.463,23,47,.489,15,35,.429,31,38,.816,122,40,85,.471,30,52,.577,10,33,.303,23,28,.821,113
71,DAL,2016-02-26,122,,DEN,W 122-116 (OT),265,45,88,.511,34,59,.576,11,29,.379,21,27,.778,122,43,93,.462,34,64,.531,9,29,.310,21,31,.677,116
72,HOU,2016-01-30,122,,WAS,L 122-123,240,41,86,.477,24,51,.471,17,35,.486,23,33,.697,122,45,86,.523,34,54,.630,11,32,.344,22,30,.733,123
73,NYK,2016-01-26,122,,OKC,L 122-128 (OT),265,44,95,.463,33,72,.458,11,23,.478,23,30,.767,122,46,99,.465,35,79,.443,11,20,.550,25,29,.862,128
74,GSW,2016-01-22,122,,IND,W 122-110,240,43,90,.478,29,57,.509,14,33,.424,22,25,.880,122,44,95,.463,41,78,.526,3,17,.176,19,27,.704,110
75,CLE,2016-01-04,122,,TOR,W 122-100,240,41,74,.554,24,41,.585,17,33,.515,23,26,.885,122,36,73,.493,28,54,.519,8,19,.421,20,29,.690,100
76,GSW,2015-12-28,122,,SAC,W 122-103,240,43,89,.483,23,47,.489,20,42,.476,16,24,.667,122,37,95,.389,24,64,.375,13,31,.419,16,28,.571,103
77,OKC,2015-12-27,122,,DEN,W 122-112,240,48,83,.578,40,68,.588,8,15,.533,18,21,.857,122,46,94,.489,37,69,.536,9,25,.360,11,15,.733,112
78,UTA,2015-12-05,122,,IND,W 122-119 (OT),265,43,92,.467,35,69,.507,8,23,.348,28,37,.757,122,40,93,.430,28,64,.438,12,29,.414,27,34,.794,119
79,NOP,2015-11-22,122,,PHO,W 122-116,240,39,85,.459,28,55,.509,11,30,.367,33,40,.825,122,35,90,.389,18,54,.333,17,36,.472,29,33,.879,116
80,MEM,2015-11-16,122,,OKC,W 122-114,240,37,84,.440,25,67,.373,12,17,.706,36,39,.923,122,41,81,.506,31,57,.544,10,24,.417,22,31,.710,114
81,WAS,2016-04-06,121,,BRK,W 121-103,240,48,95,.505,40,67,.597,8,28,.286,17,20,.850,121,39,92,.424,32,75,.427,7,17,.412,18,24,.750,103
82,MIN,2016-03-28,121,,PHO,W 121-116,240,41,81,.506,34,55,.618,7,26,.269,32,40,.800,121,41,84,.488,26,51,.510,15,33,.455,19,23,.826,116
83,GSW,2016-03-16,121,,NYK,W 121-85,240,46,91,.505,28,54,.519,18,37,.486,11,12,.917,121,36,91,.396,29,72,.403,7,19,.368,6,10,.600,85
84,POR,2016-03-12,121,,ORL,W 121-84,240,47,84,.560,30,49,.612,17,35,.486,10,11,.909,121,34,91,.374,27,65,.415,7,26,.269,9,18,.500,84
85,MEM,2016-03-11,121,,NOP,W 121-114 (OT),265,47,96,.490,41,82,.500,6,14,.429,21,32,.656,121,42,96,.438,35,72,.486,7,24,.292,23,34,.676,114
86,GSW,2016-03-03,121,,OKC,W 121-106,240,47,87,.540,36,53,.679,11,34,.324,16,21,.762,121,40,86,.465,36,66,.545,4,20,.200,22,27,.815,106
87,DAL,2016-03-01,121,,ORL,W 121-108,240,43,77,.558,34,58,.586,9,19,.474,26,31,.839,121,41,91,.451,32,61,.525,9,30,.300,17,20,.850,108
88,NOP,2016-02-19,121,,PHI,W 121-114,240,41,81,.506,34,64,.531,7,17,.412,32,40,.800,121,40,76,.526,28,49,.571,12,27,.444,22,26,.846,114
89,OKC,2016-02-11,121,,NOP,W 121-95,240,45,86,.523,33,54,.611,12,32,.375,19,23,.826,121,38,88,.432,35,72,.486,3,16,.188,16,24,.667,95
90,WAS,2016-02-03,121,,GSW,L 121-134,240,46,91,.505,38,68,.559,8,23,.348,21,30,.700,121,49,93,.527,29,52,.558,20,41,.488,16,29,.552,134
91,MEM,2016-01-30,121,,SAC,W 121-117,240,41,79,.519,33,61,.541,8,18,.444,31,37,.838,121,38,92,.413,29,68,.426,9,24,.375,32,38,.842,117
92,POR,2016-01-23,121,,LAL,W 121-103,240,47,93,.505,37,62,.597,10,31,.323,17,22,.773,121,34,69,.493,27,52,.519,7,17,.412,28,32,.875,103
93,SAS,2016-01-02,121,,HOU,W 121-103,240,45,86,.523,32,62,.516,13,24,.542,18,19,.947,121,37,74,.500,28,52,.538,9,22,.409,20,33,.606,103
94,GSW,2015-12-18,121,,MIL,W 121-112,240,42,87,.483,33,61,.541,9,26,.346,28,37,.757,121,42,91,.462,38,73,.521,4,18,.222,24,28,.857,112
95,ATL,2015-11-24,121,,BOS,W 121-97,240,45,80,.563,33,56,.589,12,24,.500,19,22,.864,121,34,82,.415,25,61,.410,9,21,.429,20,26,.769,97
96,POR,2016-04-06,120,,OKC,W 120-115,240,43,84,.512,28,51,.549,15,33,.455,19,24,.792,120,43,91,.473,34,69,.493,9,22,.409,20,31,.645,115
97,SAC,2016-03-30,120,,WAS,W 120-111,240,47,84,.560,39,66,.591,8,18,.444,18,25,.720,120,43,89,.483,34,63,.540,9,26,.346,16,20,.800,111
98,BRK,2016-03-26,120,,IND,W 120-110,240,42,77,.545,37,66,.561,5,11,.455,31,36,.861,120,37,77,.481,26,53,.491,11,24,.458,25,30,.833,110
99,OKC,2016-03-09,120,,LAC,W 120-108,240,48,91,.527,39,67,.582,9,24,.375,15,18,.833,120,41,81,.506,29,47,.617,12,34,.353,14,23,.609,108
100,CLE,2016-03-05,120,,BOS,W 120-103,240,42,82,.512,32,52,.615,10,30,.333,26,34,.765,120,37,80,.463,27,57,.474,10,23,.435,19,27,.704,103
101,DEN,2016-03-04,120,,BRK,L 120-121 (OT),265,46,96,.479,40,70,.571,6,26,.231,22,25,.880,120,46,91,.505,33,69,.478,13,22,.591,16,21,.762,121
102,CLE,2016-02-10,120,,LAL,W 120-111,240,48,94,.511,35,63,.556,13,31,.419,11,18,.611,120,38,86,.442,25,58,.431,13,28,.464,22,27,.815,111
103,CLE,2016-02-08,120,,SAC,W 120-100,240,45,94,.479,29,59,.492,16,35,.457,14,19,.737,120,36,82,.439,27,59,.458,9,23,.391,19,29,.655,100
104,LAC,2016-01-31,120,,CHI,W 120-93,240,45,84,.536,28,52,.538,17,32,.531,13,19,.684,120,40,93,.430,35,78,.449,5,15,.333,8,11,.727,93
105,GSW,2016-01-25,120,,SAS,W 120-90,240,44,85,.518,33,59,.559,11,26,.423,21,25,.840,120,31,74,.419,26,60,.433,5,14,.357,23,31,.742,90
106,NYK,2016-01-12,120,,BOS,W 120-114,240,43,81,.531,36,61,.590,7,20,.350,27,30,.900,120,42,86,.488,33,57,.579,9,29,.310,21,26,.808,114
107,ATL,2016-01-09,120,,CHI,W 120-105,240,49,94,.521,39,70,.557,10,24,.417,12,15,.800,120,36,83,.434,29,65,.446,7,18,.389,26,31,.839,105
108,HOU,2015-12-05,120,,SAC,W 120-113,240,36,78,.462,20,44,.455,16,34,.471,32,43,.744,120,46,98,.469,36,72,.500,10,26,.385,11,13,.846,113
109,GSW,2015-11-28,120,,SAC,W 120-101,240,39,80,.488,23,50,.460,16,30,.533,26,31,.839,120,39,100,.390,29,75,.387,10,25,.400,13,15,.867,101
110,BOS,2015-11-20,120,,BRK,W 120-95,240,51,87,.586,41,58,.707,10,29,.345,8,10,.800,120,35,89,.393,27,70,.386,8,19,.421,17,24,.708,95
111,PHO,2015-11-16,120,,LAL,W 120-101,240,45,93,.484,34,63,.540,11,30,.367,19,25,.760,120,37,77,.481,28,57,.491,9,20,.450,18,20,.900,101
112,NOP,2015-11-10,120,,DAL,W 120-105,240,46,92,.500,32,59,.542,14,33,.424,14,18,.778,120,39,88,.443,34,68,.500,5,20,.250,22,26,.846,105
113,NOP,2015-10-31,120,,GSW,L 120-134,240,46,100,.460,38,78,.487,8,22,.364,20,23,.870,120,46,84,.548,29,54,.537,17,30,.567,25,35,.714,134
114,ORL,2016-04-03,119,,MEM,W 119-107,240,43,90,.478,33,64,.516,10,26,.385,23,29,.793,119,41,89,.461,33,68,.485,8,21,.381,17,26,.654,107
115,OKC,2016-03-31,119,,LAC,W 119-117,240,45,87,.517,35,55,.636,10,32,.313,19,24,.792,119,42,76,.553,26,47,.553,16,29,.552,17,22,.773,117
116,PHO,2016-03-23,119,,LAL,W 119-107,240,47,93,.505,34,65,.523,13,28,.464,12,20,.600,119,39,93,.419,32,66,.485,7,27,.259,22,26,.846,107
117,GSW,2016-03-07,119,,ORL,W 119-113,240,42,84,.500,26,49,.531,16,35,.457,19,27,.704,119,40,90,.444,35,69,.507,5,21,.238,28,34,.824,113
118,DAL,2016-02-09,119,,UTA,L 119-121 (OT),265,36,75,.480,25,46,.543,11,29,.379,36,41,.878,119,48,92,.522,42,66,.636,6,26,.231,19,27,.704,121
119,LAL,2016-02-02,119,,MIN,W 119-115,240,40,80,.500,28,54,.519,12,26,.462,27,35,.771,119,46,80,.575,42,63,.667,4,17,.235,19,25,.760,115
120,ORL,2016-01-31,119,,BOS,W 119-114,240,44,82,.537,34,58,.586,10,24,.417,21,35,.600,119,39,93,.419,23,47,.489,16,46,.348,20,25,.800,114
121,NYK,2016-01-18,119,,PHI,W 119-113 (2OT),290,43,97,.443,35,77,.455,8,20,.400,25,30,.833,119,45,102,.441,35,74,.473,10,28,.357,13,25,.520,113
122,DET,2015-12-16,119,,BOS,W 119-116,240,38,78,.487,27,57,.474,11,21,.524,32,43,.744,119,43,89,.483,33,64,.516,10,25,.400,20,24,.833,116
123,BOS,2015-12-11,119,,GSW,L 119-124 (2OT),290,49,114,.430,37,81,.457,12,33,.364,9,16,.563,119,42,107,.393,33,76,.434,9,31,.290,31,39,.795,124
124,GSW,2015-11-06,119,,DEN,W 119-104,240,46,93,.495,29,56,.518,17,37,.459,10,18,.556,119,39,92,.424,31,68,.456,8,24,.333,18,22,.818,104
125,HOU,2015-11-04,119,,ORL,W 119-114 (OT),265,42,88,.477,31,54,.574,11,34,.324,24,34,.706,119,46,91,.505,39,71,.549,7,20,.350,15,19,.789,114
126,GSW,2015-11-02,119,,MEM,W 119-69,240,43,84,.512,32,59,.542,11,25,.440,22,30,.733,119,26,96,.271,23,73,.315,3,23,.130,14,20,.700,69
127,MIA,2016-04-10,118,,ORL,W 118-96,240,43,77,.558,37,57,.649,6,20,.300,26,30,.867,118,37,83,.446,30,65,.462,7,18,.389,15,19,.789,96
128,ATL,2016-04-09,118,,BOS,W 118-107,240,46,88,.523,29,55,.527,17,33,.515,9,11,.818,118,40,90,.444,29,62,.468,11,28,.393,16,24,.667,107
129,HOU,2016-04-03,118,,OKC,W 118-110,240,41,102,.402,28,60,.467,13,42,.310,23,26,.885,118,38,82,.463,31,55,.564,7,27,.259,27,32,.844,110
130,DET,2016-03-23,118,,ORL,W 118-102,240,43,80,.538,32,56,.571,11,24,.458,21,25,.840,118,39,98,.398,31,73,.425,8,25,.320,16,19,.842,102
131,SAS,2016-03-17,118,,POR,W 118-110,240,45,86,.523,37,70,.529,8,16,.500,20,22,.909,118,39,89,.438,29,67,.433,10,22,.455,22,30,.733,110
132,CHI,2016-03-17,118,,BRK,W 118-102,240,46,94,.489,35,70,.500,11,24,.458,15,15,1.000,118,40,86,.465,34,65,.523,6,21,.286,16,20,.800,102
133,CHO,2016-03-11,118,,DET,W 118-103,240,42,83,.506,32,58,.552,10,25,.400,24,29,.828,118,36,76,.474,27,46,.587,9,30,.300,22,27,.815,103
134,OKC,2016-02-27,118,,GSW,L 118-121 (OT),265,46,96,.479,37,70,.529,9,26,.346,17,26,.654,118,45,95,.474,31,63,.492,14,32,.438,17,25,.680,121
135,NYK,2016-01-20,118,,UTA,W 118-111 (OT),265,47,90,.522,40,73,.548,7,17,.412,17,18,.944,118,37,86,.430,25,59,.424,12,27,.444,25,31,.806,111
136,DAL,2016-01-18,118,,BOS,W 118-113 (OT),265,40,93,.430,24,59,.407,16,34,.471,22,24,.917,118,40,94,.426,28,64,.438,12,30,.400,21,26,.808,113
137,SAC,2016-01-07,118,,LAL,W 118-115,240,47,85,.553,41,64,.641,6,21,.286,18,27,.667,118,41,76,.539,33,52,.635,8,24,.333,25,29,.862,115
138,DAL,2015-12-26,118,,CHI,W 118-111,240,40,87,.460,24,54,.444,16,33,.485,22,28,.786,118,42,78,.538,34,57,.596,8,21,.381,19,26,.731,111
139,BRK,2015-12-23,118,,DAL,L 118-119 (OT),265,51,101,.505,41,82,.500,10,19,.526,6,14,.429,118,45,82,.549,29,48,.604,16,34,.471,13,15,.867,119
140,OKC,2015-12-19,118,,LAL,W 118-78,240,46,84,.548,37,65,.569,9,19,.474,17,25,.680,118,30,86,.349,22,58,.379,8,28,.286,10,17,.588,78
141,SAS,2015-12-14,118,,UTA,W 118-81,240,42,75,.560,33,54,.611,9,21,.429,25,27,.926,118,32,79,.405,29,68,.426,3,11,.273,14,17,.824,81
142,DET,2015-12-12,118,,IND,W 118-96,240,45,90,.500,32,61,.525,13,29,.448,15,19,.789,118,41,82,.500,38,66,.576,3,16,.188,11,18,.611,96
143,MIL,2015-11-25,118,,SAC,L 118-129,240,42,88,.477,29,57,.509,13,31,.419,21,27,.778,118,44,77,.571,34,54,.630,10,23,.435,31,37,.838,129
144,PHO,2015-11-12,118,,LAC,W 118-104,240,44,83,.530,30,53,.566,14,30,.467,16,21,.762,118,40,90,.444,31,64,.484,9,26,.346,15,28,.536,104
145,DAL,2015-11-11,118,,LAC,W 118-108,240,42,76,.553,31,52,.596,11,24,.458,23,30,.767,118,37,86,.430,25,59,.424,12,27,.444,22,33,.667,108
146,CLE,2015-11-10,118,,UTA,W 118-114,240,37,74,.500,26,50,.520,11,24,.458,33,43,.767,118,40,82,.488,30,60,.500,10,22,.455,24,28,.857,114
147,BOS,2015-11-06,118,,WAS,W 118-98,240,44,97,.454,32,67,.478,12,30,.400,18,23,.783,118,36,88,.409,28,63,.444,8,25,.320,18,23,.783,98
148,PHO,2015-11-04,118,,SAC,W 118-97,240,45,83,.542,31,60,.517,14,23,.609,14,22,.636,118,40,84,.476,29,60,.483,11,24,.458,6,12,.500,97
149,CHO,2016-04-13,117,,ORL,W 117-103,240,47,86,.547,36,57,.632,11,29,.379,12,19,.632,117,42,91,.462,34,64,.531,8,27,.296,11,18,.611,103
150,GSW,2016-04-05,117,,MIN,L 117-124 (OT),265,49,98,.500,37,63,.587,12,35,.343,7,8,.875,117,44,86,.512,36,69,.522,8,17,.471,28,36,.778,124
151,GSW,2016-03-27,117,,PHI,W 117-105,240,44,83,.530,30,50,.600,14,33,.424,15,20,.750,117,42,90,.467,32,60,.533,10,30,.333,11,12,.917,105
152,WAS,2016-03-16,117,,CHI,W 117-96,240,43,88,.489,30,67,.448,13,21,.619,18,24,.750,117,35,87,.402,29,67,.433,6,20,.300,20,23,.870,96
153,TOR,2016-03-04,117,,POR,W 117-115,240,34,67,.507,28,55,.509,6,12,.500,43,54,.796,117,39,83,.470,28,56,.500,11,27,.407,26,35,.743,115
154,DEN,2016-03-02,117,,LAL,W 117-107,240,38,78,.487,26,55,.473,12,23,.522,29,38,.763,117,35,79,.443,24,48,.500,11,31,.355,26,32,.813,107
155,UTA,2016-02-23,117,,HOU,W 117-114 (OT),265,38,74,.514,28,50,.560,10,24,.417,31,38,.816,117,36,87,.414,25,53,.472,11,34,.324,31,41,.756,114
156,MIN,2016-02-10,117,,TOR,W 117-112,240,35,76,.461,31,62,.500,4,14,.286,43,53,.811,117,39,86,.453,29,55,.527,10,31,.323,24,32,.750,112
157,OKC,2016-02-03,117,,ORL,W 117-114,240,44,93,.473,35,66,.530,9,27,.333,20,25,.800,117,47,95,.495,37,72,.514,10,23,.435,10,12,.833,114
158,CLE,2016-01-30,117,,SAS,W 117-103,240,45,82,.549,36,59,.610,9,23,.391,18,21,.857,117,40,81,.494,34,63,.540,6,18,.333,17,21,.810,103
159,MIN,2016-01-17,117,,PHO,W 117-87,240,39,69,.565,32,51,.627,7,18,.389,32,40,.800,117,35,81,.432,32,66,.485,3,15,.200,14,25,.560,87
160,WAS,2016-01-16,117,,BOS,L 117-119,240,40,89,.449,34,67,.507,6,22,.273,31,36,.861,117,39,88,.443,30,59,.508,9,29,.310,32,36,.889,119
161,BOS,2016-01-15,117,,PHO,W 117-103,240,42,96,.438,28,66,.424,14,30,.467,19,29,.655,117,35,89,.393,25,62,.403,10,27,.370,23,28,.821,103
162,CHI,2016-01-05,117,,MIL,W 117-106,240,46,83,.554,41,64,.641,5,19,.263,20,20,1.000,117,46,102,.451,40,86,.465,6,16,.375,8,14,.571,106
163,DAL,2016-01-05,117,,SAC,W 117-116 (2OT),290,45,98,.459,33,69,.478,12,29,.414,15,23,.652,117,47,99,.475,35,67,.522,12,32,.375,10,14,.714,116
164,CHO,2015-12-30,117,,LAC,L 117-122,240,38,88,.432,29,58,.500,9,30,.300,32,36,.889,117,37,71,.521,22,41,.537,15,30,.500,33,41,.805,122
165,ATL,2015-12-26,117,,NYK,W 117-98,240,47,88,.534,39,63,.619,8,25,.320,15,18,.833,117,39,81,.481,32,57,.561,7,24,.292,13,17,.765,98
166,CLE,2015-11-23,117,,ORL,W 117-103,240,43,81,.531,25,46,.543,18,35,.514,13,22,.591,117,40,81,.494,30,59,.508,10,22,.455,13,21,.619,103
167,OKC,2015-11-22,117,,DAL,W 117-114,240,47,90,.522,38,68,.559,9,22,.409,14,18,.778,117,44,83,.530,34,64,.531,10,19,.526,16,28,.571,114
168,LAC,2015-11-19,117,,GSW,L 117-124,240,44,88,.500,31,59,.525,13,29,.448,16,24,.667,117,38,73,.521,21,43,.488,17,30,.567,31,36,.861,124
169,OKC,2015-11-01,117,,DEN,W 117-93,240,45,86,.523,32,61,.525,13,25,.520,14,18,.778,117,35,92,.380,26,66,.394,9,26,.346,14,19,.737,93
170,HOU,2016-04-13,116,,SAC,W 116-81,240,47,97,.485,37,62,.597,10,35,.286,12,19,.632,116,32,96,.333,21,59,.356,11,37,.297,6,13,.462,81
171,NOP,2016-04-11,116,,CHI,L 116-121,240,41,80,.513,29,54,.537,12,26,.462,22,28,.786,116,44,77,.571,34,54,.630,10,23,.435,23,26,.885,121
172,POR,2016-03-31,116,,BOS,W 116-109,240,41,90,.456,27,56,.482,14,34,.412,20,27,.741,116,37,88,.420,28,64,.438,9,24,.375,26,34,.765,109
173,SAC,2016-03-25,116,,PHO,W 116-94,240,40,90,.444,33,68,.485,7,22,.318,29,39,.744,116,35,94,.372,26,62,.419,9,32,.281,15,23,.652,94
174,HOU,2016-03-18,116,,MIN,W 116-111,240,48,85,.565,37,56,.661,11,29,.379,9,14,.643,116,43,85,.506,37,69,.536,6,16,.375,19,24,.792,111
175,ATL,2016-03-17,116,,DEN,W 116-98,240,40,80,.500,28,54,.519,12,26,.462,24,28,.857,116,39,87,.448,33,65,.508,6,22,.273,14,17,.824,98
176,ORL,2016-03-15,116,,DEN,W 116-110,240,44,81,.543,36,56,.643,8,25,.320,20,25,.800,116,40,80,.500,31,56,.554,9,24,.375,21,24,.875,110
177,DEN,2016-03-12,116,,WAS,W 116-100,240,42,80,.525,34,56,.607,8,24,.333,24,29,.828,116,36,86,.419,29,65,.446,7,21,.333,21,29,.724,100
178,DEN,2016-03-10,116,,PHO,W 116-98,240,44,91,.484,31,63,.492,13,28,.464,15,19,.789,116,33,89,.371,27,61,.443,6,28,.214,26,33,.788,98
179,BOS,2016-03-09,116,,MEM,W 116-96,240,41,87,.471,26,55,.473,15,32,.469,19,24,.792,116,32,84,.381,25,58,.431,7,26,.269,25,31,.806,96
180,POR,2016-03-08,116,,WAS,W 116-109 (OT),265,41,89,.461,31,65,.477,10,24,.417,24,31,.774,116,45,99,.455,37,79,.468,8,20,.400,11,23,.478,109
181,DEN,2016-03-06,116,,DAL,W 116-114 (OT),265,44,107,.411,35,81,.432,9,26,.346,19,25,.760,116,41,93,.441,25,52,.481,16,41,.390,16,20,.800,114
182,MIL,2016-03-04,116,,MIN,W 116-101,240,43,83,.518,29,59,.492,14,24,.583,16,20,.800,116,42,87,.483,35,65,.538,7,22,.318,10,14,.714,101
183,BOS,2016-03-02,116,,POR,W 116-93,240,43,107,.402,36,81,.444,7,26,.269,23,24,.958,116,34,84,.405,23,55,.418,11,29,.379,14,20,.700,93
184,SAC,2016-02-29,116,,OKC,L 116-131,240,48,107,.449,41,82,.500,7,25,.280,13,19,.684,116,47,82,.573,33,48,.688,14,34,.412,23,26,.885,131
185,WAS,2016-02-29,116,,PHI,W 116-108,240,43,89,.483,37,69,.536,6,20,.300,24,31,.774,116,43,89,.483,33,57,.579,10,32,.313,12,21,.571,108
186,SAC,2016-02-19,116,,DEN,W 116-110,240,41,83,.494,31,62,.500,10,21,.476,24,31,.774,116,42,90,.467,34,66,.515,8,24,.333,18,26,.692,110
187,CHI,2016-02-19,116,,TOR,W 116-106,240,48,93,.516,41,77,.532,7,16,.438,13,20,.650,116,38,88,.432,33,70,.471,5,18,.278,25,34,.735,106
188,POR,2016-02-10,116,,HOU,W 116-103,240,41,89,.461,33,61,.541,8,28,.286,26,34,.765,116,37,77,.481,26,43,.605,11,34,.324,18,34,.529,103
189,GSW,2016-02-06,116,,OKC,W 116-108,240,48,97,.495,41,71,.577,7,26,.269,13,20,.650,116,36,85,.424,29,63,.460,7,22,.318,29,37,.784,108
190,OKC,2016-01-29,116,,HOU,W 116-108,240,41,86,.477,33,67,.493,8,19,.421,26,30,.867,116,36,95,.379,27,56,.482,9,39,.231,27,43,.628,108
191,BRK,2016-01-24,116,,OKC,W 116-106,240,45,94,.479,37,77,.481,8,17,.471,18,25,.720,116,43,93,.462,35,67,.522,8,26,.308,12,19,.632,106
192,NOP,2016-01-23,116,,MIL,W 116-99,240,43,94,.457,26,63,.413,17,31,.548,13,17,.765,116,39,74,.527,33,59,.559,6,15,.400,15,18,.833,99
193,ORL,2016-01-22,116,,CHO,L 116-120 (OT),265,45,91,.495,34,68,.500,11,23,.478,15,19,.789,116,45,101,.446,35,74,.473,10,27,.370,20,22,.909,120
194,GSW,2016-01-14,116,,LAL,W 116-98,240,43,86,.500,30,53,.566,13,33,.394,17,20,.850,116,40,90,.444,36,67,.537,4,23,.174,14,24,.583,98
195,IND,2016-01-12,116,,PHO,W 116-97,240,41,79,.519,31,55,.564,10,24,.417,24,31,.774,116,36,89,.404,28,64,.438,8,25,.320,17,27,.630,97
196,SAC,2016-01-09,116,,GSW,L 116-128,240,43,92,.467,35,69,.507,8,23,.348,22,29,.759,116,49,87,.563,30,50,.600,19,37,.514,11,15,.733,128
197,IND,2015-12-31,116,,MIL,L 116-120,240,41,82,.500,28,52,.538,13,30,.433,21,26,.808,116,45,77,.584,39,63,.619,6,14,.429,24,35,.686,120
198,MIA,2015-12-20,116,,POR,W 116-109,240,43,75,.573,31,52,.596,12,23,.522,18,26,.692,116,39,80,.488,26,46,.565,13,34,.382,18,22,.818,109
199,DET,2015-11-30,116,,HOU,W 116-105,240,45,85,.529,37,62,.597,8,23,.348,18,37,.486,116,35,88,.398,24,61,.393,11,27,.407,24,28,.857,105
200,HOU,2015-11-27,116,,PHI,W 116-114,240,38,73,.521,27,53,.509,11,20,.550,29,37,.784,116,40,83,.482,24,48,.500,16,35,.457,18,26,.692,114
201,HOU,2015-11-27,116,,PHI,W 116-114,240,38,73,.521,27,53,.509,11,20,.550,29,37,.784,116,40,83,.482,24,48,.500,16,35,.457,18,26,.692,114
202,MIA,2015-11-19,116,,SAC,W 116-109,240,42,89,.472,35,65,.538,7,24,.292,25,33,.758,116,43,84,.512,31,61,.508,12,23,.522,11,20,.550,109
203,CHO,2015-11-18,116,,BRK,W 116-111,240,39,80,.488,28,55,.509,11,25,.440,27,36,.750,116,44,91,.484,39,76,.513,5,15,.333,18,22,.818,111
204,MIN,2015-11-12,116,,GSW,L 116-129,240,43,87,.494,40,78,.513,3,9,.333,27,36,.750,116,48,89,.539,30,51,.588,18,38,.474,15,16,.938,129
205,CHI,2016-04-13,115,,PHI,W 115-105,240,39,83,.470,24,59,.407,15,24,.625,22,27,.815,115,37,81,.457,20,46,.435,17,35,.486,14,18,.778,105
206,HOU,2016-04-07,115,,PHO,L 115-124,240,42,74,.568,28,41,.683,14,33,.424,17,28,.607,115,44,94,.468,32,63,.508,12,31,.387,24,29,.828,124
207,DET,2016-03-19,115,,BRK,W 115-103,240,46,94,.489,36,70,.514,10,24,.417,13,21,.619,115,42,80,.525,37,66,.561,5,14,.357,14,21,.667,103
208,DET,2016-03-18,115,,SAC,W 115-108,240,44,92,.478,32,66,.485,12,26,.462,15,18,.833,115,40,79,.506,36,64,.563,4,15,.267,24,29,.828,108
209,GSW,2016-03-09,115,,UTA,W 115-94,240,48,84,.571,35,54,.648,13,30,.433,6,10,.600,115,32,79,.405,24,59,.407,8,20,.400,22,31,.710,94
210,NOP,2016-03-07,115,,SAC,W 115-112,240,45,94,.479,38,69,.551,7,25,.280,18,26,.692,115,41,83,.494,34,58,.586,7,25,.280,23,27,.852,112
211,PHI,2016-02-23,115,,ORL,L 115-124,240,43,79,.544,33,58,.569,10,21,.476,19,26,.731,115,41,85,.482,34,71,.479,7,14,.500,35,41,.854,124
212,POR,2016-02-21,115,,UTA,W 115-111,240,39,90,.433,27,58,.466,12,32,.375,25,38,.658,115,43,86,.500,35,70,.500,8,16,.500,17,23,.739,111
213,DEN,2016-02-05,115,,CHI,W 115-110,240,39,87,.448,33,69,.478,6,18,.333,31,44,.705,115,43,93,.462,38,81,.469,5,12,.417,19,27,.704,110
214,HOU,2016-02-02,115,,MIA,W 115-102,240,44,84,.524,28,49,.571,16,35,.457,11,16,.688,115,38,85,.447,32,68,.471,6,17,.353,20,27,.741,102
215,CLE,2016-01-27,115,,PHO,W 115-93,240,45,81,.556,34,53,.642,11,28,.393,14,16,.875,115,33,70,.471,25,50,.500,8,20,.400,19,25,.760,93
216,HOU,2016-01-24,115,,DAL,W 115-104,240,43,89,.483,28,45,.622,15,44,.341,14,21,.667,115,36,79,.456,21,49,.429,15,30,.500,17,22,.773,104
217,CLE,2016-01-21,115,,LAC,W 115-102,240,42,83,.506,29,55,.527,13,28,.464,18,24,.750,115,36,80,.450,30,55,.545,6,25,.240,24,36,.667,102
218,NOP,2016-01-21,115,,DET,W 115-99,240,46,86,.535,41,74,.554,5,12,.417,18,18,1.000,115,38,91,.418,31,61,.508,7,30,.233,16,20,.800,99
219,TOR,2016-01-20,115,,BOS,W 115-109,240,46,83,.554,35,54,.648,11,29,.379,12,17,.706,115,43,85,.506,31,59,.525,12,26,.462,11,15,.733,109
220,POR,2016-01-10,115,,OKC,W 115-110,240,42,100,.420,23,56,.411,19,44,.432,12,14,.857,115,37,76,.487,27,55,.491,10,21,.476,26,36,.722,110
221,WAS,2016-01-06,115,,CLE,L 115-121,240,42,76,.553,28,52,.538,14,24,.583,17,27,.630,115,48,89,.539,36,60,.600,12,29,.414,13,19,.684,121
222,DET,2016-01-04,115,,ORL,W 115-89,240,43,88,.489,29,58,.500,14,30,.467,15,21,.714,115,36,81,.444,30,61,.492,6,20,.300,11,11,1.000,89
223,DET,2015-12-31,115,,MIN,W 115-90,240,41,86,.477,27,51,.529,14,35,.400,19,28,.679,115,35,86,.407,30,72,.417,5,14,.357,15,19,.789,90
224,HOU,2015-12-29,115,,ATL,L 115-121,240,39,72,.542,28,52,.538,11,20,.550,26,39,.667,115,43,99,.434,29,58,.500,14,41,.341,21,25,.840,121
225,NOP,2015-12-23,115,,POR,W 115-89,240,41,85,.482,28,54,.519,13,31,.419,20,23,.870,115,33,95,.347,26,67,.388,7,28,.250,16,24,.667,89
226,SAS,2015-12-18,115,,LAC,W 115-107,240,43,87,.494,33,68,.485,10,19,.526,19,24,.792,115,36,72,.500,26,48,.542,10,24,.417,25,40,.625,107
227,CHI,2015-12-14,115,,PHI,W 115-96,240,43,85,.506,35,63,.556,8,22,.364,21,26,.808,115,38,92,.413,27,61,.443,11,31,.355,9,13,.692,96
228,CLE,2015-11-19,115,,MIL,W 115-100,240,40,71,.563,29,47,.617,11,24,.458,24,30,.800,115,38,73,.521,35,65,.538,3,8,.375,21,26,.808,100
229,WAS,2015-11-17,115,,MIL,W 115-86,240,37,70,.529,25,48,.521,12,22,.545,29,41,.707,115,31,72,.431,21,51,.412,10,21,.476,14,24,.583,86
230,GSW,2015-11-17,115,,TOR,W 115-110,240,43,80,.538,32,51,.627,11,29,.379,18,27,.667,115,37,79,.468,31,61,.508,6,18,.333,30,39,.769,110
231,NOP,2015-11-06,115,,ATL,L 115-121,240,42,84,.500,32,54,.593,10,30,.333,21,24,.875,115,41,77,.532,32,56,.571,9,21,.429,30,35,.857,121
232,POR,2015-11-05,115,,MEM,W 115-96,240,44,87,.506,29,57,.509,15,30,.500,12,20,.600,115,37,77,.481,30,57,.526,7,20,.350,15,21,.714,96
233,PHO,2016-04-13,114,,LAC,W 114-105,240,45,99,.455,38,73,.521,7,26,.269,17,22,.773,114,43,96,.448,34,65,.523,9,31,.290,10,12,.833,105
234,SAC,2016-04-09,114,,OKC,W 114-112,240,45,94,.479,32,62,.516,13,32,.406,11,20,.550,114,39,81,.481,26,49,.531,13,32,.406,21,28,.750,112
235,LAC,2016-04-03,114,,WAS,W 114-109,240,43,85,.506,35,66,.530,8,19,.421,20,33,.606,114,43,94,.457,32,64,.500,11,30,.367,12,21,.571,109
236,LAC,2016-03-28,114,,BOS,W 114-90,240,44,84,.524,33,59,.559,11,25,.440,15,18,.833,114,31,89,.348,24,70,.343,7,19,.368,21,27,.778,90
237,GSW,2016-03-23,114,,LAC,W 114-98,240,39,87,.448,24,53,.453,15,34,.441,21,28,.750,114,36,85,.424,28,57,.491,8,28,.286,18,27,.667,98
238,DET,2016-03-16,114,,ATL,L 114-118,240,39,84,.464,31,59,.525,8,25,.320,28,39,.718,114,39,89,.438,27,55,.491,12,34,.353,28,34,.824,118
239,UTA,2016-03-11,114,,WAS,W 114-93,240,38,67,.567,29,51,.569,9,16,.563,29,38,.763,114,35,80,.438,28,56,.500,7,24,.292,16,22,.727,93
240,MIL,2016-03-09,114,,MIA,W 114-108,240,42,80,.525,38,72,.528,4,8,.500,26,37,.703,114,42,80,.525,36,65,.554,6,15,.400,18,19,.947,108
241,DET,2016-02-28,114,,TOR,W 114-101,240,41,71,.577,29,48,.604,12,23,.522,20,27,.741,114,39,80,.488,29,59,.492,10,21,.476,13,18,.722,101
242,ORL,2016-02-25,114,,GSW,L 114-130,240,41,90,.456,31,64,.484,10,26,.385,22,28,.786,114,53,88,.602,40,63,.635,13,25,.520,11,16,.688,130
243,TOR,2016-02-24,114,,MIN,W 114-105,240,41,85,.482,31,59,.525,10,26,.385,22,26,.846,114,37,74,.500,31,64,.484,6,10,.600,25,33,.758,105
244,CLE,2016-02-24,114,,CHO,W 114-103,240,45,91,.495,32,59,.542,13,32,.406,11,17,.647,114,37,76,.487,27,47,.574,10,29,.345,19,27,.704,103
245,MIA,2016-02-20,114,,WAS,W 114-94,240,47,96,.490,45,83,.542,2,13,.154,18,28,.643,114,40,99,.404,37,77,.481,3,22,.136,11,21,.524,94
246,OKC,2016-02-01,114,,WAS,W 114-98,240,43,83,.518,36,61,.590,7,22,.318,21,27,.778,114,40,86,.465,33,60,.550,7,26,.269,11,15,.733,98
247,NOP,2016-01-28,114,,SAC,W 114-105,240,43,98,.439,33,72,.458,10,26,.385,18,24,.750,114,40,89,.449,30,61,.492,10,28,.357,15,20,.750,105
248,CLE,2016-01-25,114,,MIN,W 114-107,240,45,89,.506,34,58,.586,11,31,.355,13,20,.650,114,41,84,.488,37,68,.544,4,16,.250,21,23,.913,107
249,HOU,2016-01-20,114,,DET,L 114-123,240,43,95,.453,31,71,.437,12,24,.500,16,18,.889,114,38,80,.475,26,50,.520,12,30,.400,35,59,.593,123
250,NOP,2016-01-19,114,,MIN,W 114-99,240,42,83,.506,32,60,.533,10,23,.435,20,23,.870,114,36,76,.474,33,62,.532,3,14,.214,24,31,.774,99
251,ATL,2016-01-16,114,,BRK,W 114-86,240,44,79,.557,36,50,.720,8,29,.276,18,24,.750,114,34,78,.436,28,58,.483,6,20,.300,12,19,.632,86
252,PHI,2016-01-16,114,,POR,W 114-89,240,42,76,.553,32,53,.604,10,23,.435,20,30,.667,114,34,87,.391,29,58,.500,5,29,.172,16,24,.667,89
253,LAC,2016-01-10,114,,NOP,W 114-111 (OT),265,42,89,.472,30,53,.566,12,36,.333,18,34,.529,114,40,100,.400,32,70,.457,8,30,.267,23,29,.793,111
254,DAL,2015-12-30,114,,GSW,W 114-91,240,42,82,.512,28,55,.509,14,27,.519,16,20,.800,114,33,81,.407,26,62,.419,7,19,.368,18,24,.750,91
255,SAS,2015-12-16,114,,WAS,W 114-95,240,44,83,.530,36,61,.590,8,22,.364,18,23,.783,114,35,84,.417,32,69,.464,3,15,.200,22,25,.880,95
256,DEN,2015-12-14,114,,HOU,W 114-108,240,42,82,.512,34,57,.596,8,25,.320,22,25,.880,114,41,87,.471,23,47,.489,18,40,.450,8,11,.727,108
257,SAC,2015-12-08,114,,UTA,W 114-106,240,43,77,.558,33,49,.673,10,28,.357,18,24,.750,114,38,92,.413,23,56,.411,15,36,.417,15,22,.682,106
258,NOP,2015-12-04,114,,CLE,W 114-108 (OT),265,42,85,.494,33,60,.550,9,25,.360,21,31,.677,114,39,89,.438,29,56,.518,10,33,.303,20,24,.833,108
259,ORL,2015-11-27,114,,MIL,W 114-90,240,43,82,.524,31,55,.564,12,27,.444,16,22,.727,114,31,74,.419,23,48,.479,8,26,.308,20,22,.909,90
260,PHO,2015-11-25,114,,NOP,L 114-120,240,44,96,.458,34,70,.486,10,26,.385,16,20,.800,114,42,81,.519,32,59,.542,10,22,.455,26,34,.765,120
261,SAS,2015-11-07,114,,CHO,W 114-94,240,45,81,.556,36,60,.600,9,21,.429,15,23,.652,114,34,73,.466,28,54,.519,6,19,.316,20,31,.645,94
262,ATL,2015-11-07,114,,WAS,W 114-99,240,43,92,.467,30,59,.508,13,33,.394,15,15,1.000,114,38,78,.487,30,54,.556,8,24,.333,15,17,.882,99
263,LAC,2015-10-31,114,,SAC,W 114-109,240,39,76,.513,35,59,.593,4,17,.235,32,46,.696,114,43,101,.426,37,83,.446,6,18,.333,17,25,.680,109
264,WAS,2016-04-10,113,,CHO,W 113-98,240,42,80,.525,33,59,.559,9,21,.429,20,28,.714,113,28,81,.346,16,48,.333,12,33,.364,30,35,.857,98
265,CHO,2016-04-08,113,,BRK,W 113-99,240,41,83,.494,27,46,.587,14,37,.378,17,20,.850,113,39,92,.424,29,67,.433,10,25,.400,11,20,.550,99
266,MIL,2016-04-01,113,,ORL,W 113-110,240,47,86,.547,43,69,.623,4,17,.235,15,25,.600,113,46,86,.535,38,62,.613,8,24,.333,10,12,.833,110
267,OKC,2016-03-24,113,,UTA,W 113-91,240,45,83,.542,36,61,.590,9,22,.409,14,22,.636,113,35,73,.479,30,51,.588,5,22,.227,16,23,.696,91
268,CLE,2016-03-23,113,,MIL,W 113-104,240,40,83,.482,30,49,.612,10,34,.294,23,27,.852,113,43,80,.538,36,64,.563,7,16,.438,11,15,.733,104
269,MIN,2016-03-23,113,,SAC,W 113-104,240,45,80,.563,40,67,.597,5,13,.385,18,32,.563,113,42,91,.462,34,71,.479,8,20,.400,12,23,.522,104
270,MEM,2016-03-19,113,,LAC,W 113-102,240,40,82,.488,36,67,.537,4,15,.267,29,36,.806,113,31,66,.470,19,36,.528,12,30,.400,28,39,.718,102
271,WAS,2016-02-28,113,,CLE,W 113-99,240,39,79,.494,28,48,.583,11,31,.355,24,34,.706,113,32,80,.400,23,51,.451,9,29,.310,26,30,.867,99
272,LAL,2016-02-19,113,,SAS,L 113-119,240,40,81,.494,30,59,.508,10,22,.455,23,26,.885,113,48,88,.545,42,76,.553,6,12,.500,17,18,.944,119
273,BOS,2016-01-29,113,,ORL,W 113-94,240,43,86,.500,33,62,.532,10,24,.417,17,21,.810,113,32,79,.405,25,59,.424,7,20,.350,23,29,.793,94
274,WAS,2016-01-28,113,,DEN,L 113-117,240,39,88,.443,28,60,.467,11,28,.393,24,30,.800,113,41,81,.506,32,63,.508,9,18,.500,26,33,.788,117
275,PHI,2016-01-26,113,,PHO,W 113-103,240,39,81,.481,28,53,.528,11,28,.393,24,36,.667,113,39,83,.470,33,64,.516,6,19,.316,19,28,.679,103
276,DET,2016-01-16,113,,GSW,W 113-95,240,47,101,.465,39,78,.500,8,23,.348,11,20,.550,113,34,94,.362,24,69,.348,10,25,.400,17,23,.739,95
277,OKC,2016-01-15,113,,MIN,W 113-93,240,47,89,.528,42,66,.636,5,23,.217,14,22,.636,113,34,85,.400,29,73,.397,5,12,.417,20,23,.870,93
278,LAL,2016-01-08,113,,OKC,L 113-117,240,40,84,.476,31,58,.534,9,26,.346,24,25,.960,113,45,89,.506,40,72,.556,5,17,.294,22,26,.846,117
279,TOR,2016-01-03,113,,CHI,L 113-115,240,42,92,.457,29,61,.475,13,31,.419,16,19,.842,113,42,82,.512,33,61,.541,9,21,.429,22,25,.880,115
280,MIL,2015-12-23,113,,PHI,W 113-100,240,51,85,.600,46,73,.630,5,12,.417,6,8,.750,113,37,81,.457,30,61,.492,7,20,.350,19,29,.655,100
281,BOS,2015-12-21,113,,MIN,W 113-99,240,46,89,.517,34,64,.531,12,25,.480,9,16,.563,113,36,79,.456,34,66,.515,2,13,.154,25,32,.781,99
282,WAS,2015-12-21,113,,SAC,W 113-99,240,42,83,.506,28,59,.475,14,24,.583,15,17,.882,113,37,91,.407,30,69,.435,7,22,.318,18,22,.818,99
283,ORL,2015-12-16,113,,CHO,W 113-98,240,43,77,.558,29,53,.547,14,24,.583,13,15,.867,113,36,79,.456,22,45,.489,14,34,.412,12,15,.800,98
284,LAL,2015-12-15,113,,MIL,W 113-95,240,41,89,.461,31,62,.500,10,27,.370,21,25,.840,113,40,85,.471,36,72,.500,4,13,.308,11,20,.550,95
285,CHO,2015-11-20,113,,PHI,W 113-88,240,40,81,.494,28,56,.500,12,25,.480,21,22,.955,113,32,79,.405,24,53,.453,8,26,.308,16,22,.727,88
286,MIL,2015-10-30,113,,WAS,L 113-118,240,42,82,.512,35,58,.603,7,24,.292,22,28,.786,113,35,68,.515,23,47,.489,12,21,.571,36,44,.818,118
287,OKC,2016-04-11,112,,LAL,W 112-79,240,42,96,.438,30,59,.508,12,37,.324,16,27,.593,112,23,81,.284,16,50,.320,7,31,.226,26,30,.867,79
288,ORL,2016-04-08,112,,MIA,W 112-109,240,43,82,.524,38,71,.535,5,11,.455,21,28,.750,112,45,100,.450,37,78,.474,8,22,.364,11,21,.524,109
289,DET,2016-04-08,112,,WAS,W 112-99,240,36,77,.468,22,45,.489,14,32,.438,26,29,.897,112,38,86,.442,32,67,.478,6,19,.316,17,23,.739,99
290,GSW,2016-04-07,112,,SAS,W 112-101,240,45,83,.542,33,58,.569,12,25,.480,10,11,.909,112,39,80,.488,32,64,.500,7,16,.438,16,23,.696,101
291,CLE,2016-04-03,112,,CHO,W 112-103,240,45,83,.542,29,54,.537,16,29,.552,6,13,.462,112,34,76,.447,25,50,.500,9,26,.346,26,27,.963,103
292,HOU,2016-03-25,112,,TOR,W 112-109,240,42,81,.519,30,59,.508,12,22,.545,16,35,.457,112,39,94,.415,26,63,.413,13,31,.419,18,26,.692,109
293,DET,2016-03-25,112,,CHO,W 112-105,240,42,91,.462,34,61,.557,8,30,.267,20,26,.769,112,37,93,.398,23,63,.365,14,30,.467,17,22,.773,105
294,SAS,2016-03-23,112,,MIA,W 112-88,240,42,81,.519,34,67,.507,8,14,.571,20,24,.833,112,37,77,.481,30,63,.476,7,14,.500,7,12,.583,88
295,DAL,2016-03-18,112,,GSW,L 112-130,240,41,93,.441,32,64,.500,9,29,.310,21,22,.955,112,48,95,.505,26,57,.456,22,38,.579,12,14,.857,130
296,NOP,2016-03-18,112,,POR,L 112-117,240,40,83,.482,30,62,.484,10,21,.476,22,28,.786,112,36,78,.462,27,51,.529,9,27,.333,36,40,.900,117
297,TOR,2016-03-12,112,,MIA,W 112-104 (OT),265,37,84,.440,31,66,.470,6,18,.333,32,38,.842,112,37,98,.378,28,73,.384,9,25,.360,21,26,.808,104
298,LAL,2016-03-06,112,,GSW,W 112-95,240,41,87,.471,32,62,.516,9,25,.360,21,22,.955,112,37,92,.402,33,62,.532,4,30,.133,17,21,.810,95
299,BOS,2016-02-25,112,,MIL,W 112-107,240,41,84,.488,36,61,.590,5,23,.217,25,33,.758,112,42,87,.483,38,72,.528,4,15,.267,19,25,.760,107
300,MIA,2016-02-24,112,,GSW,L 112-118,240,40,86,.465,34,72,.472,6,14,.429,26,31,.839,112,42,90,.467,29,62,.468,13,28,.464,21,25,.840,118
301,POR,2016-02-23,112,,BRK,W 112-104,240,40,80,.500,30,57,.526,10,23,.435,22,25,.880,112,43,90,.478,40,78,.513,3,12,.250,15,19,.789,104
302,LAC,2016-02-20,112,,GSW,L 112-115,240,42,94,.447,29,58,.500,13,36,.361,15,18,.833,112,42,82,.512,31,51,.608,11,31,.355,20,26,.769,115
303,MIL,2016-02-09,112,,BOS,W 112-111,240,45,88,.511,38,69,.551,7,19,.368,15,23,.652,112,39,84,.464,29,55,.527,10,29,.345,23,24,.958,111
304,IND,2016-02-06,112,,DET,W 112-104,240,41,76,.539,35,65,.538,6,11,.545,24,29,.828,112,38,79,.481,26,46,.565,12,33,.364,16,31,.516,104
305,MIN,2016-02-06,112,,CHI,W 112-105,240,45,87,.517,44,75,.587,1,12,.083,21,22,.955,112,40,85,.471,32,65,.492,8,20,.400,17,19,.895,105
306,DEN,2016-02-01,112,,TOR,W 112-93,240,45,83,.542,35,61,.574,10,22,.455,12,15,.800,112,29,78,.372,21,53,.396,8,25,.320,27,39,.692,93
307,ATL,2016-02-01,112,,DAL,W 112-97,240,42,80,.525,28,45,.622,14,35,.400,14,19,.737,112,31,85,.365,24,59,.407,7,26,.269,28,38,.737,97
308,POR,2016-01-26,112,,SAC,W 112-97,240,44,90,.489,35,60,.583,9,30,.300,15,19,.789,112,36,86,.419,29,67,.433,7,19,.368,18,32,.563,97
309,TOR,2016-01-24,112,,LAC,W 112-94,240,41,83,.494,29,61,.475,12,22,.545,18,26,.692,112,34,76,.447,26,50,.520,8,26,.308,18,30,.600,94
310,TOR,2016-01-18,112,,BRK,W 112-100,240,43,85,.506,30,61,.492,13,24,.542,13,18,.722,112,39,76,.513,34,62,.548,5,14,.357,17,19,.895,100
311,SAS,2016-01-17,112,,DAL,W 112-83,240,42,90,.467,37,70,.529,5,20,.250,23,28,.821,112,29,81,.358,23,58,.397,6,23,.261,19,25,.760,83
312,DEN,2016-01-13,112,,GSW,W 112-110,240,37,87,.425,32,65,.492,5,22,.227,33,37,.892,112,42,88,.477,32,62,.516,10,26,.385,16,20,.800,110
313,OKC,2016-01-06,112,,MEM,W 112-94,240,38,83,.458,30,66,.455,8,17,.471,28,33,.848,112,35,90,.389,28,69,.406,7,21,.333,17,24,.708,94
314,SAS,2015-12-30,112,,PHO,W 112-79,240,43,76,.566,37,62,.597,6,14,.429,20,33,.606,112,32,81,.395,27,63,.429,5,18,.278,10,18,.556,79
315,MEM,2015-12-27,112,,LAL,W 112-96,240,45,80,.563,39,64,.609,6,16,.375,16,22,.727,112,32,84,.381,24,55,.436,8,29,.276,24,32,.750,96
316,MEM,2015-12-14,112,,WAS,W 112-95,240,44,78,.564,34,63,.540,10,15,.667,14,15,.933,112,37,86,.430,28,62,.452,9,24,.375,12,20,.600,95
317,POR,2015-12-01,112,,DAL,L 112-115 (OT),265,41,100,.410,26,60,.433,15,40,.375,15,17,.882,112,43,94,.457,34,65,.523,9,29,.310,20,24,.833,115
318,SAC,2015-11-30,112,,DAL,W 112-98,240,36,79,.456,27,48,.563,9,31,.290,31,44,.705,112,36,84,.429,27,47,.574,9,37,.243,17,22,.773,98
319,GSW,2015-11-04,112,,LAC,W 112-108,240,39,85,.459,29,59,.492,10,26,.385,24,31,.774,112,43,88,.489,35,66,.530,8,22,.364,14,22,.636,108
320,OKC,2015-10-28,112,,SAS,W 112-106,240,42,86,.488,35,67,.522,7,19,.368,21,22,.955,112,45,93,.484,40,78,.513,5,15,.333,11,13,.846,106
321,BOS,2015-10-28,112,,PHI,W 112-95,240,39,85,.459,31,61,.508,8,24,.333,26,27,.963,112,34,83,.410,27,61,.443,7,22,.318,20,23,.870,95
322,POR,2015-10-28,112,,NOP,W 112-94,240,44,88,.500,32,56,.571,12,32,.375,12,14,.857,112,36,91,.396,25,58,.431,11,33,.333,11,18,.611,94
323,BRK,2016-04-11,111,,WAS,L 111-120,240,44,98,.449,34,67,.507,10,31,.323,13,21,.619,111,46,89,.517,37,64,.578,9,25,.360,19,24,.792,120
324,TOR,2016-04-08,111,,IND,W 111-98,240,37,68,.544,27,46,.587,10,22,.455,27,38,.711,111,37,83,.446,29,56,.518,8,27,.296,16,20,.800,98
325,ORL,2016-03-26,111,,CHI,W 111-89,240,48,89,.539,41,70,.586,7,19,.368,8,12,.667,111,36,88,.409,30,64,.469,6,24,.250,11,17,.647,89
326,OKC,2016-03-26,111,,SAS,W 111-92,240,44,85,.518,37,65,.569,7,20,.350,16,18,.889,111,37,86,.430,33,71,.465,4,15,.267,14,17,.824,92
327,OKC,2016-03-22,111,,HOU,W 111-107,240,41,91,.451,33,56,.589,8,35,.229,21,29,.724,111,40,92,.435,27,55,.491,13,37,.351,14,17,.824,107
328,IND,2016-03-19,111,,OKC,L 111-115,240,40,83,.482,31,61,.508,9,22,.409,22,30,.733,111,42,80,.525,32,52,.615,10,28,.357,21,26,.808,115
329,PHI,2016-03-12,111,,DET,L 111-125,240,39,84,.464,29,59,.492,10,25,.400,23,27,.852,111,49,91,.538,40,73,.548,9,18,.500,18,22,.818,125
330,SAC,2016-03-09,111,,CLE,L 111-120,240,40,84,.476,32,62,.516,8,22,.364,23,32,.719,111,39,90,.433,26,46,.565,13,44,.295,29,35,.829,120
331,PHO,2016-02-27,111,,MEM,W 111-106,240,37,80,.463,25,48,.521,12,32,.375,25,35,.714,111,32,80,.400,26,60,.433,6,20,.300,36,42,.857,106
332,DET,2016-02-24,111,,PHI,W 111-91,240,39,83,.470,28,55,.509,11,28,.393,22,34,.647,111,33,83,.398,26,60,.433,7,23,.304,18,26,.692,91
333,PHO,2016-02-21,111,,SAS,L 111-118,240,43,93,.462,34,69,.493,9,24,.375,16,22,.727,111,43,82,.524,33,66,.500,10,16,.625,22,34,.647,118
334,UTA,2016-02-19,111,,BOS,W 111-93,240,37,68,.544,27,45,.600,10,23,.435,27,44,.614,111,30,81,.370,23,56,.411,7,25,.280,26,36,.722,93
335,ATL,2016-02-19,111,,MIA,L 111-115,240,41,87,.471,25,51,.490,16,36,.444,13,13,1.000,111,44,88,.500,36,68,.529,8,20,.400,19,28,.679,115
336,DET,2016-02-04,111,,NYK,W 111-105,240,40,79,.506,31,62,.500,9,17,.529,22,33,.667,111,36,84,.429,30,62,.484,6,22,.273,27,34,.794,105
337,SAC,2016-02-01,111,,MIL,W 111-104,240,39,86,.453,30,60,.500,9,26,.346,24,30,.800,111,42,84,.500,34,64,.531,8,20,.400,12,17,.706,104
338,TOR,2016-01-30,111,,DET,W 111-107,240,36,78,.462,32,64,.500,4,14,.286,35,47,.745,111,39,87,.448,30,58,.517,9,29,.310,20,34,.588,107
339,IND,2016-01-28,111,,ATL,W 111-92,240,38,78,.487,29,63,.460,9,15,.600,26,30,.867,111,33,83,.398,26,55,.473,7,28,.250,19,21,.905,92
340,BOS,2016-01-27,111,,DEN,W 111-103,240,41,96,.427,32,68,.471,9,28,.321,20,24,.833,111,36,84,.429,29,63,.460,7,21,.333,24,32,.750,103
341,NOP,2016-01-25,111,,HOU,L 111-112,240,42,91,.462,29,62,.468,13,29,.448,14,25,.560,111,38,80,.475,19,40,.475,19,40,.475,17,21,.810,112
342,PHI,2016-01-14,111,,CHI,L 111-115 (OT),265,42,93,.452,30,66,.455,12,27,.444,15,20,.750,111,41,88,.466,34,71,.479,7,17,.412,26,31,.839,115
343,GSW,2016-01-11,111,,MIA,W 111-103,240,41,86,.477,34,63,.540,7,23,.304,22,30,.733,111,41,91,.451,34,72,.472,7,19,.368,14,16,.875,103
344,PHO,2016-01-06,111,,CHO,W 111-102,240,41,84,.488,22,51,.431,19,33,.576,10,13,.769,111,38,87,.437,27,59,.458,11,28,.393,15,22,.682,102
345,GSW,2016-01-04,111,,CHO,W 111-101,240,45,87,.517,30,53,.566,15,34,.441,6,6,1.000,111,38,86,.442,31,65,.477,7,21,.333,18,19,.947,101
346,NYK,2016-01-03,111,,ATL,W 111-97,240,44,88,.500,33,62,.532,11,26,.423,12,14,.857,111,37,84,.440,29,58,.500,8,26,.308,15,20,.750,97
347,GSW,2016-01-02,111,,DEN,W 111-108 (OT),265,43,86,.500,33,58,.569,10,28,.357,15,23,.652,111,44,105,.419,39,75,.520,5,30,.167,15,23,.652,108
348,DAL,2015-12-12,111,,WAS,L 111-114,240,38,89,.427,24,56,.429,14,33,.424,21,24,.875,111,44,85,.518,30,56,.536,14,29,.483,12,15,.800,114
349,DEN,2015-12-11,111,,MIN,W 111-108 (OT),265,38,86,.442,27,58,.466,11,28,.393,24,33,.727,111,38,87,.437,31,68,.456,7,19,.368,25,29,.862,108
350,DET,2015-12-06,111,,LAL,W 111-91,240,41,93,.441,32,69,.464,9,24,.375,20,26,.769,111,32,80,.400,27,62,.435,5,18,.278,22,29,.759,91
351,NYK,2015-11-29,111,,HOU,L 111-116 (OT),265,45,78,.577,39,60,.650,6,18,.333,15,17,.882,111,43,95,.453,36,70,.514,7,25,.280,23,36,.639,116
352,BOS,2015-11-27,111,,WAS,W 111-78,240,42,97,.433,30,64,.469,12,33,.364,15,19,.789,111,27,84,.321,22,66,.333,5,18,.278,19,22,.864,78
353,LAC,2015-11-27,111,,NOP,W 111-90,240,40,83,.482,33,64,.516,7,19,.368,24,30,.800,111,34,94,.362,29,74,.392,5,20,.250,17,23,.739,90
354,GSW,2015-11-24,111,,LAL,W 111-77,240,45,92,.489,33,57,.579,12,35,.343,9,15,.600,111,31,83,.373,28,62,.452,3,21,.143,12,16,.750,77
355,BRK,2015-11-22,111,,BOS,W 111-101,240,40,79,.506,35,64,.547,5,15,.333,26,33,.788,111,35,82,.427,21,45,.467,14,37,.378,17,21,.810,101
356,SAC,2015-11-13,111,,BRK,W 111-109,240,40,94,.426,29,67,.433,11,27,.407,20,26,.769,111,42,89,.472,34,68,.500,8,21,.381,17,21,.810,109
357,LAL,2015-10-28,111,,MIN,L 111-112,240,35,90,.389,26,56,.464,9,34,.265,32,35,.914,111,38,83,.458,33,63,.524,5,20,.250,31,37,.838,112
358,GSW,2015-10-27,111,,NOP,W 111-95,240,41,96,.427,32,66,.485,9,30,.300,20,22,.909,111,35,83,.422,29,65,.446,6,18,.333,19,27,.704,95
359,CLE,2016-04-13,110,,DET,L 110-112 (OT),265,46,97,.474,39,79,.494,7,18,.389,11,15,.733,110,37,85,.435,21,52,.404,16,33,.485,22,28,.786,112
360,LAC,2016-04-12,110,,MEM,W 110-84,240,41,75,.547,29,50,.580,12,25,.480,16,21,.762,110,35,86,.407,30,66,.455,5,20,.250,9,14,.643,84
361,NOP,2016-04-08,110,,LAL,W 110-102,240,42,79,.532,32,57,.561,10,22,.455,16,21,.762,110,34,81,.420,23,57,.404,11,24,.458,23,27,.852,102
362,POR,2016-04-02,110,,MIA,W 110-93,240,41,79,.519,31,64,.484,10,15,.667,18,23,.783,110,34,88,.386,28,69,.406,6,19,.316,19,27,.704,93
363,MIA,2016-03-28,110,,BRK,W 110-99,240,48,84,.571,43,68,.632,5,16,.313,9,12,.750,110,41,77,.532,38,66,.576,3,11,.273,14,18,.778,99
364,SAS,2016-03-25,110,,MEM,W 110-104,240,44,77,.571,37,59,.627,7,18,.389,15,18,.833,110,44,83,.530,37,65,.569,7,18,.389,9,13,.692,104
365,DEN,2016-03-08,110,,NYK,W 110-94,240,45,99,.455,39,78,.500,6,21,.286,14,19,.737,110,33,75,.440,27,57,.474,6,18,.333,22,26,.846,94
366,NOP,2016-02-27,110,,MIN,L 110-112,240,39,84,.464,29,57,.509,10,27,.370,22,26,.846,110,42,84,.500,37,69,.536,5,15,.333,23,30,.767,112
367,DEN,2016-02-23,110,,SAC,L 110-114,240,41,100,.410,31,73,.425,10,27,.370,18,22,.818,110,43,83,.518,36,66,.545,7,17,.412,21,28,.750,114
368,ORL,2016-02-19,110,,DAL,W 110-104 (OT),265,41,102,.402,28,67,.418,13,35,.371,15,17,.882,110,37,89,.416,18,48,.375,19,41,.463,11,18,.611,104
369,PHI,2016-02-10,110,,SAC,L 110-114,240,42,91,.462,27,56,.482,15,35,.429,11,17,.647,110,44,87,.506,40,71,.563,4,16,.250,22,29,.759,114
370,ATL,2016-02-08,110,,ORL,L 110-117 (OT),265,43,92,.467,31,63,.492,12,29,.414,12,20,.600,110,46,93,.495,37,64,.578,9,29,.310,16,22,.727,117
371,MEM,2016-02-06,110,,DAL,L 110-114 (OT),265,44,88,.500,35,65,.538,9,23,.391,13,23,.565,110,38,88,.432,23,50,.460,15,38,.395,23,33,.697,114
372,SAS,2016-02-03,110,,NOP,W 110-97,240,42,81,.519,33,66,.500,9,15,.600,17,18,.944,110,41,90,.456,38,71,.535,3,19,.158,12,14,.857,97
373,DET,2016-01-27,110,,PHI,W 110-97,240,39,91,.429,34,70,.486,5,21,.238,27,38,.711,110,39,82,.476,32,63,.508,7,19,.368,12,17,.706,97
374,BOS,2016-01-22,110,,CHI,W 110-101,240,43,96,.448,35,73,.479,8,23,.348,16,21,.762,110,38,89,.427,35,76,.461,3,13,.231,22,26,.846,101
375,BRK,2016-01-13,110,,NYK,W 110-104,240,45,86,.523,36,69,.522,9,17,.529,11,14,.786,110,41,91,.451,34,69,.493,7,22,.318,15,23,.652,104
376,HOU,2015-12-31,110,,GSW,L 110-114,240,36,78,.462,24,48,.500,12,30,.400,26,29,.897,110,43,84,.512,32,61,.525,11,23,.478,17,27,.630,114
377,OKC,2015-12-31,110,,PHO,W 110-106,240,42,80,.525,35,59,.593,7,21,.333,19,24,.792,110,43,82,.524,35,62,.565,8,20,.400,12,13,.923,106
378,POR,2015-12-30,110,,DEN,W 110-103,240,41,87,.471,29,55,.527,12,32,.375,16,20,.800,110,37,87,.425,25,60,.417,12,27,.444,17,19,.895,103
379,NOP,2015-12-26,110,,HOU,W 110-108,240,38,75,.507,25,51,.490,13,24,.542,21,26,.808,110,38,84,.452,23,51,.451,15,33,.455,17,20,.850,108
380,UTA,2015-12-21,110,,PHO,W 110-89,240,36,79,.456,27,54,.500,9,25,.360,29,37,.784,110,31,79,.392,24,55,.436,7,24,.292,20,22,.909,89
381,POR,2015-12-12,110,,NYK,L 110-112,240,41,89,.461,35,68,.515,6,21,.286,22,29,.759,110,39,75,.520,30,54,.556,9,21,.429,25,28,.893,112
382,BRK,2015-12-08,110,,HOU,W 110-105,240,45,81,.556,38,63,.603,7,18,.389,13,16,.813,110,39,82,.476,24,47,.511,15,35,.429,12,17,.706,105
383,ORL,2015-11-29,110,,BOS,W 110-91,240,45,93,.484,36,68,.529,9,25,.360,11,16,.688,110,36,88,.409,31,61,.508,5,27,.185,14,20,.700,91
384,OKC,2015-11-25,110,,BRK,W 110-99,240,41,78,.526,31,54,.574,10,24,.417,18,21,.857,110,43,94,.457,40,81,.494,3,13,.231,10,12,.833,99
385,MEM,2015-11-24,110,,DAL,W 110-96,240,37,86,.430,30,65,.462,7,21,.333,29,37,.784,110,30,77,.390,19,43,.442,11,34,.324,25,28,.893,96
386,OKC,2015-11-18,110,,NOP,W 110-103,240,38,85,.447,31,68,.456,7,17,.412,27,40,.675,110,43,95,.453,35,63,.556,8,32,.250,9,9,1.000,103
387,SAC,2015-11-06,110,,HOU,L 110-116,240,40,93,.430,31,65,.477,9,28,.321,21,29,.724,110,40,82,.488,25,46,.543,15,36,.417,21,27,.778,116
388,HOU,2015-11-02,110,,OKC,W 110-105,240,41,89,.461,32,60,.533,9,29,.310,19,29,.655,110,40,84,.476,30,61,.492,10,23,.435,15,22,.682,105
389,WAS,2015-10-31,110,,NYK,L 110-117,240,38,90,.422,32,68,.471,6,22,.273,28,33,.848,110,41,86,.477,32,67,.478,9,19,.474,26,32,.813,117
390,PHO,2015-10-30,110,,POR,W 110-92,240,37,83,.446,33,65,.508,4,18,.222,32,42,.762,110,34,86,.395,25,62,.403,9,24,.375,15,19,.789,92
391,WAS,2016-04-13,109,,ATL,W 109-98,240,42,88,.477,33,60,.550,9,28,.321,16,30,.533,109,32,81,.395,21,52,.404,11,29,.379,23,31,.742,98
392,CLE,2016-04-11,109,,ATL,W 109-94,240,40,83,.482,29,54,.537,11,29,.379,18,20,.900,109,39,87,.448,31,57,.544,8,30,.267,8,15,.533,94
393,POR,2016-03-23,109,,DAL,W 109-103,240,40,89,.449,33,62,.532,7,27,.259,22,25,.880,109,42,96,.438,33,66,.500,9,30,.300,10,11,.909,103
394,CHI,2016-03-21,109,,SAC,W 109-102,240,41,91,.451,29,67,.433,12,24,.500,15,23,.652,109,40,88,.455,31,59,.525,9,29,.310,13,16,.813,102
395,NOP,2016-03-20,109,,LAC,W 109-105,240,35,71,.493,28,50,.560,7,21,.333,32,40,.800,109,33,82,.402,23,43,.535,10,39,.256,29,42,.690,105
396,ATL,2016-03-19,109,,HOU,W 109-97,240,44,88,.500,30,50,.600,14,38,.368,7,12,.583,109,33,84,.393,28,61,.459,5,23,.217,26,31,.839,97
397,BOS,2016-03-16,109,,OKC,L 109-130,240,40,93,.430,35,74,.473,5,19,.263,24,27,.889,109,47,96,.490,35,67,.522,12,29,.414,24,30,.800,130
398,SAS,2016-03-10,109,,CHI,W 109-101,240,44,93,.473,38,76,.500,6,17,.353,15,19,.789,109,39,86,.453,28,64,.438,11,22,.500,12,13,.923,101
399,GSW,2016-03-01,109,,ATL,W 109-105 (OT),265,41,103,.398,29,67,.433,12,36,.333,15,17,.882,109,37,80,.463,25,47,.532,12,33,.364,19,24,.792,105
400,CHI,2016-02-24,109,,WAS,W 109-104,240,44,88,.500,36,65,.554,8,23,.348,13,16,.813,109,38,90,.422,29,62,.468,9,28,.321,19,26,.731,104
401,WAS,2016-02-23,109,,NOP,W 109-89,240,43,94,.457,31,68,.456,12,26,.462,11,17,.647,109,29,83,.349,23,60,.383,6,23,.261,25,33,.758,89
402,ATL,2016-02-20,109,,MIL,L 109-117 (2OT),290,44,106,.415,35,65,.538,9,41,.220,12,18,.667,109,46,104,.442,43,87,.494,3,17,.176,22,32,.688,117
403,MEM,2016-02-19,109,,MIN,W 109-104,240,40,82,.488,33,61,.541,7,21,.333,22,28,.786,109,31,75,.413,20,49,.408,11,26,.423,31,31,1.000,104
404,BRK,2016-02-19,109,,NYK,W 109-98,240,42,86,.488,34,69,.493,8,17,.471,17,20,.850,109,36,82,.439,26,56,.464,10,26,.385,16,18,.889,98
405,IND,2016-01-30,109,,DEN,W 109-105 (OT),265,44,100,.440,35,73,.479,9,27,.333,12,16,.750,109,40,87,.460,36,69,.522,4,18,.222,21,25,.840,105
406,POR,2016-01-29,109,,CHO,W 109-91,240,45,92,.489,38,72,.528,7,20,.350,12,16,.750,109,31,80,.388,21,51,.412,10,29,.345,19,28,.679,91
407,OKC,2016-01-20,109,,CHO,W 109-95,240,39,83,.470,30,59,.508,9,24,.375,22,30,.733,109,34,81,.420,25,54,.463,9,27,.333,18,21,.857,95
408,UTA,2016-01-16,109,,LAL,W 109-82,240,41,83,.494,29,59,.492,12,24,.500,15,18,.833,109,31,90,.344,22,67,.328,9,23,.391,11,18,.611,82
409,NOP,2016-01-15,109,,CHO,W 109-107,240,43,87,.494,31,60,.517,12,27,.444,11,13,.846,109,42,86,.488,28,51,.549,14,35,.400,9,12,.750,107
410,PHI,2016-01-04,109,,MIN,W 109-99,240,48,87,.552,44,67,.657,4,20,.200,9,14,.643,109,39,73,.534,37,68,.544,2,5,.400,19,24,.792,99
411,UTA,2015-12-31,109,,POR,W 109-96,240,43,86,.500,28,53,.528,15,33,.455,8,11,.727,109,35,78,.449,19,42,.452,16,36,.444,10,14,.714,96
412,WAS,2015-12-19,109,,CHO,W 109-101,240,40,79,.506,31,59,.525,9,20,.450,20,23,.870,109,39,93,.419,29,60,.483,10,33,.303,13,16,.813,101
413,CHO,2015-12-17,109,,TOR,W 109-99 (OT),265,37,85,.435,27,56,.482,10,29,.345,25,31,.806,109,35,97,.361,26,58,.448,9,39,.231,20,28,.714,99
414,SAS,2015-12-11,109,,LAL,W 109-87,240,44,82,.537,38,68,.559,6,14,.429,15,25,.600,109,36,88,.409,27,63,.429,9,25,.360,6,10,.600,87
415,TOR,2015-12-05,109,,GSW,L 109-112,240,40,91,.440,32,71,.451,8,20,.400,21,26,.808,109,35,73,.479,19,43,.442,16,30,.533,26,36,.722,112
416,WAS,2015-12-04,109,,PHO,W 109-106,240,40,82,.488,30,56,.536,10,26,.385,19,25,.760,109,43,84,.512,33,61,.541,10,23,.435,10,16,.625,106
417,MIL,2015-11-23,109,,DET,W 109-88,240,43,83,.518,34,70,.486,9,13,.692,14,17,.824,109,31,91,.341,25,63,.397,6,28,.214,20,24,.833,88
418,CLE,2015-11-21,109,,ATL,W 109-97,240,41,85,.482,30,56,.536,11,29,.379,16,19,.842,109,32,86,.372,21,58,.362,11,28,.393,22,25,.880,97
419,SAS,2015-11-18,109,,DEN,W 109-98,240,42,86,.488,33,68,.485,9,18,.500,16,20,.800,109,38,98,.388,33,83,.398,5,15,.333,17,18,.944,98
420,TOR,2015-11-10,109,,NYK,L 109-111,240,37,84,.440,33,67,.493,4,17,.235,31,39,.795,109,42,95,.442,31,72,.431,11,23,.478,16,18,.889,111
421,GSW,2015-11-09,109,,DET,W 109-95,240,43,91,.473,31,70,.443,12,21,.571,11,13,.846,109,40,85,.471,34,66,.515,6,19,.316,9,15,.600,95
422,LAL,2015-11-03,109,,DEN,L 109-120,240,36,86,.419,30,60,.500,6,26,.231,31,38,.816,109,43,85,.506,36,65,.554,7,20,.350,27,31,.871,120
423,MIA,2015-11-01,109,,HOU,W 109-89,240,42,86,.488,33,64,.516,9,22,.409,16,21,.762,109,32,79,.405,22,43,.512,10,36,.278,15,18,.833,89
424,PHI,2016-04-10,108,,MIL,L 108-109 (OT),265,39,96,.406,26,50,.520,13,46,.283,17,25,.680,108,40,87,.460,33,64,.516,7,23,.304,22,24,.917,109
425,MEM,2016-04-05,108,,CHI,W 108-92,240,39,87,.448,32,68,.471,7,19,.368,23,26,.885,108,34,77,.442,23,48,.479,11,29,.379,13,19,.684,92
426,ATL,2016-04-01,108,,CLE,L 108-110 (OT),265,38,95,.400,29,65,.446,9,30,.300,23,26,.885,108,39,98,.398,27,60,.450,12,38,.316,20,31,.645,110
427,POR,2016-03-26,108,,PHI,W 108-105,240,38,91,.418,30,66,.455,8,25,.320,24,30,.800,108,39,93,.419,29,55,.527,10,38,.263,17,24,.708,105
428,MIA,2016-03-25,108,,ORL,W 108-97,240,40,80,.500,35,65,.538,5,15,.333,23,33,.697,108,36,84,.429,30,66,.455,6,18,.333,19,28,.679,97
429,MEM,2016-03-16,108,,MIN,L 108-114,240,44,100,.440,40,80,.500,4,20,.200,16,21,.762,108,40,71,.563,30,50,.600,10,21,.476,24,31,.774,114
430,SAC,2016-03-16,108,,NOP,L 108-123,240,42,90,.467,33,72,.458,9,18,.500,15,17,.882,108,49,90,.544,37,69,.536,12,21,.571,13,16,.813,123
431,SAS,2016-03-15,108,,LAC,W 108-87,240,44,82,.537,36,62,.581,8,20,.400,12,16,.750,108,32,69,.464,24,50,.480,8,19,.421,15,22,.682,87
432,LAL,2016-03-10,108,,CLE,L 108-120,240,42,80,.525,35,58,.603,7,22,.318,17,21,.810,108,45,85,.529,29,50,.580,16,35,.457,14,20,.700,120
433,CHO,2016-03-07,108,,MIN,W 108-103,240,41,90,.456,29,60,.483,12,30,.400,14,17,.824,108,39,80,.488,35,65,.538,4,15,.267,21,24,.875,103
434,CHI,2016-03-05,108,,HOU,W 108-100,240,36,79,.456,27,58,.466,9,21,.429,27,34,.794,108,35,87,.402,26,52,.500,9,35,.257,21,30,.700,100
435,CLE,2016-03-04,108,,WAS,W 108-83,240,42,90,.467,30,63,.476,12,27,.444,12,16,.750,108,32,81,.395,29,61,.475,3,20,.150,16,24,.667,83
436,CHO,2016-03-04,108,,IND,W 108-101,240,38,79,.481,25,48,.521,13,31,.419,19,23,.826,108,37,90,.411,28,62,.452,9,28,.321,18,21,.857,101
437,MIA,2016-03-03,108,,PHO,W 108-92,240,40,83,.482,31,66,.470,9,17,.529,19,25,.760,108,33,82,.402,28,60,.467,5,22,.227,21,27,.778,92
438,NYK,2016-02-26,108,,ORL,W 108-95,240,37,80,.463,33,64,.516,4,16,.250,30,36,.833,108,39,93,.419,33,66,.500,6,27,.222,11,16,.688,95
439,IND,2016-02-24,108,,NYK,W 108-105,240,46,91,.505,43,76,.566,3,15,.200,13,16,.813,108,35,77,.455,22,51,.431,13,26,.500,22,25,.880,105
440,MIL,2016-02-22,108,,LAL,W 108-101,240,44,86,.512,39,70,.557,5,16,.313,15,25,.600,108,28,76,.368,16,47,.340,12,29,.414,33,43,.767,101
441,NYK,2016-02-09,108,,WAS,L 108-111,240,44,83,.530,36,57,.632,8,26,.308,12,14,.857,108,39,78,.500,23,52,.442,16,26,.615,17,25,.680,111
442,CHO,2016-02-08,108,,CHI,W 108-91,240,35,80,.438,21,44,.477,14,36,.389,24,31,.774,108,35,90,.389,25,65,.385,10,25,.400,11,14,.786,91
443,CHO,2016-02-06,108,,WAS,W 108-104,240,38,81,.469,26,54,.481,12,27,.444,20,25,.800,108,38,86,.442,29,61,.475,9,25,.360,19,24,.792,104
444,MEM,2016-01-25,108,,ORL,W 108-102 (OT),265,43,100,.430,37,82,.451,6,18,.333,16,25,.640,108,40,86,.465,30,58,.517,10,28,.357,12,14,.857,102
445,SAC,2016-01-23,108,,IND,W 108-97,240,38,85,.447,33,69,.478,5,16,.313,27,36,.750,108,36,86,.419,29,67,.433,7,19,.368,18,25,.720,97
446,MIL,2016-01-15,108,,ATL,W 108-101 (OT),265,40,96,.417,37,86,.430,3,10,.300,25,37,.676,108,43,100,.430,34,70,.486,9,30,.300,6,6,1.000,101
447,OKC,2016-01-13,108,,DAL,W 108-89,240,38,82,.463,23,49,.469,15,33,.455,17,29,.586,108,32,82,.390,26,51,.510,6,31,.194,19,25,.760,89
448,POR,2016-01-08,108,,GSW,L 108-128,240,38,96,.396,26,63,.413,12,33,.364,20,28,.714,108,46,87,.529,28,55,.509,18,32,.563,18,21,.857,128
449,CHI,2016-01-01,108,,NYK,W 108-81,240,39,85,.459,29,69,.420,10,16,.625,20,25,.800,108,31,84,.369,25,65,.385,6,19,.316,13,17,.765,81
450,NYK,2015-12-29,108,,DET,W 108-96,240,43,79,.544,35,63,.556,8,16,.500,14,17,.824,108,37,89,.416,27,62,.435,10,27,.370,12,17,.706,96
451,CHO,2015-12-28,108,,LAL,W 108-98,240,43,89,.483,37,64,.578,6,25,.240,16,22,.727,108,35,85,.412,26,56,.464,9,29,.310,19,23,.826,98
452,CLE,2015-12-20,108,,PHI,W 108-86,240,40,85,.471,29,60,.483,11,25,.440,17,21,.810,108,30,86,.349,25,62,.403,5,24,.208,21,30,.700,86
453,PHO,2015-12-13,108,,MIN,W 108-101,240,39,87,.448,29,57,.509,10,30,.333,20,24,.833,108,33,73,.452,25,54,.463,8,19,.421,27,34,.794,101
454,MIL,2015-12-12,108,,GSW,W 108-95,240,44,90,.489,38,76,.500,6,14,.429,14,18,.778,108,36,89,.404,30,62,.484,6,27,.222,17,25,.680,95
455,SAS,2015-12-05,108,,BOS,W 108-105,240,44,83,.530,39,66,.591,5,17,.294,15,22,.682,108,39,86,.453,27,57,.474,12,29,.414,15,22,.682,105
456,NYK,2015-12-04,108,,BRK,W 108-91,240,39,87,.448,27,60,.450,12,27,.444,18,21,.857,108,39,91,.429,36,80,.450,3,11,.273,10,15,.667,91
457,HOU,2015-12-02,108,,NOP,W 108-101,240,36,87,.414,28,60,.467,8,27,.296,28,39,.718,108,36,88,.409,29,63,.460,7,25,.280,22,25,.880,101
458,POR,2015-11-28,108,,LAL,W 108-96,240,38,78,.487,26,48,.542,12,30,.400,20,26,.769,108,36,82,.439,29,59,.492,7,23,.304,17,23,.739,96
459,SAS,2015-11-28,108,,ATL,W 108-88,240,40,85,.471,31,68,.456,9,17,.529,19,20,.950,108,37,87,.425,31,61,.508,6,26,.231,8,13,.615,88
460,HOU,2015-11-18,108,,POR,W 108-103 (OT),265,32,92,.348,18,48,.375,14,44,.318,30,35,.857,108,35,88,.398,26,58,.448,9,30,.300,24,29,.828,103
461,WAS,2015-11-14,108,,ORL,W 108-99,240,39,83,.470,27,54,.500,12,29,.414,18,26,.692,108,38,87,.437,34,69,.493,4,18,.222,19,24,.792,99
462,MIL,2015-11-14,108,,CLE,W 108-105 (2OT),290,43,102,.422,37,86,.430,6,16,.375,16,22,.727,108,37,91,.407,23,53,.434,14,38,.368,17,27,.630,105
463,DEN,2015-11-09,108,,POR,W 108-104,240,40,77,.519,33,58,.569,7,19,.368,21,32,.656,108,36,91,.396,26,62,.419,10,29,.345,22,27,.815,104
464,CLE,2015-11-06,108,,PHI,W 108-102,240,45,88,.511,35,62,.565,10,26,.385,8,12,.667,108,41,79,.519,31,56,.554,10,23,.435,10,15,.667,102
465,POR,2016-04-13,107,,DEN,W 107-99,240,39,89,.438,28,53,.528,11,36,.306,18,22,.818,107,40,94,.426,33,69,.478,7,25,.280,12,18,.667,99
466,ORL,2016-04-11,107,,MIL,W 107-98,240,41,84,.488,34,61,.557,7,23,.304,18,28,.643,107,41,78,.526,38,63,.603,3,15,.200,13,19,.684,98
467,MIA,2016-04-05,107,,DET,W 107-89,240,44,84,.524,35,70,.500,9,14,.643,10,14,.714,107,32,80,.400,27,58,.466,5,22,.227,20,25,.800,89
468,SAC,2016-04-05,107,,POR,L 107-115,240,41,78,.526,30,56,.536,11,22,.500,14,21,.667,107,40,93,.430,28,62,.452,12,31,.387,23,27,.852,115
469,PHI,2016-04-05,107,,NOP,W 107-93,240,40,88,.455,27,54,.500,13,34,.382,14,17,.824,107,37,82,.451,30,64,.469,7,18,.389,12,16,.750,93
470,CLE,2016-03-31,107,,BRK,W 107-87,240,38,87,.437,26,49,.531,12,38,.316,19,24,.792,107,35,94,.372,31,73,.425,4,21,.190,13,21,.619,87
471,CHI,2016-03-23,107,,NYK,L 107-115,240,38,82,.463,23,50,.460,15,32,.469,16,21,.762,107,45,87,.517,31,62,.500,14,25,.560,11,15,.733,115
472,LAL,2016-03-22,107,,MEM,W 107-100,240,39,77,.506,33,58,.569,6,19,.316,23,24,.958,107,40,80,.500,36,65,.554,4,15,.267,16,23,.696,100
473,BOS,2016-03-21,107,,ORL,W 107-96,240,40,85,.471,33,63,.524,7,22,.318,20,24,.833,107,39,93,.419,34,74,.459,5,19,.263,13,19,.684,96
474,CHO,2016-03-16,107,,ORL,W 107-99,240,40,100,.400,29,63,.460,11,37,.297,16,21,.762,107,35,83,.422,24,58,.414,11,25,.440,18,21,.857,99
475,PHO,2016-03-14,107,,MIN,W 107-104,240,40,95,.421,29,60,.483,11,35,.314,16,20,.800,107,37,84,.440,33,68,.485,4,16,.250,26,30,.867,104
476,TOR,2016-03-14,107,,CHI,L 107-109,240,37,83,.446,31,63,.492,6,20,.300,27,31,.871,107,41,83,.494,32,58,.552,9,25,.360,18,20,.900,109
477,LAL,2016-03-08,107,,ORL,W 107-98,240,40,81,.494,31,54,.574,9,27,.333,18,23,.783,107,37,76,.487,32,57,.561,5,19,.263,19,27,.704,98
478,TOR,2016-03-06,107,,HOU,L 107-113,240,37,77,.481,25,44,.568,12,33,.364,21,27,.778,107,38,78,.487,25,49,.510,13,29,.448,24,37,.649,113
479,LAL,2016-03-01,107,,BRK,W 107-101,240,41,83,.494,30,57,.526,11,26,.423,14,21,.667,107,39,89,.438,34,71,.479,5,18,.278,18,27,.667,101
480,SAC,2016-02-26,107,,LAC,L 107-117,240,34,78,.436,22,54,.407,12,24,.500,27,37,.730,107,43,89,.483,34,60,.567,9,29,.310,22,26,.846,117
481,POR,2016-02-02,107,,MIL,W 107-95,240,39,85,.459,28,54,.519,11,31,.355,18,25,.720,107,38,86,.442,33,72,.458,5,14,.357,14,24,.583,95
482,SAS,2016-02-01,107,,ORL,W 107-92,240,40,78,.513,31,54,.574,9,24,.375,18,21,.857,107,39,96,.406,34,79,.430,5,17,.294,9,11,.818,92
483,MIL,2016-01-26,107,,ORL,W 107-100,240,38,77,.494,33,64,.516,5,13,.385,26,31,.839,107,33,80,.413,20,56,.357,13,24,.542,21,29,.724,100
484,CHO,2016-01-13,107,,ATL,W 107-84,240,36,82,.439,23,43,.535,13,39,.333,22,26,.846,107,30,81,.370,23,56,.411,7,25,.280,17,21,.810,84
485,HOU,2016-01-13,107,,MIN,W 107-104,240,37,75,.493,30,45,.667,7,30,.233,26,38,.684,107,36,78,.462,28,61,.459,8,17,.471,24,30,.800,104
486,DAL,2016-01-12,107,,CLE,L 107-110 (OT),265,39,79,.494,28,51,.549,11,28,.393,18,22,.818,107,40,97,.412,23,53,.434,17,44,.386,13,16,.813,110
487,HOU,2016-01-10,107,,IND,W 107-103 (OT),265,39,89,.438,25,51,.490,14,38,.368,15,23,.652,107,43,90,.478,34,59,.576,9,31,.290,8,10,.800,103
488,ATL,2015-12-23,107,,DET,W 107-100,240,43,89,.483,37,69,.536,6,20,.300,15,20,.750,107,38,89,.427,31,68,.456,7,21,.333,17,33,.515,100
489,DEN,2015-12-22,107,,LAL,L 107-111,240,41,90,.456,32,65,.492,9,25,.360,16,19,.842,107,40,84,.476,33,58,.569,7,26,.269,24,32,.750,111
490,NYK,2015-12-19,107,,CHI,W 107-91,240,41,82,.500,36,62,.581,5,20,.250,20,24,.833,107,37,94,.394,32,73,.438,5,21,.238,12,17,.706,91
491,HOU,2015-12-19,107,,LAC,W 107-97,240,34,76,.447,26,51,.510,8,25,.320,31,49,.633,107,34,86,.395,23,48,.479,11,38,.289,18,29,.621,97
492,NYK,2015-12-16,107,,MIN,W 107-102,240,37,85,.435,29,64,.453,8,21,.381,25,30,.833,107,42,101,.416,38,80,.475,4,21,.190,14,14,1.000,102
493,IND,2015-12-16,107,,DAL,W 107-81,240,43,89,.483,32,60,.533,11,29,.379,10,17,.588,107,33,90,.367,25,57,.439,8,33,.242,7,10,.700,81
494,SAC,2015-12-15,107,,HOU,W 107-97,240,38,75,.507,27,51,.529,11,24,.458,20,29,.690,107,34,82,.415,22,43,.512,12,39,.308,17,23,.739,97
495,NOP,2015-12-11,107,,WAS,W 107-105,240,39,79,.494,23,52,.442,16,27,.593,13,18,.722,107,40,80,.500,28,53,.528,12,27,.444,13,21,.619,105
496,OKC,2015-12-10,107,,ATL,W 107-94,240,39,80,.488,30,63,.476,9,17,.529,20,26,.769,107,35,78,.449,25,50,.500,10,28,.357,14,23,.609,94
497,PHO,2015-12-09,107,,ORL,W 107-104,240,41,80,.513,35,56,.625,6,24,.250,19,27,.704,107,40,85,.471,28,60,.467,12,25,.480,12,16,.750,104
498,LAC,2015-11-29,107,,MIN,W 107-99,240,39,75,.520,31,53,.585,8,22,.364,21,33,.636,107,37,82,.451,29,66,.439,8,16,.500,17,21,.810,99
499,DEN,2015-11-20,107,,PHO,L 107-114,240,41,90,.456,36,66,.545,5,24,.208,20,26,.769,107,40,79,.506,25,52,.481,15,27,.556,19,25,.760,114
500,SAC,2015-11-15,107,,TOR,W 107-101,240,39,76,.513,29,51,.569,10,25,.400,19,24,.792,107,38,87,.437,23,56,.411,15,31,.484,10,14,.714,101
501,GSW,2015-11-14,107,,BRK,W 107-99 (OT),265,43,97,.443,31,63,.492,12,34,.353,9,10,.900,107,41,98,.418,39,80,.488,2,18,.111,15,16,.938,99
502,IND,2015-11-13,107,,MIN,W 107-103,240,41,86,.477,31,61,.508,10,25,.400,15,23,.652,107,42,83,.506,35,63,.556,7,20,.350,12,13,.923,103
503,DEN,2015-11-13,107,,HOU,W 107-98,240,37,81,.457,28,61,.459,9,20,.450,24,32,.750,107,33,77,.429,24,48,.500,9,29,.310,23,31,.742,98
504,ATL,2015-11-09,107,,MIN,L 107-117,240,44,86,.512,31,55,.564,13,31,.419,6,7,.857,107,46,80,.575,39,65,.600,7,15,.467,18,22,.818,117
505,DAL,2015-11-07,107,,NOP,W 107-98,240,40,84,.476,31,60,.517,9,24,.375,18,22,.818,107,39,86,.453,30,58,.517,9,28,.321,11,13,.846,98
506,MIA,2016-04-07,106,,CHI,W 106-98,240,44,92,.478,40,78,.513,4,14,.286,14,17,.824,106,35,78,.449,32,64,.500,3,14,.214,25,28,.893,98
507,DEN,2016-04-02,106,,SAC,L 106-115,240,40,92,.435,31,63,.492,9,29,.310,17,24,.708,106,41,88,.466,33,67,.493,8,21,.381,25,31,.806,115
508,GSW,2016-04-01,106,,BOS,L 106-109,240,38,83,.458,18,40,.450,20,43,.465,10,13,.769,106,41,87,.471,33,64,.516,8,23,.348,19,30,.633,109
509,SAC,2016-04-01,106,,MIA,L 106-112,240,38,87,.437,31,66,.470,7,21,.333,23,29,.793,106,42,82,.512,30,60,.500,12,22,.545,16,17,.941,112
510,NYK,2016-03-24,106,,CHI,W 106-94,240,39,76,.513,26,46,.565,13,30,.433,15,16,.938,106,37,89,.416,31,64,.484,6,25,.240,14,18,.778,94
511,MIA,2016-03-17,106,,CHO,L 106-109,240,40,75,.533,33,58,.569,7,17,.412,19,24,.792,106,40,86,.465,27,60,.450,13,26,.500,16,21,.762,109
512,HOU,2016-03-16,106,,LAC,L 106-122,240,40,82,.488,31,57,.544,9,25,.360,17,24,.708,106,43,76,.566,31,46,.674,12,30,.400,24,32,.750,122
513,PHO,2016-02-25,106,,BRK,L 106-116,240,42,98,.429,33,71,.465,9,27,.333,13,23,.565,106,37,75,.493,29,57,.509,8,18,.444,34,42,.810,116
514,DET,2016-02-21,106,,NOP,L 106-111,240,37,89,.416,25,56,.446,12,33,.364,20,32,.625,106,41,86,.477,37,66,.561,4,20,.200,25,29,.862,111
515,CLE,2016-02-18,106,,CHI,W 106-95,240,42,91,.462,35,67,.522,7,24,.292,15,17,.882,106,37,93,.398,29,72,.403,8,21,.381,13,22,.591,95
516,MEM,2016-02-08,106,,POR,L 106-112 (OT),265,43,86,.500,36,67,.537,7,19,.368,13,19,.684,106,44,89,.494,34,60,.567,10,29,.345,14,20,.700,112
517,PHO,2016-02-08,106,,OKC,L 106-122,240,37,73,.507,36,62,.581,1,11,.091,31,39,.795,106,42,85,.494,27,52,.519,15,33,.455,23,30,.767,122
518,SAS,2016-02-06,106,,LAL,W 106-102,240,39,88,.443,31,64,.484,8,24,.333,20,25,.800,106,34,86,.395,24,56,.429,10,30,.333,24,27,.889,102
519,WAS,2016-02-05,106,,PHI,W 106-94,240,44,84,.524,38,62,.613,6,22,.273,12,20,.600,106,37,87,.425,28,61,.459,9,26,.346,11,14,.786,94
520,CHO,2016-02-03,106,,CLE,W 106-97,240,39,79,.494,30,52,.577,9,27,.333,19,23,.826,106,38,83,.458,28,55,.509,10,28,.357,11,14,.786,97
521,IND,2016-02-01,106,,CLE,L 106-111 (OT),265,43,101,.426,35,74,.473,8,27,.296,12,14,.857,106,44,88,.500,37,66,.561,7,22,.318,16,23,.696,111
522,DET,2016-01-29,106,,CLE,L 106-114,240,40,84,.476,33,61,.541,7,23,.304,19,26,.731,106,39,83,.470,30,60,.500,9,23,.391,27,29,.931,114
523,TOR,2016-01-26,106,,WAS,W 106-89,240,35,79,.443,24,50,.480,11,29,.379,25,32,.781,106,32,78,.410,28,63,.444,4,15,.267,21,28,.750,89
524,MIN,2016-01-23,106,,MEM,W 106-101,240,34,68,.500,29,51,.569,5,17,.294,33,36,.917,106,37,79,.468,28,60,.467,9,19,.474,18,22,.818,101
525,DAL,2016-01-22,106,,OKC,L 106-109,240,40,87,.460,30,54,.556,10,33,.303,16,18,.889,106,45,91,.495,37,61,.607,8,30,.267,11,15,.733,109
526,DAL,2016-01-20,106,,MIN,W 106-94 (OT),265,42,97,.433,37,72,.514,5,25,.200,17,22,.773,106,40,91,.440,35,68,.515,5,23,.217,9,11,.818,94
527,WAS,2016-01-20,106,,MIA,W 106-87,240,45,86,.523,40,70,.571,5,16,.313,11,13,.846,106,33,68,.485,26,53,.491,7,15,.467,14,18,.778,87
528,WAS,2016-01-13,106,,MIL,W 106-101,240,38,84,.452,26,57,.456,12,27,.444,18,24,.750,106,38,72,.528,37,64,.578,1,8,.125,24,34,.706,101
529,MIL,2016-01-12,106,,CHI,W 106-101,240,43,93,.462,40,80,.500,3,13,.231,17,28,.607,106,35,85,.412,23,56,.411,12,29,.414,19,24,.792,101
530,DEN,2016-01-03,106,,POR,L 106-112,240,34,80,.425,27,58,.466,7,22,.318,31,48,.646,106,40,78,.513,30,55,.545,10,23,.435,22,32,.688,112
531,MIA,2016-01-01,106,,DAL,W 106-82,240,46,82,.561,38,64,.594,8,18,.444,6,9,.667,106,32,88,.364,25,57,.439,7,31,.226,11,14,.786,82
532,IND,2015-12-23,106,,SAC,L 106-108,240,41,89,.461,29,57,.509,12,32,.375,12,20,.600,106,46,89,.517,42,66,.636,4,23,.174,12,16,.750,108
533,SAS,2015-12-21,106,,IND,W 106-92,240,46,89,.517,40,69,.580,6,20,.300,8,9,.889,106,38,90,.422,31,71,.437,7,19,.368,9,15,.600,92
534,ATL,2015-12-21,106,,POR,W 106-97,240,37,77,.481,28,48,.583,9,29,.310,23,28,.821,106,38,81,.469,33,57,.579,5,24,.208,16,22,.727,97
535,OKC,2015-12-16,106,,POR,W 106-90,240,38,79,.481,36,65,.554,2,14,.143,28,37,.757,106,32,92,.348,21,66,.318,11,26,.423,15,18,.833,90
536,IND,2015-12-14,106,,TOR,W 106-90,240,41,86,.477,31,64,.484,10,22,.455,14,16,.875,106,29,79,.367,19,51,.373,10,28,.357,22,26,.846,90
537,UTA,2015-12-09,106,,NYK,W 106-85,240,39,80,.488,30,59,.508,9,21,.429,19,23,.826,106,31,78,.397,23,57,.404,8,21,.381,15,27,.556,85
538,MIN,2015-12-07,106,,LAC,L 106-110,240,36,82,.439,29,64,.453,7,18,.389,27,35,.771,106,38,86,.442,30,61,.492,8,25,.320,26,29,.897,110
539,MIL,2015-12-05,106,,NYK,W 106-91,240,44,89,.494,42,85,.494,2,4,.500,16,24,.667,106,32,76,.421,26,51,.510,6,25,.240,21,28,.750,91
540,ATL,2015-11-30,106,,OKC,W 106-100,240,39,90,.433,29,62,.468,10,28,.357,18,20,.900,106,37,93,.398,30,74,.405,7,19,.368,19,22,.864,100
541,WAS,2015-11-24,106,,IND,L 106-123,240,38,83,.458,25,50,.500,13,33,.394,17,24,.708,106,44,80,.550,25,54,.463,19,26,.731,16,23,.696,123
542,GSW,2015-11-20,106,,CHI,W 106-94,240,39,79,.494,29,50,.580,10,29,.345,18,24,.750,106,35,88,.398,28,66,.424,7,22,.318,17,23,.739,94
543,MIN,2015-11-15,106,,MEM,L 106-114,240,41,82,.500,36,66,.545,5,16,.313,19,21,.905,106,40,71,.563,31,54,.574,9,17,.529,25,27,.926,114
544,CHO,2015-11-15,106,,POR,W 106-94,240,41,83,.494,32,52,.615,9,31,.290,15,19,.789,106,35,89,.393,30,68,.441,5,21,.238,19,21,.905,94
545,BOS,2015-11-13,106,,ATL,W 106-93,240,42,103,.408,31,70,.443,11,33,.333,11,12,.917,106,36,76,.474,30,56,.536,6,20,.300,15,20,.750,93
546,ATL,2015-11-11,106,,NOP,W 106-98,240,42,86,.488,32,60,.533,10,26,.385,12,16,.750,106,37,83,.446,23,54,.426,14,29,.483,10,15,.667,98
547,TOR,2015-11-01,106,,MIL,W 106-87,240,41,90,.456,30,65,.462,11,25,.440,13,20,.650,106,29,69,.420,24,50,.480,5,19,.263,24,24,1.000,87
548,TOR,2015-10-28,106,,IND,W 106-99,240,36,80,.450,29,62,.468,7,18,.389,27,39,.692,106,32,86,.372,23,63,.365,9,23,.391,26,31,.839,99
549,MIN,2016-04-11,105,,HOU,L 105-129,240,38,83,.458,33,62,.532,5,21,.238,24,33,.727,105,48,86,.558,33,56,.589,15,30,.500,18,26,.692,129
550,CHI,2016-04-09,105,,CLE,W 105-102,240,40,89,.449,32,65,.492,8,24,.333,17,21,.810,105,36,83,.434,17,43,.395,19,40,.475,11,18,.611,102
551,POR,2016-04-09,105,,MIN,L 105-106,240,40,80,.500,31,56,.554,9,24,.375,16,18,.889,105,41,84,.488,36,71,.507,5,13,.385,19,25,.760,106
552,NYK,2016-04-01,105,,BRK,W 105-91,240,42,84,.500,28,61,.459,14,23,.609,7,7,1.000,105,36,101,.356,32,77,.416,4,24,.167,15,20,.750,91
553,TOR,2016-03-30,105,,ATL,W 105-97,240,36,80,.450,25,57,.439,11,23,.478,22,28,.786,105,37,83,.446,23,50,.460,14,33,.424,9,13,.692,97
554,MEM,2016-03-30,105,,DEN,L 105-109,240,41,95,.432,35,76,.461,6,19,.316,17,27,.630,105,38,78,.487,25,49,.510,13,29,.448,20,24,.833,109
555,MIL,2016-03-30,105,,PHO,W 105-94,240,37,77,.481,31,62,.500,6,15,.400,25,34,.735,105,38,84,.452,33,60,.550,5,24,.208,13,17,.765,94
556,POR,2016-03-28,105,,SAC,W 105-93,240,38,80,.475,24,51,.471,14,29,.483,15,18,.833,105,37,89,.416,30,74,.405,7,15,.467,12,19,.632,93
557,LAC,2016-03-27,105,,DEN,W 105-90,240,38,80,.475,28,52,.538,10,28,.357,19,26,.731,105,37,94,.394,30,65,.462,7,29,.241,9,13,.692,90
558,LAL,2016-03-25,105,,DEN,L 105-116,240,37,85,.435,27,62,.435,10,23,.435,21,26,.808,105,45,94,.479,35,68,.515,10,26,.385,16,24,.667,116
559,PHI,2016-03-20,105,,BOS,L 105-120,240,39,92,.424,31,71,.437,8,21,.381,19,27,.704,105,46,94,.489,36,69,.522,10,25,.400,18,21,.857,120
560,TOR,2016-03-20,105,,ORL,W 105-100,240,35,81,.432,29,61,.475,6,20,.300,29,45,.644,105,40,83,.482,32,61,.525,8,22,.364,12,18,.667,100
561,TOR,2016-03-18,105,,BOS,W 105-91,240,37,77,.481,24,49,.490,13,28,.464,18,25,.720,105,36,82,.439,27,61,.443,9,21,.429,10,12,.833,91
562,DAL,2016-03-12,105,,IND,L 105-112,240,41,85,.482,33,63,.524,8,22,.364,15,18,.833,105,38,81,.469,29,53,.547,9,28,.321,27,29,.931,112
563,BOS,2016-03-04,105,,NYK,W 105-104,240,41,90,.456,37,70,.529,4,20,.200,19,25,.760,105,42,92,.457,33,69,.478,9,23,.391,11,14,.786,104
564,LAC,2016-02-29,105,,BRK,W 105-95,240,41,83,.494,32,60,.533,9,23,.391,14,16,.875,105,32,77,.416,24,58,.414,8,19,.421,23,33,.697,95
565,POR,2016-02-25,105,,HOU,L 105-119,240,37,80,.463,24,45,.533,13,35,.371,18,22,.818,105,44,82,.537,34,53,.642,10,29,.345,21,35,.600,119
566,LAC,2016-02-18,105,,SAS,W 105-86,240,39,78,.500,27,53,.509,12,25,.480,15,20,.750,105,35,83,.422,31,66,.470,4,17,.235,12,15,.800,86
567,BRK,2016-02-08,105,,DEN,W 105-104,240,42,81,.519,33,62,.532,9,19,.474,12,15,.800,105,42,90,.467,33,65,.508,9,25,.360,11,13,.846,104
568,PHO,2016-02-04,105,,HOU,L 105-111,240,32,83,.386,21,54,.389,11,29,.379,30,32,.938,105,37,86,.430,22,44,.500,15,42,.357,22,32,.688,111
569,UTA,2016-02-01,105,,CHI,W 105-96 (OT),265,38,85,.447,31,67,.463,7,18,.389,22,33,.667,105,39,90,.433,34,69,.493,5,21,.238,13,20,.650,96
570,MIA,2016-01-31,105,,ATL,W 105-87,240,39,81,.481,34,61,.557,5,20,.250,22,26,.846,105,27,70,.386,22,48,.458,5,22,.227,28,32,.875,87
571,NOP,2016-01-30,105,,BRK,W 105-103,240,43,93,.462,32,66,.485,11,27,.407,8,10,.800,105,40,84,.476,31,64,.484,9,20,.450,14,23,.609,103
572,PHI,2016-01-30,105,,GSW,L 105-108,240,42,92,.457,32,63,.508,10,29,.345,11,21,.524,105,47,95,.495,34,65,.523,13,30,.433,1,2,.500,108
573,LAC,2016-01-29,105,,LAL,W 105-93,240,40,81,.494,32,55,.582,8,26,.308,17,24,.708,105,34,78,.436,29,65,.446,5,13,.385,20,25,.800,93
574,DEN,2016-01-25,105,,ATL,L 105-119,240,33,84,.393,27,64,.422,6,20,.300,33,37,.892,105,43,86,.500,34,59,.576,9,27,.333,24,26,.923,119
575,SAC,2015-12-30,105,,PHI,L 105-110,240,36,74,.486,28,49,.571,8,25,.320,25,41,.610,105,40,94,.426,31,63,.492,9,31,.290,21,34,.618,110
576,MIA,2015-12-28,105,,BRK,L 105-111,240,36,78,.462,26,54,.481,10,24,.417,23,30,.767,105,36,82,.439,24,59,.407,12,23,.522,27,36,.750,111
577,POR,2015-12-26,105,,CLE,W 105-76,240,41,89,.461,32,67,.478,9,22,.409,14,19,.737,105,28,77,.364,17,46,.370,11,31,.355,9,15,.600,76
578,POR,2015-12-14,105,,NOP,W 105-101,240,35,81,.432,22,49,.449,13,32,.406,22,29,.759,105,36,82,.439,28,57,.491,8,25,.320,21,27,.778,101
579,BOS,2015-12-09,105,,CHI,W 105-100,240,38,92,.413,33,69,.478,5,23,.217,24,28,.857,105,39,91,.429,33,70,.471,6,21,.286,16,23,.696,100
580,CLE,2015-12-08,105,,POR,W 105-100,240,40,79,.506,31,58,.534,9,21,.429,16,20,.800,105,40,79,.506,29,53,.547,11,26,.423,9,16,.563,100
581,PHI,2015-12-05,105,,DEN,L 105-108,240,37,74,.500,22,43,.512,15,31,.484,16,26,.615,105,37,81,.457,26,50,.520,11,31,.355,23,38,.605,108
582,TOR,2015-12-03,105,,DEN,L 105-106,240,39,92,.424,31,65,.477,8,27,.296,19,22,.864,105,38,81,.469,26,54,.481,12,27,.444,18,18,1.000,106
583,DEN,2015-11-22,105,,GSW,L 105-118,240,37,86,.430,33,71,.465,4,15,.267,27,35,.771,105,47,89,.528,32,60,.533,15,29,.517,9,13,.692,118
584,PHO,2015-11-14,105,,DEN,W 105-81,240,37,84,.440,26,60,.433,11,24,.458,20,26,.769,105,34,98,.347,28,63,.444,6,35,.171,7,8,.875,81
585,LAC,2015-11-07,105,,HOU,L 105-109,240,42,88,.477,38,66,.576,4,22,.182,17,25,.680,105,38,86,.442,31,56,.554,7,30,.233,26,29,.897,109
586,ORL,2016-04-06,104,,DET,L 104-108,240,43,90,.478,39,75,.520,4,15,.267,14,19,.737,104,39,86,.453,28,59,.475,11,27,.407,19,31,.613,108
587,BOS,2016-04-06,104,,NOP,W 104-97,240,36,87,.414,26,53,.491,10,34,.294,22,27,.815,104,34,78,.436,25,54,.463,9,24,.375,20,23,.870,97
588,IND,2016-03-27,104,,HOU,W 104-101,240,41,87,.471,32,61,.525,9,26,.346,13,20,.650,104,38,85,.447,31,52,.596,7,33,.212,18,27,.667,101
589,BRK,2016-03-24,104,,CLE,W 104-95,240,41,89,.461,33,67,.493,8,22,.364,14,19,.737,104,39,89,.438,29,51,.569,10,38,.263,7,9,.778,95
590,DEN,2016-03-23,104,,PHI,W 104-103,240,33,76,.434,27,59,.458,6,17,.353,32,40,.800,104,37,94,.394,22,57,.386,15,37,.405,14,15,.933,103
591,MIN,2016-03-21,104,,GSW,L 104-109,240,36,82,.439,29,63,.460,7,19,.368,25,30,.833,104,43,87,.494,35,63,.556,8,24,.333,15,24,.625,109
592,ATL,2016-03-13,104,,IND,W 104-75,240,40,85,.471,25,55,.455,15,30,.500,9,10,.900,104,33,87,.379,28,63,.444,5,24,.208,4,7,.571,75
593,TOR,2016-03-10,104,,ATL,W 104-96,240,38,82,.463,31,58,.534,7,24,.292,21,29,.724,104,35,82,.427,28,59,.475,7,23,.304,19,27,.704,96
594,PHI,2016-03-09,104,,HOU,L 104-118,240,35,86,.407,23,53,.434,12,33,.364,22,32,.688,104,38,86,.442,27,53,.509,11,33,.333,31,41,.756,118
595,TOR,2016-03-08,104,,BRK,W 104-99,240,37,78,.474,27,55,.491,10,23,.435,20,25,.800,104,42,82,.512,36,70,.514,6,12,.500,9,9,1.000,99
596,SAS,2016-03-05,104,,SAC,W 104-94,240,40,81,.494,32,58,.552,8,23,.348,16,19,.842,104,37,81,.457,31,65,.477,6,16,.375,14,21,.667,94
597,MEM,2016-03-02,104,,SAC,W 104-98,240,35,79,.443,30,61,.492,5,18,.278,29,33,.879,104,39,82,.476,30,56,.536,9,26,.346,11,20,.550,98
598,TOR,2016-03-02,104,,UTA,W 104-94,240,40,80,.500,34,58,.586,6,22,.273,18,21,.857,104,37,83,.446,27,57,.474,10,26,.385,10,16,.625,94
599,PHO,2016-02-10,104,,GSW,L 104-112,240,41,93,.441,35,72,.486,6,21,.286,16,22,.727,104,37,89,.416,23,49,.469,14,40,.350,24,29,.828,112
600,DEN,2016-01-23,104,,DET,W 104-101,240,36,78,.462,28,56,.500,8,22,.364,24,29,.828,104,40,84,.476,29,55,.527,11,29,.379,10,19,.526,101
601,DEN,2016-01-19,104,,OKC,L 104-110,240,35,83,.422,28,63,.444,7,20,.350,27,36,.750,104,41,97,.423,35,69,.507,6,28,.214,22,30,.733,110
602,BRK,2016-01-15,104,,POR,L 104-116,240,38,85,.447,30,66,.455,8,19,.421,20,28,.714,104,47,93,.505,32,58,.552,15,35,.429,7,11,.636,116
603,IND,2016-01-15,104,,WAS,L 104-118,240,38,80,.475,35,63,.556,3,17,.176,25,32,.781,104,51,98,.520,40,73,.548,11,25,.440,5,10,.500,118
604,LAC,2016-01-13,104,,MIA,W 104-90,240,40,94,.426,29,69,.420,11,25,.440,13,16,.813,104,31,70,.443,22,46,.478,9,24,.375,19,29,.655,90
605,OKC,2016-01-04,104,,SAC,L 104-116,240,39,89,.438,29,60,.483,10,29,.345,16,23,.696,104,40,89,.449,33,72,.458,7,17,.412,29,39,.744,116
606,CLE,2016-01-02,104,,ORL,W 104-79,240,34,82,.415,22,45,.489,12,37,.324,24,39,.615,104,29,76,.382,23,51,.451,6,25,.240,15,17,.882,79
607,TOR,2016-01-01,104,,CHO,W 104-94,240,36,91,.396,21,58,.362,15,33,.455,17,18,.944,104,34,85,.400,24,53,.453,10,32,.313,16,18,.889,94
608,BOS,2015-12-30,104,,LAL,L 104-112,240,38,88,.432,31,61,.508,7,27,.259,21,25,.840,104,43,94,.457,34,75,.453,9,19,.474,17,23,.739,112
609,CHI,2015-12-28,104,,TOR,W 104-97,240,40,87,.460,32,66,.485,8,21,.381,16,24,.667,104,38,88,.432,32,68,.471,6,20,.300,15,24,.625,97
610,ORL,2015-12-28,104,,NOP,W 104-89,240,45,82,.549,38,65,.585,7,17,.412,7,11,.636,104,37,83,.446,32,63,.508,5,20,.250,10,15,.667,89
611,PHO,2015-12-26,104,,PHI,L 104-111,240,34,88,.386,24,61,.393,10,27,.370,26,34,.765,104,38,79,.481,26,52,.500,12,27,.444,23,27,.852,111
612,UTA,2015-12-26,104,,LAC,L 104-109,240,36,74,.486,26,47,.553,10,27,.370,22,27,.815,104,38,79,.481,25,53,.472,13,26,.500,20,24,.833,109
613,ORL,2015-12-23,104,,HOU,W 104-101,240,44,84,.524,37,68,.544,7,16,.438,9,13,.692,104,41,83,.494,34,54,.630,7,29,.241,12,17,.706,101
614,PHO,2015-12-18,104,,NOP,W 104-88,240,44,84,.524,38,68,.559,6,16,.375,10,17,.588,104,26,71,.366,22,49,.449,4,22,.182,32,38,.842,88
615,IND,2015-12-18,104,,BRK,W 104-97,240,37,89,.416,30,61,.492,7,28,.250,23,26,.885,104,36,86,.419,28,70,.400,8,16,.500,17,17,1.000,97
616,CLE,2015-12-17,104,,OKC,W 104-100,240,41,88,.466,29,59,.492,12,29,.414,10,13,.769,104,35,74,.473,29,54,.537,6,20,.300,24,28,.857,100
617,DAL,2015-12-14,104,,PHO,W 104-94,240,38,77,.494,26,45,.578,12,32,.375,16,21,.762,104,33,80,.413,24,55,.436,9,25,.360,19,27,.704,94
618,OKC,2015-12-13,104,,UTA,W 104-98 (OT),265,35,79,.443,28,58,.483,7,21,.333,27,30,.900,104,39,94,.415,31,72,.431,8,22,.364,12,20,.600,98
619,CHO,2015-12-07,104,,DET,W 104-84,240,36,84,.429,28,58,.483,8,26,.308,24,35,.686,104,32,87,.368,22,53,.415,10,34,.294,10,22,.455,84
620,WAS,2015-12-06,104,,DAL,L 104-116,240,42,89,.472,34,62,.548,8,27,.296,12,21,.571,104,38,76,.500,22,45,.489,16,31,.516,24,27,.889,116
621,WAS,2015-12-02,104,,LAL,L 104-108,240,37,79,.468,30,58,.517,7,21,.333,23,31,.742,104,41,96,.427,33,71,.465,8,25,.320,18,20,.900,108
622,NOP,2015-12-01,104,,MEM,L 104-113,240,35,81,.432,26,54,.481,9,27,.333,25,33,.758,104,43,90,.478,41,80,.513,2,10,.200,25,26,.962,113
623,IND,2015-11-27,104,,CHI,W 104-92,240,37,87,.425,29,59,.492,8,28,.286,22,29,.759,104,32,92,.348,21,66,.318,11,26,.423,17,20,.850,92
624,DET,2015-11-25,104,,MIA,W 104-81,240,41,98,.418,25,67,.373,16,31,.516,6,7,.857,104,32,79,.405,26,59,.441,6,20,.300,11,16,.688,81
625,NOP,2015-11-20,104,,SAS,W 104-90,240,40,88,.455,32,66,.485,8,22,.364,16,17,.941,104,34,84,.405,25,67,.373,9,17,.529,13,16,.813,90
626,ORL,2015-11-18,104,,MIN,W 104-101 (OT),265,41,110,.373,32,89,.360,9,21,.429,13,21,.619,104,36,85,.424,32,67,.478,4,18,.222,25,30,.833,101
627,DET,2015-11-17,104,,CLE,W 104-99,240,36,84,.429,29,63,.460,7,21,.333,25,31,.806,104,38,80,.475,27,47,.574,11,33,.333,12,20,.600,99
628,CHI,2015-11-05,104,,OKC,W 104-98,240,40,90,.444,33,72,.458,7,18,.389,17,21,.810,104,38,84,.452,33,71,.465,5,13,.385,17,20,.850,98
629,LAC,2015-10-29,104,,DAL,W 104-88,240,38,87,.437,30,56,.536,8,31,.258,20,33,.606,104,35,97,.361,29,67,.433,6,30,.200,12,15,.800,88
630,SAC,2015-10-28,104,,LAC,L 104-111,240,41,94,.436,30,70,.429,11,24,.458,11,18,.611,104,42,80,.525,36,61,.590,6,19,.316,21,31,.677,111
631,MIA,2015-10-28,104,,CHO,W 104-94,240,36,73,.493,24,53,.453,12,20,.600,20,21,.952,104,33,84,.393,27,60,.450,6,24,.250,22,29,.759,94
632,DAL,2016-04-08,103,,MEM,W 103-93,240,30,60,.500,18,29,.621,12,31,.387,31,39,.795,103,35,87,.402,28,65,.431,7,22,.318,16,22,.727,93
633,ATL,2016-04-05,103,,PHO,W 103-90,240,39,95,.411,28,61,.459,11,34,.324,14,19,.737,103,30,81,.370,18,50,.360,12,31,.387,18,30,.600,90
634,LAC,2016-04-05,103,,LAL,W 103-81,240,40,78,.513,33,58,.569,7,20,.350,16,26,.615,103,26,83,.313,20,63,.317,6,20,.300,23,25,.920,81
635,ORL,2016-03-18,103,,CLE,L 103-109,240,37,82,.451,26,60,.433,11,22,.500,18,22,.818,103,38,76,.500,25,48,.521,13,28,.464,20,27,.741,109
636,UTA,2016-03-17,103,,PHO,W 103-69,240,43,88,.489,32,63,.508,11,25,.440,6,9,.667,103,28,82,.341,22,56,.393,6,26,.231,7,14,.500,69
637,IND,2016-03-15,103,,BOS,W 103-98,240,39,84,.464,34,72,.472,5,12,.417,20,28,.714,103,36,94,.383,28,63,.444,8,31,.258,18,22,.818,98
638,MIL,2016-03-12,103,,NOP,W 103-92,240,40,81,.494,36,68,.529,4,13,.308,19,24,.792,103,35,89,.393,29,60,.483,6,29,.207,16,21,.762,92
639,CLE,2016-03-07,103,,MEM,L 103-106,240,36,80,.450,29,51,.569,7,29,.241,24,29,.828,103,41,86,.477,35,66,.530,6,20,.300,18,22,.818,106
640,MIA,2016-03-06,103,,PHI,W 103-98,240,36,81,.444,28,67,.418,8,14,.571,23,30,.767,103,37,85,.435,26,54,.481,11,31,.355,13,22,.591,98
641,LAC,2016-03-02,103,,OKC,W 103-98,240,40,98,.408,31,66,.470,9,32,.281,14,21,.667,103,39,98,.398,29,63,.460,10,35,.286,10,11,.909,98
642,ATL,2016-02-26,103,,CHI,W 103-88,240,37,89,.416,30,55,.545,7,34,.206,22,24,.917,103,32,88,.364,27,68,.397,5,20,.250,19,22,.864,88
643,DAL,2016-02-24,103,,OKC,L 103-116,240,35,86,.407,26,58,.448,9,28,.321,24,30,.800,103,43,89,.483,31,56,.554,12,33,.364,18,22,.818,116
644,WAS,2016-02-18,103,,UTA,W 103-89,240,42,86,.488,35,68,.515,7,18,.389,12,21,.571,103,31,77,.403,27,62,.435,4,15,.267,23,29,.793,89
645,PHI,2016-02-06,103,,BRK,W 103-98,240,38,81,.469,28,52,.538,10,29,.345,17,22,.773,103,35,76,.461,30,61,.492,5,15,.333,23,26,.885,98
646,CLE,2016-02-05,103,,BOS,L 103-104,240,37,87,.425,29,57,.509,8,30,.267,21,35,.600,103,38,88,.432,31,68,.456,7,20,.350,21,25,.840,104
647,POR,2016-02-04,103,,TOR,L 103-110,240,38,81,.469,28,56,.500,10,25,.400,17,23,.739,103,40,85,.471,28,66,.424,12,19,.632,18,25,.720,110
648,MIL,2016-01-29,103,,MIA,L 103-107,240,38,80,.475,36,68,.529,2,12,.167,25,28,.893,103,37,74,.500,30,56,.536,7,18,.389,26,32,.813,107
649,UTA,2016-01-29,103,,MIN,W 103-90,240,40,76,.526,30,51,.588,10,25,.400,13,16,.813,103,35,75,.467,33,65,.508,2,10,.200,18,26,.692,90
650,MEM,2016-01-28,103,,MIL,W 103-83,240,38,80,.475,28,52,.538,10,28,.357,17,20,.850,103,29,79,.367,28,63,.444,1,16,.063,24,27,.889,83
651,TOR,2016-01-28,103,,NYK,W 103-93,240,37,85,.435,29,65,.446,8,20,.400,21,29,.724,103,38,87,.437,31,69,.449,7,18,.389,10,20,.500,93
652,LAC,2016-01-16,103,,SAC,L 103-110,240,38,96,.396,25,57,.439,13,39,.333,14,19,.737,103,36,76,.474,23,51,.451,13,25,.520,25,33,.758,110
653,MEM,2016-01-16,103,,NYK,W 103-95,240,39,82,.476,34,72,.472,5,10,.500,20,26,.769,103,35,77,.455,30,57,.526,5,20,.250,20,24,.833,95
654,MEM,2016-01-14,103,,DET,W 103-101,240,37,76,.487,28,60,.467,9,16,.563,20,25,.800,103,37,72,.514,22,40,.550,15,32,.469,12,17,.706,101
655,ORL,2016-01-14,103,,TOR,L 103-106 (OT),265,44,97,.454,35,74,.473,9,23,.391,6,8,.750,103,37,90,.411,29,66,.439,8,24,.333,24,31,.774,106
656,BOS,2016-01-13,103,,IND,W 103-94,240,40,90,.444,31,64,.484,9,26,.346,14,20,.700,103,37,91,.407,32,61,.525,5,30,.167,15,20,.750,94
657,DET,2016-01-09,103,,BRK,W 103-89,240,43,92,.467,35,65,.538,8,27,.296,9,14,.643,103,38,82,.463,33,73,.452,5,9,.556,8,10,.800,89
658,HOU,2016-01-07,103,,UTA,W 103-94,240,39,75,.520,32,52,.615,7,23,.304,18,26,.692,103,38,78,.487,31,50,.620,7,28,.250,11,17,.647,94
659,MIA,2016-01-04,103,,IND,W 103-100 (OT),265,34,90,.378,29,68,.426,5,22,.227,30,39,.769,103,37,94,.394,29,66,.439,8,28,.286,18,25,.720,100
660,WAS,2016-01-01,103,,ORL,W 103-91,240,43,92,.467,35,66,.530,8,26,.308,9,10,.900,103,40,85,.471,35,65,.538,5,20,.250,6,8,.750,91
661,DAL,2015-12-28,103,,MIL,W 103-93,240,38,84,.452,28,62,.452,10,22,.455,17,26,.654,103,38,79,.481,34,65,.523,4,14,.286,13,15,.867,93
662,GSW,2015-12-23,103,,UTA,W 103-85,240,39,83,.470,30,60,.500,9,23,.391,16,16,1.000,103,33,80,.413,26,60,.433,7,20,.350,12,14,.857,85
663,TOR,2015-12-22,103,,DAL,W 103-99,240,35,74,.473,23,48,.479,12,26,.462,21,27,.778,103,40,92,.435,29,63,.460,11,29,.379,8,11,.727,99
664,LAC,2015-12-16,103,,MIL,W 103-90,240,36,75,.480,25,54,.463,11,21,.524,20,24,.833,103,38,88,.432,33,72,.458,5,16,.313,9,11,.818,90
665,DET,2015-12-14,103,,LAC,L 103-105 (OT),265,37,89,.416,31,70,.443,6,19,.316,23,31,.742,103,44,97,.454,38,78,.487,6,19,.316,11,15,.733,105
666,WAS,2015-12-09,103,,HOU,L 103-109,240,39,89,.438,34,64,.531,5,25,.200,20,24,.833,103,40,83,.482,28,50,.560,12,33,.364,17,25,.680,109
667,MIA,2015-12-07,103,,WAS,L 103-114,240,41,69,.594,36,53,.679,5,16,.313,16,22,.727,103,46,92,.500,37,74,.500,9,18,.500,13,17,.765,114
668,MIN,2015-12-05,103,,POR,L 103-109,240,38,83,.458,33,68,.485,5,15,.333,22,26,.846,103,39,77,.506,29,57,.509,10,20,.500,21,30,.700,109
669,LAC,2015-12-05,103,,ORL,W 103-101,240,37,82,.451,25,51,.490,12,31,.387,17,25,.680,103,40,90,.444,34,70,.486,6,20,.300,15,18,.833,101
670,PHI,2015-12-01,103,,LAL,W 103-91,240,37,79,.468,23,47,.489,14,32,.438,15,23,.652,103,33,89,.371,25,55,.455,8,34,.235,17,24,.708,91
671,UTA,2015-11-30,103,,GSW,L 103-106,240,40,89,.449,34,70,.486,6,19,.316,17,22,.773,103,40,82,.488,26,53,.491,14,29,.483,12,15,.800,106
672,LAL,2015-11-29,103,,IND,L 103-107,240,38,99,.384,27,66,.409,11,33,.333,16,22,.727,103,34,83,.410,25,56,.446,9,27,.333,30,37,.811,107
673,OKC,2015-11-27,103,,DET,W 103-87,240,37,79,.468,30,55,.545,7,24,.292,22,26,.846,103,31,90,.344,22,61,.361,9,29,.310,16,20,.800,87
674,TOR,2015-11-25,103,,CLE,W 103-99,240,40,79,.506,29,54,.537,11,25,.440,12,22,.545,103,36,82,.439,22,53,.415,14,29,.483,13,16,.813,99
675,ATL,2015-11-18,103,,SAC,W 103-97,240,38,89,.427,29,59,.492,9,30,.300,18,24,.750,103,38,86,.442,33,70,.471,5,16,.313,16,18,.889,97
676,PHI,2015-11-11,103,,TOR,L 103-119,240,40,87,.460,28,58,.483,12,29,.414,11,17,.647,103,43,89,.483,38,71,.535,5,18,.278,28,31,.903,119
677,DEN,2015-11-11,103,,MIL,W 103-102,240,39,79,.494,31,55,.564,8,24,.333,17,24,.708,103,42,79,.532,32,57,.561,10,22,.455,8,9,.889,102
678,POR,2015-11-08,103,,DET,L 103-120,240,41,76,.539,32,51,.627,9,25,.360,12,18,.667,103,47,96,.490,36,66,.545,11,30,.367,15,22,.682,120
679,BOS,2015-10-30,103,,TOR,L 103-113,240,32,85,.376,25,59,.424,7,26,.269,32,41,.780,103,36,82,.439,25,56,.446,11,26,.423,30,35,.857,113
680,IND,2015-10-29,103,,MEM,L 103-112,240,37,78,.474,25,48,.521,12,30,.400,17,24,.708,103,41,82,.500,34,66,.515,7,16,.438,23,29,.793,112
681,SAS,2016-04-12,102,,OKC,W 102-98 (OT),265,37,87,.425,33,73,.452,4,14,.286,24,32,.750,102,35,87,.402,29,62,.468,6,25,.240,22,25,.880,98
682,IND,2016-04-12,102,,NYK,W 102-90,240,41,80,.513,35,61,.574,6,19,.316,14,20,.700,102,36,80,.450,26,53,.491,10,27,.370,8,9,.889,90
683,PHI,2016-04-08,102,,NYK,L 102-109,240,32,91,.352,18,54,.333,14,37,.378,24,36,.667,102,43,91,.473,39,75,.520,4,16,.250,19,30,.633,109
684,DEN,2016-04-08,102,,SAS,W 102-98,240,40,86,.465,34,64,.531,6,22,.273,16,19,.842,102,36,85,.424,33,71,.465,3,14,.214,23,28,.821,98
685,DEN,2016-04-05,102,,OKC,L 102-124,240,37,88,.420,27,58,.466,10,30,.333,18,27,.667,102,46,87,.529,31,54,.574,15,33,.455,17,24,.708,124
686,SAS,2016-04-02,102,,TOR,W 102-95,240,35,77,.455,30,57,.526,5,20,.250,27,30,.900,102,40,80,.500,34,62,.548,6,18,.333,9,10,.900,95
687,PHI,2016-04-02,102,,IND,L 102-115,240,34,83,.410,18,46,.391,16,37,.432,18,26,.692,102,44,84,.524,36,61,.590,8,23,.348,19,23,.826,115
688,LAL,2016-03-30,102,,MIA,W 102-100 (OT),265,37,102,.363,31,82,.378,6,20,.300,22,29,.759,102,41,86,.477,38,69,.551,3,17,.176,15,26,.577,100
689,GSW,2016-03-29,102,,WAS,W 102-94,240,38,87,.437,27,62,.435,11,25,.440,15,23,.652,102,36,86,.419,31,63,.492,5,23,.217,17,27,.630,94
690,ATL,2016-03-21,102,,WAS,L 102-117,240,38,78,.487,25,45,.556,13,33,.394,13,17,.765,102,46,91,.505,33,66,.500,13,25,.520,12,20,.600,117
691,NYK,2016-03-05,102,,DET,W 102-89,240,42,79,.532,38,63,.603,4,16,.250,14,18,.778,102,36,92,.391,30,66,.455,6,26,.231,11,15,.733,89
692,PHI,2016-03-04,102,,MIA,L 102-112,240,36,95,.379,27,64,.422,9,31,.290,21,27,.778,102,39,88,.443,34,72,.472,5,16,.313,29,36,.806,112
693,ORL,2016-03-02,102,,CHI,W 102-89,240,39,97,.402,32,76,.421,7,21,.333,17,22,.773,102,38,99,.384,32,80,.400,6,19,.316,7,11,.636,89
694,IND,2016-02-28,102,,POR,L 102-111,240,40,93,.430,37,79,.468,3,14,.214,19,25,.760,102,41,81,.506,27,57,.474,14,24,.583,15,21,.714,111
695,ORL,2016-02-21,102,,IND,L 102-105,240,38,91,.418,31,66,.470,7,25,.280,19,29,.655,102,41,82,.500,32,58,.552,9,24,.375,14,21,.667,105
696,MIN,2016-02-08,102,,NOP,L 102-116,240,36,81,.444,34,69,.493,2,12,.167,28,35,.800,102,47,97,.485,37,73,.507,10,24,.417,12,20,.600,116
697,ATL,2016-02-05,102,,IND,W 102-96,240,39,76,.513,29,49,.592,10,27,.370,14,20,.700,102,38,91,.418,25,60,.417,13,31,.419,7,9,.778,96
698,BOS,2016-02-03,102,,DET,W 102-95,240,42,96,.438,35,75,.467,7,21,.333,11,13,.846,102,32,85,.376,21,51,.412,11,34,.324,20,28,.714,95
699,SAC,2016-02-03,102,,CHI,L 102-107,240,42,88,.477,36,68,.529,6,20,.300,12,19,.632,102,40,88,.455,29,67,.433,11,21,.524,16,21,.762,107
700,LAC,2016-02-03,102,,MIN,L 102-108,240,33,75,.440,22,43,.512,11,32,.344,25,34,.735,102,39,77,.506,31,60,.517,8,17,.471,22,26,.846,108
701,NYK,2016-01-29,102,,PHO,W 102-84,240,36,84,.429,29,64,.453,7,20,.350,23,26,.885,102,35,85,.412,28,59,.475,7,26,.269,7,12,.583,84
702,UTA,2016-01-27,102,,CHO,W 102-73,240,40,81,.494,28,50,.560,12,31,.387,10,15,.667,102,25,68,.368,19,43,.442,6,25,.240,17,21,.810,73
703,HOU,2016-01-22,102,,MIL,W 102-98,240,38,94,.404,23,50,.460,15,44,.341,11,16,.688,102,39,85,.459,36,71,.507,3,14,.214,17,22,.773,98
704,CHI,2015-12-30,102,,IND,W 102-100 (OT),265,37,86,.430,31,68,.456,6,18,.333,22,27,.815,102,37,97,.381,30,75,.400,7,22,.318,19,24,.792,100
705,CHI,2015-12-21,102,,BRK,L 102-105,240,43,95,.453,34,69,.493,9,26,.346,7,13,.538,102,43,94,.457,36,74,.486,7,20,.350,12,14,.857,105
706,HOU,2015-12-21,102,,CHO,W 102-95,240,33,71,.465,26,43,.605,7,28,.250,29,41,.707,102,29,83,.349,17,42,.405,12,41,.293,25,31,.806,95
707,ORL,2015-12-18,102,,POR,W 102-94,240,39,84,.464,37,69,.536,2,15,.133,22,31,.710,102,32,73,.438,21,41,.512,11,32,.344,19,26,.731,94
708,TOR,2015-12-07,102,,LAL,W 102-93,240,34,74,.459,25,49,.510,9,25,.360,25,32,.781,102,34,83,.410,27,64,.422,7,19,.368,18,20,.900,93
709,DET,2015-12-04,102,,MIL,W 102-95,240,34,82,.415,27,59,.458,7,23,.304,27,39,.692,102,39,87,.448,35,69,.507,4,18,.222,13,14,.929,95
710,LAC,2015-11-30,102,,POR,W 102-87,240,33,85,.388,25,66,.379,8,19,.421,28,56,.500,102,33,87,.379,28,64,.438,5,23,.217,16,27,.593,87
711,TOR,2015-11-29,102,,PHO,L 102-107,240,38,86,.442,26,57,.456,12,29,.414,14,17,.824,102,40,94,.426,29,67,.433,11,27,.407,16,20,.800,107
712,HOU,2015-11-21,102,,NYK,L 102-107,240,35,81,.432,23,53,.434,12,28,.429,20,28,.714,102,34,80,.425,22,55,.400,12,25,.480,27,34,.794,107
713,POR,2015-11-20,102,,LAC,W 102-91,240,38,90,.422,30,65,.462,8,25,.320,18,24,.750,102,38,86,.442,31,62,.500,7,24,.292,8,16,.500,91
714,DAL,2015-11-20,102,,UTA,W 102-93,240,39,83,.470,31,55,.564,8,28,.286,16,17,.941,102,35,80,.438,29,60,.483,6,20,.300,17,21,.810,93
715,BOS,2015-11-18,102,,DAL,L 102-106,240,38,92,.413,30,66,.455,8,26,.308,18,24,.750,102,37,72,.514,30,52,.577,7,20,.350,25,35,.714,106
716,NYK,2015-11-17,102,,CHO,W 102-94,240,36,89,.404,26,69,.377,10,20,.500,20,21,.952,102,36,82,.439,31,62,.500,5,20,.250,17,25,.680,94
717,ORL,2015-11-13,102,,UTA,W 102-93,240,32,76,.421,22,49,.449,10,27,.370,28,31,.903,102,34,87,.391,26,62,.419,8,25,.320,17,23,.739,93
718,OKC,2015-11-13,102,,PHI,W 102-85,240,39,97,.402,31,72,.431,8,25,.320,16,21,.762,102,30,86,.349,25,69,.362,5,17,.294,20,28,.714,85
719,CHI,2015-11-13,102,,CHO,W 102-97,240,37,84,.440,33,68,.485,4,16,.250,24,31,.774,102,36,95,.379,21,62,.339,15,33,.455,10,12,.833,97
720,WAS,2015-11-04,102,,SAS,W 102-99,240,42,87,.483,34,64,.531,8,23,.348,10,14,.714,102,37,81,.457,30,59,.508,7,22,.318,18,20,.900,99
721,LAC,2015-11-02,102,,PHO,W 102-96,240,37,81,.457,29,55,.527,8,26,.308,20,23,.870,102,36,98,.367,27,68,.397,9,30,.300,15,21,.714,96
722,SAS,2015-10-30,102,,BRK,W 102-75,240,40,86,.465,31,64,.484,9,22,.409,13,13,1.000,102,31,77,.403,26,61,.426,5,16,.313,8,15,.533,75
723,CLE,2015-10-30,102,,MIA,W 102-92,240,39,86,.453,33,61,.541,6,25,.240,18,21,.857,102,33,77,.429,27,56,.482,6,21,.286,20,22,.909,92
724,LAL,2016-04-13,101,,UTA,W 101-96,240,41,85,.482,35,60,.583,6,25,.240,13,15,.867,101,39,83,.470,30,53,.566,9,30,.300,9,15,.600,96
725,PHO,2016-04-11,101,,SAC,L 101-105,240,41,100,.410,36,78,.462,5,22,.227,14,17,.824,101,41,83,.494,35,66,.530,6,17,.353,17,28,.607,105
726,NOP,2016-03-31,101,,DEN,W 101-95,240,40,90,.444,27,61,.443,13,29,.448,8,9,.889,101,36,83,.434,26,56,.464,10,27,.370,13,17,.765,95
727,ATL,2016-03-25,101,,MIL,W 101-90,240,41,97,.423,36,65,.554,5,32,.156,14,17,.824,101,35,84,.417,32,71,.451,3,13,.231,17,26,.654,90
728,WAS,2016-03-23,101,,ATL,L 101-122,240,39,92,.424,27,62,.435,12,30,.400,11,12,.917,101,45,84,.536,28,42,.667,17,42,.405,15,22,.682,122
729,LAC,2016-03-11,101,,NYK,W 101-94,240,38,85,.447,25,56,.446,13,29,.448,12,16,.750,101,34,83,.410,30,63,.476,4,20,.200,22,25,.880,94
730,DAL,2016-03-03,101,,SAC,L 101-104,240,45,94,.479,38,65,.585,7,29,.241,4,6,.667,101,42,80,.525,35,55,.636,7,25,.280,13,24,.542,104
731,BOS,2016-02-27,101,,MIA,W 101-89,240,39,96,.406,34,80,.425,5,16,.313,18,22,.818,101,36,87,.414,35,74,.473,1,13,.077,16,23,.696,89
732,MIA,2016-02-22,101,,IND,W 101-93 (OT),265,38,100,.380,36,87,.414,2,13,.154,23,34,.676,101,36,92,.391,31,77,.403,5,15,.333,16,25,.640,93
733,DEN,2016-02-21,101,,BOS,L 101-121,240,34,73,.466,28,52,.538,6,21,.286,27,34,.794,101,47,97,.485,37,65,.569,10,32,.313,17,20,.850,121
734,MIA,2016-02-09,101,,SAS,L 101-119,240,40,70,.571,36,58,.621,4,12,.333,17,24,.708,101,47,89,.528,41,75,.547,6,14,.429,19,26,.731,119
735,TOR,2016-01-22,101,,MIA,W 101-81,240,35,75,.467,22,50,.440,13,25,.520,18,21,.857,101,33,81,.407,29,64,.453,4,17,.235,11,17,.647,81
736,DEN,2016-01-21,101,,MEM,L 101-102,240,36,80,.450,27,50,.540,9,30,.300,20,26,.769,101,36,72,.500,30,51,.588,6,21,.286,24,29,.828,102
737,MEM,2016-01-18,101,,NOP,W 101-99,240,35,75,.467,27,56,.482,8,19,.421,23,30,.767,101,36,74,.486,30,55,.545,6,19,.316,21,23,.913,99
738,DET,2016-01-18,101,,CHI,L 101-111,240,42,95,.442,37,69,.536,5,26,.192,12,20,.600,101,44,84,.524,35,63,.556,9,21,.429,14,20,.700,111
739,UTA,2016-01-14,101,,SAC,L 101-103,240,35,83,.422,29,49,.592,6,34,.176,25,34,.735,101,34,74,.459,29,63,.460,5,11,.455,30,42,.714,103
740,MEM,2016-01-10,101,,BOS,W 101-98,240,31,84,.369,27,68,.397,4,16,.250,35,40,.875,101,37,88,.420,30,66,.455,7,22,.318,17,23,.739,98
741,CHI,2016-01-07,101,,BOS,W 101-92,240,39,94,.415,30,72,.417,9,22,.409,14,17,.824,101,35,98,.357,30,73,.411,5,25,.200,17,22,.773,92
742,ATL,2016-01-05,101,,NYK,L 101-107,240,37,87,.425,22,48,.458,15,39,.385,12,19,.632,101,40,84,.476,35,66,.530,5,18,.278,22,24,.917,107
743,SAS,2015-12-28,101,,MIN,W 101-95,240,37,72,.514,32,55,.582,5,17,.294,22,28,.786,101,39,82,.476,36,71,.507,3,11,.273,14,24,.583,95
744,SAS,2015-12-26,101,,DEN,W 101-86,240,39,81,.481,32,71,.451,7,10,.700,16,17,.941,101,38,86,.442,33,68,.485,5,18,.278,5,6,.833,86
745,ORL,2015-12-26,101,,MIA,L 101-108,240,43,79,.544,34,60,.567,9,19,.474,6,13,.462,101,38,77,.494,28,57,.491,10,20,.500,22,23,.957,108
746,BOS,2015-12-18,101,,ATL,L 101-109,240,34,77,.442,24,54,.444,10,23,.435,23,31,.742,101,41,88,.466,37,68,.544,4,20,.200,23,29,.793,109
747,CHI,2015-12-07,101,,PHO,L 101-103,240,41,90,.456,35,69,.507,6,21,.286,13,18,.722,101,41,92,.446,34,75,.453,7,17,.412,14,17,.824,103
748,UTA,2015-11-28,101,,NOP,W 101-87,240,38,82,.463,29,64,.453,9,18,.500,16,21,.762,101,29,69,.420,24,52,.462,5,17,.294,24,30,.800,87
749,MEM,2015-11-27,101,,ATL,L 101-116,240,35,80,.438,23,50,.460,12,30,.400,19,21,.905,101,35,75,.467,21,36,.583,14,39,.359,32,36,.889,116
750,CHO,2015-11-25,101,,WAS,W 101-87,240,39,83,.470,31,57,.544,8,26,.308,15,15,1.000,101,31,87,.356,21,55,.382,10,32,.313,15,18,.833,87
751,LAC,2015-11-14,101,,DET,W 101-96,240,37,79,.468,30,60,.500,7,19,.368,20,26,.769,101,33,74,.446,26,47,.553,7,27,.259,23,35,.657,96
752,MEM,2015-11-13,101,,POR,W 101-100,240,36,86,.419,30,70,.429,6,16,.375,23,27,.852,101,33,69,.478,25,47,.532,8,22,.364,26,29,.897,100
753,SAC,2015-11-11,101,,DET,W 101-92,240,37,74,.500,28,58,.483,9,16,.563,18,24,.750,101,34,89,.382,25,57,.439,9,32,.281,15,20,.750,92
754,ORL,2015-11-11,101,,LAL,W 101-99,240,40,100,.400,27,72,.375,13,28,.464,8,12,.667,101,39,79,.494,32,57,.561,7,22,.318,14,18,.778,99
755,POR,2015-11-11,101,,SAS,L 101-113,240,39,88,.443,30,66,.455,9,22,.409,14,23,.609,101,46,82,.561,39,67,.582,7,15,.467,14,18,.778,113
756,WAS,2015-11-10,101,,OKC,L 101-125,240,38,97,.392,33,73,.452,5,24,.208,20,26,.769,101,44,86,.512,29,63,.460,15,23,.652,22,29,.759,125
757,MIA,2015-11-10,101,,LAL,W 101-88,240,38,84,.452,33,64,.516,5,20,.250,20,27,.741,101,34,77,.442,23,55,.418,11,22,.500,9,12,.750,88
758,CLE,2015-11-08,101,,IND,W 101-97,240,38,83,.458,30,59,.508,8,24,.333,17,25,.680,101,39,90,.433,33,72,.458,6,18,.333,13,19,.684,97
759,ATL,2015-11-04,101,,BRK,W 101-87,240,37,76,.487,29,54,.537,8,22,.364,19,24,.792,101,36,83,.434,31,62,.500,5,21,.238,10,13,.769,87
760,MIN,2015-11-02,101,,POR,L 101-106,240,34,79,.430,31,66,.470,3,13,.231,30,39,.769,101,41,89,.461,32,59,.542,9,30,.300,15,20,.750,106
761,MEM,2015-10-31,101,,BRK,W 101-91,240,34,80,.425,25,57,.439,9,23,.391,24,28,.857,101,38,79,.481,35,66,.530,3,13,.231,12,18,.667,91
762,NYK,2015-10-29,101,,ATL,L 101-112,240,38,93,.409,32,64,.500,6,29,.207,19,21,.905,101,42,83,.506,32,59,.542,10,24,.417,18,26,.692,112
763,BOS,2016-04-11,100,,CHO,L 100-114,240,34,89,.382,26,65,.400,8,24,.333,24,29,.828,100,41,81,.506,27,49,.551,14,32,.438,18,22,.818,114
764,NOP,2016-04-09,100,,PHO,L 100-121,240,39,95,.411,32,74,.432,7,21,.333,15,20,.750,100,43,83,.518,33,58,.569,10,25,.400,25,31,.806,121
765,LAL,2016-04-03,100,,BOS,L 100-107,240,37,90,.411,31,69,.449,6,21,.286,20,29,.690,100,41,91,.451,33,61,.541,8,30,.267,17,22,.773,107
766,CHO,2016-04-01,100,,PHI,W 100-91,240,36,84,.429,29,57,.509,7,27,.259,21,27,.778,100,33,90,.367,23,51,.451,10,39,.256,15,21,.714,91
767,HOU,2016-03-31,100,,CHI,L 100-103,240,36,90,.400,27,65,.415,9,25,.360,19,22,.864,100,37,77,.481,26,53,.491,11,24,.458,18,22,.818,103
768,SAS,2016-03-30,100,,NOP,W 100-92,240,36,75,.480,24,51,.471,12,24,.500,16,22,.727,100,36,80,.450,28,63,.444,8,17,.471,12,18,.667,92
769,CLE,2016-03-29,100,,HOU,L 100-106,240,31,86,.360,17,46,.370,14,40,.350,24,28,.857,100,38,79,.481,29,54,.537,9,25,.360,21,42,.500,106
770,CHI,2016-03-28,100,,ATL,L 100-102,240,40,106,.377,31,84,.369,9,22,.409,11,15,.733,100,36,85,.424,31,63,.492,5,22,.227,25,28,.893,102
771,TOR,2016-03-28,100,,OKC,L 100-119,240,38,93,.409,30,69,.435,8,24,.333,16,23,.696,100,41,86,.477,30,60,.500,11,26,.423,26,32,.813,119
772,BRK,2016-03-22,100,,CHO,L 100-105,240,34,74,.459,26,56,.464,8,18,.444,24,27,.889,100,39,82,.476,29,54,.537,10,28,.357,17,21,.810,105
773,BRK,2016-03-13,100,,MIL,L 100-109,240,39,70,.557,27,43,.628,12,27,.444,10,13,.769,100,45,89,.506,39,75,.520,6,14,.429,13,21,.619,109
774,SAC,2016-03-11,100,,ORL,L 100-107,240,35,88,.398,27,63,.429,8,25,.320,22,25,.880,100,41,79,.519,37,64,.578,4,15,.267,21,34,.618,107
775,CHI,2016-03-07,100,,MIL,W 100-90,240,39,78,.500,29,53,.547,10,25,.400,12,15,.800,100,36,91,.396,29,73,.397,7,18,.389,11,17,.647,90
776,MEM,2016-03-06,100,,PHO,L 100-109,240,32,80,.400,22,58,.379,10,22,.455,26,33,.788,100,37,71,.521,25,43,.581,12,28,.429,23,30,.767,109
777,HOU,2016-03-02,100,,NOP,W 100-95,240,36,81,.444,33,46,.717,3,35,.086,25,38,.658,100,36,90,.400,22,53,.415,14,37,.378,9,13,.692,95
778,BOS,2016-02-29,100,,UTA,W 100-95,240,37,84,.440,31,66,.470,6,18,.333,20,29,.690,100,38,101,.376,31,77,.403,7,24,.292,12,17,.706,95
779,CLE,2016-02-29,100,,IND,W 100-96,240,35,83,.422,26,54,.481,9,29,.310,21,25,.840,100,37,80,.463,29,62,.468,8,18,.444,14,15,.933,96
780,PHO,2016-02-19,100,,HOU,L 100-116,240,30,82,.366,19,47,.404,11,35,.314,29,35,.829,100,37,78,.474,30,54,.556,7,24,.292,35,56,.625,116
781,NOP,2016-02-10,100,,UTA,W 100-96,240,39,82,.476,31,63,.492,8,19,.421,14,21,.667,100,33,70,.471,26,49,.531,7,21,.333,23,30,.767,96
782,BRK,2016-02-03,100,,IND,L 100-114,240,36,81,.444,29,58,.500,7,23,.304,21,31,.677,100,44,88,.500,32,64,.500,12,24,.500,14,17,.824,114
783,BRK,2016-02-01,100,,DET,L 100-105,240,40,82,.488,33,66,.500,7,16,.438,13,15,.867,100,42,98,.429,32,68,.471,10,30,.333,11,16,.688,105
784,CHI,2016-01-11,100,,WAS,L 100-114,240,34,81,.420,25,59,.424,9,22,.409,23,27,.852,100,48,99,.485,39,75,.520,9,24,.375,9,10,.900,114
785,NYK,2016-01-10,100,,MIL,W 100-88,240,39,84,.464,32,60,.533,7,24,.292,15,18,.833,100,32,80,.400,29,67,.433,3,13,.231,21,30,.700,88
786,SAS,2016-01-08,100,,NYK,W 100-99,240,41,93,.441,37,80,.463,4,13,.308,14,17,.824,100,38,91,.418,29,70,.414,9,21,.429,14,17,.824,99
787,ORL,2015-12-30,100,,BRK,W 100-93,240,36,82,.439,27,56,.482,9,26,.346,19,21,.905,100,35,83,.422,32,63,.508,3,20,.150,20,22,.909,93
788,BOS,2015-12-27,100,,NYK,W 100-91,240,36,85,.424,28,65,.431,8,20,.400,20,29,.690,100,33,89,.371,29,70,.414,4,19,.211,21,24,.875,91
789,WAS,2015-12-23,100,,MEM,W 100-91,240,37,82,.451,26,57,.456,11,25,.440,15,19,.789,100,33,72,.458,30,55,.545,3,17,.176,22,32,.688,91
790,ORL,2015-12-20,100,,ATL,L 100-103,240,38,81,.469,34,69,.493,4,12,.333,20,24,.833,100,39,78,.500,28,56,.500,11,22,.500,14,20,.700,103
791,MIN,2015-12-15,100,,DEN,L 100-112,240,36,77,.468,32,67,.478,4,10,.400,24,31,.774,100,41,73,.562,31,55,.564,10,18,.556,20,27,.741,112
792,MIA,2015-12-13,100,,MEM,W 100-97,240,37,77,.481,30,55,.545,7,22,.318,19,23,.826,100,40,77,.519,33,58,.569,7,19,.368,10,14,.714,97
793,BRK,2015-12-12,100,,LAC,L 100-105,240,35,79,.443,30,60,.500,5,19,.263,25,30,.833,100,43,86,.500,35,62,.565,8,24,.333,11,18,.611,105
794,BRK,2015-12-10,100,,PHI,W 100-91,240,37,74,.500,31,60,.517,6,14,.429,20,27,.741,100,34,87,.391,30,56,.536,4,31,.129,19,22,.864,91
795,ATL,2015-12-04,100,,LAL,W 100-87,240,37,74,.500,27,48,.563,10,26,.385,16,20,.800,100,32,86,.372,19,59,.322,13,27,.481,10,13,.769,87
796,ORL,2015-11-25,100,,NYK,W 100-91,240,34,86,.395,29,70,.414,5,16,.313,27,32,.844,100,31,83,.373,22,56,.393,9,27,.333,20,25,.800,91
797,MIN,2015-11-23,100,,PHI,W 100-95,240,36,78,.462,33,66,.500,3,12,.250,25,27,.926,100,32,78,.410,22,47,.468,10,31,.323,21,27,.778,95
798,TOR,2015-11-13,100,,NOP,W 100-81,240,34,77,.442,25,56,.446,9,21,.429,23,27,.852,100,30,82,.366,23,59,.390,7,23,.304,14,20,.700,81
799,IND,2015-11-04,100,,BOS,W 100-98,240,35,91,.385,27,68,.397,8,23,.348,22,29,.759,100,35,83,.422,25,56,.446,10,27,.370,18,22,.818,98
800,PHI,2015-11-02,100,,CLE,L 100-107,240,38,85,.447,31,61,.508,7,24,.292,17,23,.739,100,42,81,.519,34,59,.576,8,22,.364,15,20,.750,107
801,BRK,2015-10-28,100,,CHI,L 100-115,240,39,93,.419,39,84,.464,0,9,.000,22,28,.786,100,42,78,.538,28,50,.560,14,28,.500,17,20,.850,115
802,MEM,2016-04-09,99,,GSW,L 99-100,240,37,96,.385,30,75,.400,7,21,.333,18,20,.900,99,39,87,.448,29,51,.569,10,36,.278,12,13,.923,100
803,UTA,2016-04-08,99,,LAC,L 99-102 (OT),265,36,82,.439,25,51,.490,11,31,.355,16,23,.696,99,37,83,.446,24,54,.444,13,29,.448,15,19,.789,102
804,PHO,2016-04-01,99,,WAS,L 99-106,240,36,93,.387,29,70,.414,7,23,.304,20,26,.769,99,38,86,.442,28,60,.467,10,26,.385,20,25,.800,106
805,NOP,2016-03-28,99,,NYK,W 99-91,240,32,75,.427,24,56,.429,8,19,.421,27,37,.730,99,36,89,.404,26,58,.448,10,31,.323,9,13,.692,91
806,PHO,2016-03-26,99,,BOS,L 99-102,240,37,85,.435,30,54,.556,7,31,.226,18,21,.857,99,35,84,.417,27,55,.491,8,29,.276,24,27,.889,102
807,NOP,2016-03-22,99,,MIA,L 99-113,240,34,87,.391,27,71,.380,7,16,.438,24,30,.800,99,44,88,.500,41,69,.594,3,19,.158,22,27,.815,113
808,WAS,2016-03-19,99,,NYK,W 99-89,240,39,87,.448,31,58,.534,8,29,.276,13,17,.765,99,32,81,.395,22,60,.367,10,21,.476,15,17,.882,89
809,CLE,2016-03-16,99,,DAL,W 99-98,240,39,88,.443,29,51,.569,10,37,.270,11,13,.846,99,37,79,.468,30,57,.526,7,22,.318,17,19,.895,98
810,SAC,2016-03-13,99,,UTA,L 99-108,240,38,81,.469,29,60,.483,9,21,.429,14,21,.667,99,39,82,.476,27,54,.500,12,28,.429,18,22,.818,108
811,IND,2016-03-07,99,,SAS,W 99-91,240,32,78,.410,25,62,.403,7,16,.438,28,30,.933,99,34,96,.354,30,68,.441,4,28,.143,19,22,.864,91
812,WAS,2016-03-05,99,,IND,L 99-100,240,39,89,.438,33,74,.446,6,15,.400,15,24,.625,99,37,83,.446,30,62,.484,7,21,.333,19,20,.950,100
813,MIL,2016-03-02,99,,IND,L 99-104,240,34,76,.447,31,62,.500,3,14,.214,28,32,.875,99,38,80,.475,28,60,.467,10,20,.500,18,26,.692,104
814,PHI,2016-03-02,99,,CHO,L 99-119,240,34,85,.400,21,52,.404,13,33,.394,18,26,.692,99,40,81,.494,30,56,.536,10,25,.400,29,35,.829,119
815,TOR,2016-02-26,99,,CLE,W 99-97,240,37,73,.507,31,56,.554,6,17,.353,19,26,.731,99,35,74,.473,23,50,.460,12,24,.500,15,21,.714,97
816,MIL,2016-02-11,99,,WAS,W 99-92,240,36,82,.439,32,68,.471,4,14,.286,23,32,.719,99,34,88,.386,28,56,.500,6,32,.188,18,24,.750,92
817,CLE,2016-02-06,99,,NOP,W 99-84,240,39,90,.433,25,49,.510,14,41,.341,7,7,1.000,99,34,87,.391,29,64,.453,5,23,.217,11,16,.688,84
818,OKC,2016-01-17,99,,MIA,W 99-74,240,40,88,.455,33,66,.500,7,22,.318,12,12,1.000,99,30,72,.417,26,58,.448,4,14,.286,10,11,.909,74
819,SAS,2016-01-14,99,,CLE,W 99-95,240,38,83,.458,33,66,.500,5,17,.294,18,22,.818,99,38,82,.463,28,56,.500,10,26,.385,9,11,.818,95
820,POR,2016-01-13,99,,UTA,W 99-85,240,39,88,.443,28,62,.452,11,26,.423,10,15,.667,99,31,76,.408,23,57,.404,8,19,.421,15,22,.682,85
821,DET,2016-01-12,99,,SAS,L 99-109,240,38,91,.418,32,68,.471,6,23,.261,17,26,.654,99,41,85,.482,36,71,.507,5,14,.357,22,27,.815,109
822,ORL,2016-01-09,99,,WAS,L 99-105,240,38,74,.514,33,60,.550,5,14,.357,18,24,.750,99,42,76,.553,29,53,.547,13,23,.565,8,10,.800,105
823,MIN,2016-01-08,99,,CLE,L 99-125,240,36,79,.456,29,63,.460,7,16,.438,20,26,.769,99,43,81,.531,30,54,.556,13,27,.481,26,29,.897,125
824,MEM,2015-12-29,99,,MIA,W 99-90 (OT),265,38,87,.437,34,72,.472,4,15,.267,19,20,.950,99,35,79,.443,24,50,.480,11,29,.379,9,18,.500,90
825,NYK,2015-12-21,99,,ORL,L 99-107,240,39,76,.513,32,52,.615,7,24,.292,14,16,.875,99,44,86,.512,34,64,.531,10,22,.455,9,11,.818,107
826,LAC,2015-12-21,99,,OKC,L 99-100,240,41,87,.471,34,65,.523,7,22,.318,10,14,.714,99,40,85,.471,36,68,.529,4,17,.235,16,20,.800,100
827,MIN,2015-12-18,99,,SAC,W 99-95,240,39,82,.476,33,64,.516,6,18,.333,15,16,.938,99,38,81,.469,31,58,.534,7,23,.304,12,17,.706,95
828,MEM,2015-12-11,99,,CHO,L 99-123,240,32,80,.400,25,60,.417,7,20,.350,28,37,.757,99,39,78,.500,21,41,.512,18,37,.486,27,30,.900,123
829,SAC,2015-12-10,99,,NYK,W 99-97,240,42,93,.452,39,77,.506,3,16,.188,12,16,.750,99,33,83,.398,24,54,.444,9,29,.310,22,28,.786,97
830,CHO,2015-12-09,99,,MIA,W 99-81,240,40,81,.494,29,54,.537,11,27,.407,8,17,.471,99,29,75,.387,23,54,.426,6,21,.286,17,24,.708,81
831,MIA,2015-12-05,99,,CLE,W 99-84,240,37,68,.544,30,52,.577,7,16,.438,18,29,.621,99,31,85,.365,25,57,.439,6,28,.214,16,24,.667,84
832,CHI,2015-12-02,99,,DEN,W 99-90,240,36,89,.404,30,72,.417,6,17,.353,21,27,.778,99,36,93,.387,31,78,.397,5,15,.333,13,22,.591,90
833,CHO,2015-12-02,99,,GSW,L 99-116,240,35,94,.372,26,63,.413,9,31,.290,20,30,.667,99,46,88,.523,30,54,.556,16,34,.471,8,11,.727,116
834,NYK,2015-12-02,99,,PHI,W 99-87,240,38,88,.432,34,69,.493,4,19,.211,19,22,.864,99,32,86,.372,23,56,.411,9,30,.300,14,24,.583,87
835,MIN,2015-11-25,99,,ATL,W 99-95,240,34,82,.415,25,61,.410,9,21,.429,22,29,.759,99,31,82,.378,23,51,.451,8,31,.258,25,35,.714,95
836,NYK,2015-11-08,99,,LAL,W 99-95,240,33,84,.393,24,57,.421,9,27,.333,24,29,.828,99,36,94,.383,27,67,.403,9,27,.333,14,23,.609,95
837,BOS,2016-04-13,98,,MIA,W 98-88,240,37,86,.430,32,72,.444,5,14,.357,19,22,.864,98,38,88,.432,36,69,.522,2,19,.105,10,12,.833,88
838,LAC,2016-04-10,98,,DAL,W 98-91,240,37,76,.487,28,58,.483,9,18,.500,15,37,.405,98,30,74,.405,22,44,.500,8,30,.267,23,33,.697,91
839,MIL,2016-04-03,98,,CHI,L 98-102,240,40,85,.471,38,78,.487,2,7,.286,16,20,.800,98,39,74,.527,32,48,.667,7,26,.269,17,22,.773,102
840,UTA,2016-04-01,98,,MIN,W 98-85,240,38,72,.528,30,50,.600,8,22,.364,14,23,.609,98,35,79,.443,26,56,.464,9,23,.391,6,10,.600,85
841,LAL,2016-03-15,98,,SAC,L 98-106,240,37,84,.440,32,58,.552,5,26,.192,19,26,.731,98,38,79,.481,34,61,.557,4,18,.222,26,33,.788,106
842,BOS,2016-03-11,98,,HOU,L 98-102,240,34,91,.374,26,60,.433,8,31,.258,22,28,.786,98,40,88,.455,35,62,.565,5,26,.192,17,25,.680,102
843,MIN,2016-03-02,98,,WAS,L 98-104,240,32,75,.427,27,61,.443,5,14,.357,29,34,.853,98,42,84,.500,31,55,.564,11,29,.379,9,13,.692,104
844,TOR,2016-02-21,98,,MEM,W 98-85,240,33,81,.407,26,53,.491,7,28,.250,25,31,.806,98,28,76,.368,25,56,.446,3,20,.150,26,32,.813,85
845,WAS,2016-02-19,98,,DET,W 98-86,240,36,78,.462,29,56,.518,7,22,.318,19,26,.731,98,35,82,.427,28,59,.475,7,23,.304,9,17,.529,86
846,OKC,2016-02-19,98,,IND,L 98-101,240,42,96,.438,37,70,.529,5,26,.192,9,10,.900,98,39,88,.443,30,66,.455,9,22,.409,14,22,.636,101
847,BRK,2016-01-26,98,,MIA,L 98-102,240,36,71,.507,27,53,.509,9,18,.500,17,23,.739,98,45,83,.542,42,74,.568,3,9,.333,9,10,.900,102
848,PHO,2016-01-23,98,,ATL,W 98-95,240,34,85,.400,24,61,.393,10,24,.417,20,26,.769,98,34,84,.405,22,50,.440,12,34,.353,15,18,.833,95
849,POR,2016-01-20,98,,ATL,L 98-104,240,41,94,.436,32,63,.508,9,31,.290,7,11,.636,98,39,87,.448,29,63,.460,10,24,.417,16,23,.696,104
850,ATL,2016-01-18,98,,ORL,W 98-81,240,41,80,.513,32,61,.525,9,19,.474,7,10,.700,98,30,87,.345,24,65,.369,6,22,.273,15,20,.750,81
851,CLE,2016-01-18,98,,GSW,L 98-132,240,37,77,.481,30,58,.517,7,19,.368,17,25,.680,98,46,85,.541,27,45,.600,19,40,.475,21,27,.778,132
852,WAS,2016-01-18,98,,POR,L 98-108,240,37,77,.481,28,56,.500,9,21,.429,15,20,.750,98,43,84,.512,26,53,.491,17,31,.548,5,11,.455,108
853,UTA,2016-01-09,98,,MIA,W 98-83,240,39,71,.549,30,51,.588,9,20,.450,11,18,.611,98,34,82,.415,28,63,.444,6,19,.316,9,17,.529,83
854,PHI,2016-01-07,98,,ATL,L 98-126,240,39,86,.453,34,68,.500,5,18,.278,15,25,.600,98,49,92,.533,36,60,.600,13,32,.406,15,19,.789,126
855,POR,2016-01-06,98,,LAC,L 98-109,240,38,86,.442,29,60,.483,9,26,.346,13,23,.565,98,42,83,.506,31,60,.517,11,23,.478,14,17,.824,109
856,MIL,2016-01-04,98,,SAS,L 98-123,240,37,77,.481,34,65,.523,3,12,.250,21,30,.700,98,49,90,.544,40,70,.571,9,20,.450,16,20,.800,123
857,DAL,2016-01-02,98,,NOP,L 98-105,240,36,83,.434,26,57,.456,10,26,.385,16,19,.842,98,40,83,.482,34,63,.540,6,20,.300,19,24,.792,105
858,CHO,2015-12-26,98,,MEM,W 98-92,240,28,69,.406,14,37,.378,14,32,.438,28,32,.875,98,37,90,.411,30,71,.423,7,19,.368,11,21,.524,92
859,CHI,2015-12-16,98,,MEM,W 98-85,240,38,86,.442,29,62,.468,9,24,.375,13,19,.684,98,32,76,.421,27,57,.474,5,19,.263,16,28,.571,85
860,BRK,2015-12-16,98,,MIA,L 98-104,240,42,89,.472,38,73,.521,4,16,.250,10,14,.714,98,40,75,.533,33,54,.611,7,21,.333,17,24,.708,104
861,CHI,2015-12-12,98,,NOP,W 98-94,240,33,78,.423,25,58,.431,8,20,.400,24,29,.828,98,40,89,.449,34,73,.466,6,16,.375,8,11,.727,94
862,BRK,2015-12-06,98,,GSW,L 98-114,240,39,89,.438,34,72,.472,5,17,.294,15,23,.652,98,44,86,.512,30,53,.566,14,33,.424,12,23,.522,114
863,OKC,2015-12-06,98,,SAC,W 98-95,240,35,86,.407,29,64,.453,6,22,.273,22,31,.710,98,35,88,.398,28,64,.438,7,24,.292,18,30,.600,95
864,SAS,2015-11-23,98,,PHO,W 98-84,240,42,82,.512,33,62,.532,9,20,.450,5,10,.500,98,34,73,.466,27,54,.500,7,19,.368,9,10,.900,84
865,NOP,2015-11-17,98,,DEN,L 98-115,240,41,83,.494,34,60,.567,7,23,.304,9,11,.818,98,45,85,.529,30,55,.545,15,30,.500,10,13,.769,115
866,HOU,2015-11-14,98,,DAL,L 98-110,240,32,84,.381,23,50,.460,9,34,.265,25,32,.781,98,43,89,.483,35,61,.574,8,28,.286,16,21,.762,110
867,HOU,2015-11-11,98,,BRK,L 98-106,240,42,98,.429,34,64,.531,8,34,.235,6,12,.500,98,42,98,.429,34,81,.420,8,17,.471,14,17,.824,106
868,BRK,2015-11-06,98,,LAL,L 98-104,240,40,93,.430,37,74,.500,3,19,.158,15,20,.750,98,33,78,.423,26,55,.473,7,23,.304,31,40,.775,104
869,OKC,2015-11-04,98,,TOR,L 98-103,240,39,82,.476,31,59,.525,8,23,.348,12,14,.857,98,33,79,.418,28,65,.431,5,14,.357,32,39,.821,103
870,DET,2015-10-30,98,,CHI,W 98-94 (OT),265,39,104,.375,33,76,.434,6,28,.214,14,28,.500,98,34,84,.405,27,62,.435,7,22,.318,19,26,.731,94
871,SAC,2016-04-07,97,,MIN,L 97-105,240,36,85,.424,30,68,.441,6,17,.353,19,21,.905,97,36,80,.450,25,59,.424,11,21,.524,22,31,.710,105
872,NYK,2016-04-06,97,,CHO,L 97-111,240,37,78,.474,27,52,.519,10,26,.385,13,15,.867,97,42,90,.467,30,64,.469,12,26,.462,15,17,.882,111
873,PHO,2016-03-21,97,,MEM,L 97-103,240,30,76,.395,19,48,.396,11,28,.393,26,34,.765,97,39,90,.433,31,70,.443,8,20,.400,17,19,.895,103
874,PHI,2016-03-18,97,,OKC,L 97-111,240,35,89,.393,25,60,.417,10,29,.345,17,27,.630,97,45,89,.506,38,67,.567,7,22,.318,14,18,.778,111
875,PHO,2016-03-09,97,,NYK,L 97-128,240,39,89,.438,30,60,.500,9,29,.310,10,15,.667,97,46,82,.561,30,58,.517,16,24,.667,20,24,.833,128
876,LAC,2016-03-05,97,,ATL,L 97-107,240,34,79,.430,22,47,.468,12,32,.375,17,28,.607,97,40,89,.449,30,62,.484,10,27,.370,17,20,.850,107
877,SAS,2016-03-02,97,,DET,W 97-81,240,43,84,.512,40,70,.571,3,14,.214,8,9,.889,97,31,78,.397,25,59,.424,6,19,.316,13,23,.565,81
878,PHO,2016-02-02,97,,TOR,L 97-104,240,37,79,.468,25,48,.521,12,31,.387,11,15,.733,97,35,74,.473,26,47,.553,9,27,.333,25,32,.781,104
879,CHO,2016-01-23,97,,NYK,W 97-84,240,28,82,.341,19,51,.373,9,31,.290,32,37,.865,97,29,77,.377,22,53,.415,7,24,.292,19,32,.594,84
880,SAC,2016-01-13,97,,NOP,L 97-109,240,41,84,.488,35,61,.574,6,23,.261,9,14,.643,97,42,100,.420,26,67,.388,16,33,.485,9,11,.818,109
881,LAC,2016-01-09,97,,CHO,W 97-83,240,40,91,.440,32,60,.533,8,31,.258,9,10,.900,97,31,84,.369,24,61,.393,7,23,.304,14,19,.737,83
882,LAL,2016-01-03,97,,PHO,W 97-77,240,38,84,.452,30,62,.484,8,22,.364,13,17,.765,97,32,89,.360,26,62,.419,6,27,.222,7,9,.778,77
883,BOS,2016-01-02,97,,BRK,L 97-100,240,34,88,.386,27,56,.482,7,32,.219,22,28,.786,97,38,93,.409,35,75,.467,3,18,.167,21,22,.955,100
884,PHO,2015-12-28,97,,CLE,L 97-101,240,36,79,.456,25,54,.463,11,25,.440,14,20,.700,97,33,71,.465,16,30,.533,17,41,.415,18,25,.720,101
885,UTA,2015-12-18,97,,DEN,W 97-88,240,34,73,.466,24,48,.500,10,25,.400,19,25,.760,97,31,79,.392,25,51,.490,6,28,.214,20,25,.800,88
886,PHI,2015-12-18,97,,NYK,L 97-107,240,37,77,.481,31,53,.585,6,24,.250,17,30,.567,97,40,85,.471,34,66,.515,6,19,.316,21,28,.750,107
887,DAL,2015-12-18,97,,MEM,W 97-88,240,34,78,.436,24,49,.490,10,29,.345,19,21,.905,97,30,80,.375,24,63,.381,6,17,.353,22,24,.917,88
888,TOR,2015-12-09,97,,SAS,W 97-94,240,37,64,.578,34,54,.630,3,10,.300,20,22,.909,97,34,76,.447,27,51,.529,7,25,.280,19,24,.792,94
889,NYK,2015-12-07,97,,DAL,L 97-104,240,40,84,.476,31,59,.525,9,25,.360,8,9,.889,97,37,82,.451,24,51,.471,13,31,.419,17,20,.850,104
890,SAC,2015-12-03,97,,BOS,L 97-114,240,29,77,.377,22,56,.393,7,21,.333,32,41,.780,97,40,84,.476,26,51,.510,14,33,.424,20,24,.833,114
891,MIA,2015-12-03,97,,OKC,W 97-95,240,40,81,.494,37,68,.544,3,13,.231,14,24,.583,97,35,79,.443,31,63,.492,4,16,.250,21,24,.875,95
892,PHO,2015-11-18,97,,CHI,L 97-103,240,37,91,.407,29,64,.453,8,27,.296,15,21,.714,97,41,83,.494,32,64,.500,9,19,.474,12,14,.857,103
893,LAL,2015-11-15,97,,DET,W 97-85,240,31,75,.413,25,56,.446,6,19,.316,29,39,.744,97,35,96,.365,28,69,.406,7,27,.259,8,15,.533,85
894,IND,2015-11-09,97,,ORL,W 97-84,240,34,77,.442,23,52,.442,11,25,.440,18,22,.818,97,31,78,.397,21,45,.467,10,33,.303,12,17,.706,84
895,PHI,2015-11-07,97,,ORL,L 97-105,240,36,80,.450,25,47,.532,11,33,.333,14,26,.538,97,39,83,.470,33,70,.471,6,13,.462,21,24,.875,105
896,ATL,2015-10-30,97,,CHO,W 97-94,240,36,83,.434,28,60,.467,8,23,.348,17,22,.773,97,36,88,.409,24,58,.414,12,30,.400,10,13,.769,94
897,MIL,2015-10-28,97,,NYK,L 97-122,240,30,86,.349,21,68,.309,9,18,.500,28,31,.903,97,42,93,.452,33,70,.471,9,23,.391,29,35,.829,122
898,CHI,2015-10-27,97,,CLE,W 97-95,240,37,87,.425,30,68,.441,7,19,.368,16,23,.696,97,38,94,.404,29,65,.446,9,29,.310,10,17,.588,95
899,BRK,2016-04-13,96,,TOR,L 96-103,240,39,89,.438,29,63,.460,10,26,.385,8,12,.667,96,41,93,.441,28,56,.500,13,37,.351,8,15,.533,103
900,TOR,2016-04-05,96,,CHO,W 96-90,240,34,78,.436,28,55,.509,6,23,.261,22,31,.710,96,32,88,.364,21,53,.396,11,35,.314,15,21,.714,90
901,UTA,2016-03-30,96,,GSW,L 96-103 (OT),265,37,92,.402,28,60,.467,9,32,.281,13,29,.448,96,39,89,.438,27,54,.500,12,35,.343,13,18,.722,103
902,IND,2016-03-29,96,,CHI,L 96-98,240,39,90,.433,36,71,.507,3,19,.158,15,17,.882,96,37,87,.425,27,61,.443,10,26,.385,14,16,.875,98
903,LAC,2016-03-24,96,,POR,W 96-94,240,37,82,.451,33,63,.524,4,19,.211,18,28,.643,96,32,80,.400,26,56,.464,6,24,.250,24,32,.750,94
904,MIL,2016-03-17,96,,MEM,W 96-86,240,37,75,.493,32,56,.571,5,19,.263,17,25,.680,96,34,92,.370,31,79,.392,3,13,.231,15,17,.882,86
905,CHO,2016-03-14,96,,DAL,L 96-107,240,32,76,.421,22,46,.478,10,30,.333,22,34,.647,96,42,87,.483,33,57,.579,9,30,.300,14,18,.778,107
906,CHI,2016-03-11,96,,MIA,L 96-118,240,38,81,.469,30,60,.500,8,21,.381,12,15,.800,96,47,91,.516,37,73,.507,10,18,.556,14,20,.700,118
907,OKC,2016-03-11,96,,MIN,L 96-99,240,36,84,.429,30,57,.526,6,27,.222,18,25,.720,96,37,86,.430,30,65,.462,7,21,.333,18,21,.857,99
908,DAL,2016-03-09,96,,DET,L 96-102,240,39,86,.453,30,56,.536,9,30,.300,9,11,.818,96,38,85,.447,29,58,.500,9,27,.333,17,30,.567,102
909,MIL,2016-03-06,96,,OKC,L 96-104,240,34,90,.378,31,71,.437,3,19,.158,25,30,.833,96,32,76,.421,25,51,.490,7,25,.280,33,43,.767,104
910,DEN,2016-02-29,96,,MEM,L 96-103,240,40,75,.533,32,50,.640,8,25,.320,8,10,.800,96,36,75,.480,33,55,.600,3,20,.150,28,36,.778,103
911,UTA,2016-02-27,96,,BRK,L 96-98,240,37,89,.416,32,69,.464,5,20,.250,17,25,.680,96,40,84,.476,33,69,.478,7,15,.467,11,17,.647,98
912,BRK,2016-02-21,96,,CHO,L 96-104,240,35,81,.432,30,59,.508,5,22,.227,21,24,.875,96,40,79,.506,30,52,.577,10,27,.370,14,15,.933,104
913,ORL,2016-02-10,96,,SAS,L 96-98,240,37,91,.407,29,71,.408,8,20,.400,14,16,.875,96,38,89,.427,30,69,.435,8,20,.400,14,15,.933,98
914,NYK,2016-02-07,96,,DEN,L 96-101,240,37,84,.440,29,62,.468,8,22,.364,14,20,.700,96,37,86,.430,32,65,.492,5,21,.238,22,28,.786,101
915,ORL,2016-02-07,96,,ATL,W 96-94,240,39,85,.459,32,60,.533,7,25,.280,11,12,.917,96,35,91,.385,22,63,.349,13,28,.464,11,15,.733,94
916,NOP,2016-02-04,96,,LAL,L 96-99,240,39,85,.459,35,65,.538,4,20,.200,14,26,.538,96,39,81,.481,32,61,.525,7,20,.350,14,20,.700,99
917,POR,2016-01-31,96,,MIN,W 96-93,240,32,76,.421,26,49,.531,6,27,.222,26,30,.867,96,35,80,.438,31,64,.484,4,16,.250,19,28,.679,93
918,MIN,2016-01-12,96,,OKC,L 96-101,240,36,81,.444,29,63,.460,7,18,.389,17,23,.739,96,39,84,.464,30,62,.484,9,22,.409,14,18,.778,101
919,MIL,2016-01-08,96,,DAL,W 96-95,240,37,80,.463,33,71,.465,4,9,.444,18,29,.621,96,35,84,.417,21,40,.525,14,44,.318,11,16,.688,95
920,BRK,2015-12-26,96,,WAS,L 96-111,240,43,89,.483,38,72,.528,5,17,.294,5,16,.313,96,42,84,.500,30,57,.526,12,27,.444,15,22,.682,111
921,OKC,2015-12-25,96,,CHI,L 96-105,240,37,96,.385,31,72,.431,6,24,.250,16,23,.696,96,40,92,.435,33,74,.446,7,18,.389,18,20,.900,105
922,PHO,2015-12-23,96,,DEN,L 96-104,240,36,87,.414,23,62,.371,13,25,.520,11,17,.647,96,42,91,.462,28,56,.500,14,35,.400,6,13,.462,104
923,MEM,2015-12-19,96,,IND,W 96-84,240,37,83,.446,32,64,.500,5,19,.263,17,21,.810,96,30,77,.390,25,49,.510,5,28,.179,19,25,.760,84
924,TOR,2015-12-13,96,,PHI,W 96-76,240,32,78,.410,25,56,.446,7,22,.318,25,34,.735,96,28,84,.333,18,56,.321,10,28,.357,10,14,.714,76
925,PHO,2015-12-11,96,,POR,L 96-106,240,36,83,.434,23,48,.479,13,35,.371,11,18,.611,96,45,96,.469,33,62,.532,12,34,.353,4,7,.571,106
926,IND,2015-12-11,96,,MIA,W 96-83,240,36,86,.419,30,58,.517,6,28,.214,18,20,.900,96,35,81,.432,30,61,.492,5,20,.250,8,13,.615,83
927,CHI,2015-12-05,96,,CHO,L 96-102,240,37,89,.416,28,64,.438,9,25,.360,13,19,.684,96,37,89,.416,27,55,.491,10,34,.294,18,25,.720,102
928,DAL,2015-12-04,96,,HOU,L 96-100,240,37,81,.457,29,52,.558,8,29,.276,14,20,.700,96,39,84,.464,27,58,.466,12,26,.462,10,18,.556,100
929,MIA,2015-11-21,96,,PHI,W 96-91,240,30,69,.435,25,51,.490,5,18,.278,31,45,.689,96,31,82,.378,21,51,.412,10,31,.323,19,24,.792,91
930,MEM,2015-11-20,96,,HOU,W 96-84,240,36,85,.424,28,61,.459,8,24,.333,16,19,.842,96,28,74,.378,22,45,.489,6,29,.207,22,37,.595,84
931,CHI,2015-11-16,96,,IND,W 96-95,240,35,86,.407,29,71,.408,6,15,.400,20,32,.625,96,35,87,.402,26,66,.394,9,21,.429,16,24,.667,95
932,ATL,2015-11-15,96,,UTA,L 96-97,240,37,76,.487,29,54,.537,8,22,.364,14,17,.824,96,39,76,.513,32,55,.582,7,21,.333,12,17,.706,97
933,MIA,2015-11-08,96,,TOR,W 96-76,240,35,83,.422,27,63,.429,8,20,.400,18,25,.720,96,28,71,.394,25,52,.481,3,19,.158,17,22,.773,76
934,CLE,2015-11-04,96,,NYK,W 96-86,240,33,83,.398,26,56,.464,7,27,.259,23,32,.719,96,33,84,.393,25,60,.417,8,24,.333,12,15,.800,86
935,BRK,2015-11-02,96,,MIL,L 96-103,240,36,79,.456,30,60,.500,6,19,.316,18,22,.818,96,38,73,.521,29,50,.580,9,23,.391,18,26,.692,103
936,ATL,2016-04-07,95,,TOR,W 95-87,240,33,76,.434,21,44,.477,12,32,.375,17,21,.810,95,32,84,.381,24,63,.381,8,21,.381,15,20,.750,87
937,MEM,2016-04-01,95,,TOR,L 95-99,240,37,91,.407,30,72,.417,7,19,.368,14,17,.824,95,30,71,.423,18,43,.419,12,28,.429,27,29,.931,99
938,DET,2016-03-26,95,,ATL,L 95-112,240,34,88,.386,27,59,.458,7,29,.241,20,28,.714,95,43,95,.453,30,61,.492,13,34,.382,13,14,.929,112
939,ATL,2016-03-12,95,,MEM,W 95-83,240,36,84,.429,25,50,.500,11,34,.324,12,17,.706,95,33,95,.347,27,72,.375,6,23,.261,11,14,.786,83
940,PHI,2016-03-11,95,,BRK,W 95-89,240,38,84,.452,29,56,.518,9,28,.321,10,15,.667,95,33,87,.379,28,70,.400,5,17,.294,18,22,.818,89
941,CHI,2016-02-27,95,,POR,L 95-103,240,39,94,.415,32,72,.444,7,22,.318,10,12,.833,95,38,87,.437,33,66,.500,5,21,.238,22,27,.815,103
942,IND,2016-02-26,95,,CHO,L 95-96,240,35,85,.412,31,66,.470,4,19,.211,21,24,.875,95,36,83,.434,25,55,.455,11,28,.393,13,19,.684,96
943,LAL,2016-02-26,95,,MEM,L 95-112,240,32,78,.410,27,55,.491,5,23,.217,26,39,.667,95,43,85,.506,30,53,.566,13,32,.406,13,15,.867,112
944,NYK,2016-02-22,95,,TOR,L 95-122,240,37,84,.440,31,64,.484,6,20,.300,15,23,.652,95,46,87,.529,35,62,.565,11,25,.440,19,25,.760,122
945,MIN,2016-02-20,95,,NYK,L 95-103,240,36,84,.429,31,72,.431,5,12,.417,18,25,.720,95,42,83,.506,37,66,.561,5,17,.294,14,16,.875,103
946,MIL,2016-02-19,95,,CHO,L 95-98,240,36,81,.444,29,62,.468,7,19,.368,16,21,.762,95,37,86,.430,28,55,.509,9,31,.290,15,18,.833,98
947,IND,2016-02-10,95,,CHO,L 95-117,240,40,92,.435,36,74,.486,4,18,.222,11,15,.733,95,45,87,.517,33,59,.559,12,28,.429,15,19,.789,117
948,CHO,2016-02-05,95,,MIA,L 95-98,240,36,81,.444,26,55,.473,10,26,.385,13,15,.867,95,43,94,.457,43,85,.506,0,9,.000,12,18,.667,98
949,NOP,2016-02-01,95,,MEM,L 95-110,240,36,88,.409,26,62,.419,10,26,.385,13,21,.619,95,43,71,.606,34,55,.618,9,16,.563,15,18,.833,110
950,NYK,2016-01-31,95,,GSW,L 95-116,240,33,90,.367,27,72,.375,6,18,.333,23,26,.885,95,42,73,.575,26,44,.591,16,29,.552,16,23,.696,116
951,LAL,2016-01-22,95,,SAS,L 95-108,240,38,84,.452,32,68,.471,6,16,.375,13,18,.722,95,43,85,.506,32,64,.500,11,21,.524,11,13,.846,108
952,LAL,2016-01-17,95,,HOU,L 95-112,240,37,82,.451,31,63,.492,6,19,.316,15,19,.789,95,44,91,.484,38,70,.543,6,21,.286,18,24,.750,112
953,DEN,2016-01-15,95,,MIA,L 95-98,240,32,78,.410,26,60,.433,6,18,.333,25,26,.962,95,40,81,.494,36,69,.522,4,12,.333,14,19,.737,98
954,LAL,2016-01-12,95,,NOP,W 95-91,240,32,87,.368,26,58,.448,6,29,.207,25,32,.781,95,38,91,.418,32,68,.471,6,23,.261,9,14,.643,91
955,DEN,2016-01-10,95,,CHO,W 95-92,240,32,77,.416,20,50,.400,12,27,.444,19,23,.826,95,30,83,.361,18,47,.383,12,36,.333,20,24,.833,92
956,PHI,2016-01-09,95,,TOR,L 95-108,240,39,80,.488,28,63,.444,11,17,.647,6,14,.429,95,41,75,.547,36,58,.621,5,17,.294,21,27,.778,108
957,PHO,2016-01-08,95,,MIA,L 95-103,240,40,92,.435,34,68,.500,6,24,.250,9,13,.692,95,36,73,.493,29,55,.527,7,18,.389,24,30,.800,103
958,UTA,2015-12-28,95,,PHI,W 95-91,240,28,84,.333,21,58,.362,7,26,.269,32,36,.889,95,36,86,.419,31,65,.477,5,21,.238,14,19,.737,91
959,PHO,2015-12-20,95,,MIL,L 95-101,240,33,74,.446,25,56,.446,8,18,.444,21,24,.875,95,41,79,.519,36,63,.571,5,16,.313,14,24,.583,101
960,PHI,2015-12-11,95,,DET,L 95-107,240,36,80,.450,30,62,.484,6,18,.333,17,24,.708,95,43,93,.462,33,66,.500,10,27,.370,11,16,.688,107
961,MIL,2015-12-09,95,,LAC,L 95-109,240,42,90,.467,40,80,.500,2,10,.200,9,12,.750,95,38,81,.469,26,53,.491,12,28,.429,21,36,.583,109
962,DAL,2015-12-09,95,,ATL,L 95-98,240,36,100,.360,29,69,.420,7,31,.226,16,19,.842,95,39,81,.481,33,61,.541,6,20,.300,14,18,.778,98
963,MEM,2015-12-06,95,,PHO,W 95-93,240,36,90,.400,31,75,.413,5,15,.333,18,24,.750,95,36,82,.439,27,51,.529,9,31,.290,12,17,.706,93
964,SAS,2015-12-02,95,,MIL,W 95-70,240,37,90,.411,30,69,.435,7,21,.333,14,20,.700,95,26,78,.333,23,64,.359,3,14,.214,15,18,.833,70
965,MIA,2015-11-30,95,,BOS,L 95-105,240,36,75,.480,31,58,.534,5,17,.294,18,24,.750,95,38,80,.475,30,60,.500,8,20,.400,21,25,.840,105
966,MIA,2015-11-23,95,,NYK,W 95-78,240,31,81,.383,26,62,.419,5,19,.263,28,36,.778,95,28,87,.322,24,63,.381,4,24,.167,18,21,.857,78
967,DET,2015-11-21,95,,WAS,L 95-97,240,36,79,.456,28,53,.528,8,26,.308,15,21,.714,95,38,78,.487,31,59,.525,7,19,.368,14,20,.700,97
968,HOU,2015-11-16,95,,BOS,L 95-111,240,36,85,.424,25,53,.472,11,32,.344,12,23,.522,95,44,93,.473,33,57,.579,11,36,.306,12,17,.706,111
969,NYK,2015-11-15,95,,NOP,W 95-87,240,38,88,.432,34,70,.486,4,18,.222,15,19,.789,95,32,71,.451,26,50,.520,6,21,.286,17,19,.895,87
970,CHO,2015-11-11,95,,NYK,W 95-93,240,35,84,.417,27,61,.443,8,23,.348,17,28,.607,95,42,86,.488,38,65,.585,4,21,.190,5,7,.714,93
971,MIN,2015-11-10,95,,CHO,L 95-104,240,36,80,.450,27,61,.443,9,19,.474,14,19,.737,95,38,78,.487,30,52,.577,8,26,.308,20,27,.741,104
972,PHO,2015-10-28,95,,DAL,L 95-111,240,34,87,.391,28,63,.444,6,24,.250,21,33,.636,95,40,85,.471,30,64,.469,10,21,.476,21,31,.677,111
973,IND,2016-03-31,94,,ORL,L 94-114,240,36,86,.419,29,67,.433,7,19,.368,15,21,.714,94,48,90,.533,43,74,.581,5,16,.313,13,18,.722,114
974,IND,2016-03-17,94,,TOR,L 94-101 (OT),265,35,91,.385,27,63,.429,8,28,.286,16,23,.696,94,32,88,.364,25,66,.379,7,22,.318,30,38,.789,101
975,PHI,2016-03-17,94,,WAS,L 94-99,240,35,91,.385,29,58,.500,6,33,.182,18,26,.692,94,40,90,.444,34,63,.540,6,27,.222,13,19,.684,99
976,UTA,2016-03-14,94,,CLE,W 94-85,240,35,71,.493,23,44,.523,12,27,.444,12,14,.857,94,35,88,.398,25,45,.556,10,43,.233,5,8,.625,85
977,NOP,2016-03-05,94,,UTA,L 94-106,240,38,92,.413,29,73,.397,9,19,.474,9,11,.818,94,37,78,.474,31,58,.534,6,20,.300,26,27,.963,106
978,MEM,2016-03-04,94,,UTA,W 94-88,240,37,81,.457,33,63,.524,4,18,.222,16,19,.842,94,32,75,.427,27,56,.482,5,19,.263,19,29,.655,88
979,HOU,2016-02-27,94,,SAS,L 94-104,240,35,84,.417,27,59,.458,8,25,.320,16,22,.727,94,37,76,.487,29,57,.509,8,19,.421,22,28,.786,104
980,PHI,2016-02-26,94,,WAS,L 94-103,240,35,82,.427,27,57,.474,8,25,.320,16,21,.762,94,40,94,.426,33,71,.465,7,23,.304,16,17,.941,103
981,CHI,2016-01-20,94,,GSW,L 94-125,240,37,100,.370,36,80,.450,1,20,.050,19,24,.792,94,50,95,.526,38,63,.603,12,32,.375,13,20,.650,125
982,PHO,2016-01-19,94,,IND,L 94-97,240,28,81,.346,17,46,.370,11,35,.314,27,29,.931,94,34,83,.410,30,63,.476,4,20,.200,25,34,.735,97
983,BOS,2016-01-06,94,,DET,L 94-99,240,34,91,.374,28,63,.444,6,28,.214,20,27,.741,94,33,74,.446,23,47,.489,10,27,.370,23,36,.639,99
984,BRK,2016-01-04,94,,BOS,L 94-103,240,32,85,.376,26,57,.456,6,28,.214,24,27,.889,94,41,92,.446,35,71,.493,6,21,.286,15,19,.789,103
985,IND,2016-01-02,94,,DET,W 94-82,240,33,73,.452,26,55,.473,7,18,.389,21,29,.724,94,33,93,.355,30,73,.411,3,20,.150,13,23,.565,82
986,TOR,2015-12-30,94,,WAS,W 94-91,240,28,82,.341,22,58,.379,6,24,.250,32,39,.821,94,35,87,.402,27,65,.415,8,22,.364,13,17,.765,91
987,MIN,2015-12-30,94,,UTA,W 94-80,240,36,77,.468,31,67,.463,5,10,.500,17,27,.630,94,28,80,.350,18,41,.439,10,39,.256,14,20,.700,80
988,SAC,2015-12-27,94,,POR,L 94-98,240,30,76,.395,21,52,.404,9,24,.375,25,31,.806,94,38,92,.413,28,59,.475,10,33,.303,12,16,.750,98
989,MIA,2015-12-25,94,,NOP,W 94-88 (OT),265,35,88,.398,29,62,.468,6,26,.231,18,27,.667,94,36,90,.400,30,70,.429,6,20,.300,10,11,.909,88
990,TOR,2015-12-20,94,,SAC,L 94-104,240,35,94,.372,27,65,.415,8,29,.276,16,17,.941,94,40,76,.526,31,55,.564,9,21,.429,15,24,.625,104
991,MIA,2015-12-18,94,,TOR,L 94-108,240,35,74,.473,26,49,.531,9,25,.360,15,17,.882,94,41,80,.513,33,59,.559,8,21,.381,18,22,.818,108
992,UTA,2015-12-16,94,,NOP,L 94-104,240,32,67,.478,25,47,.532,7,20,.350,23,29,.793,94,34,73,.466,24,52,.462,10,21,.476,26,28,.929,104
993,UTA,2015-12-03,94,,ORL,L 94-103,240,31,72,.431,17,39,.436,14,33,.424,18,24,.750,94,40,89,.449,32,66,.485,8,23,.348,15,15,1.000,103
994,BRK,2015-12-01,94,,PHO,W 94-91,240,41,84,.488,37,71,.521,4,13,.308,8,12,.667,94,33,75,.440,23,47,.489,10,28,.357,15,22,.682,91
995,DEN,2015-11-24,94,,LAC,L 94-111,240,31,78,.397,23,53,.434,8,25,.320,24,29,.828,94,37,79,.468,29,59,.492,8,20,.400,29,47,.617,111
996,LAC,2015-11-09,94,,MEM,W 94-92,240,28,68,.412,23,49,.469,5,19,.263,33,37,.892,94,35,80,.438,33,69,.478,2,11,.182,20,29,.690,92
997,SAC,2015-11-07,94,,GSW,L 94-103,240,38,87,.437,32,68,.471,6,19,.316,12,16,.750,94,38,92,.413,30,53,.566,8,39,.205,19,22,.864,103
998,MIL,2015-11-07,94,,BRK,W 94-86,240,37,82,.451,29,62,.468,8,20,.400,12,16,.750,94,34,82,.415,31,73,.425,3,9,.333,15,19,.789,86
999,DAL,2015-11-05,94,,CHO,L 94-108,240,32,82,.390,26,53,.491,6,29,.207,24,27,.889,94,44,89,.494,38,62,.613,6,27,.222,14,17,.824,108
1000,NOP,2015-11-03,94,,ORL,L 94-103,240,32,90,.356,20,54,.370,12,36,.333,18,25,.720,94,42,90,.467,35,72,.486,7,18,.389,12,12,1.000,103
1001,ATL,2015-10-27,94,,DET,L 94-106,240,37,82,.451,29,55,.527,8,27,.296,12,15,.800,94,37,96,.385,25,67,.373,12,29,.414,20,26,.769,106
1002,DET,2016-04-12,93,,MIA,L 93-99,240,34,84,.405,29,66,.439,5,18,.278,20,30,.667,93,38,78,.487,31,58,.534,7,20,.350,16,22,.727,99
1003,NYK,2016-03-26,93,,CLE,L 93-107,240,33,79,.418,25,56,.446,8,23,.348,19,28,.679,93,37,83,.446,23,49,.469,14,34,.412,19,25,.760,107
1004,CHO,2016-03-19,93,,DEN,L 93-101,240,35,83,.422,26,51,.510,9,32,.281,14,20,.700,93,38,87,.437,29,69,.420,9,18,.500,16,23,.696,101
1005,SAS,2016-03-12,93,,OKC,W 93-85,240,34,85,.400,30,61,.492,4,24,.167,21,25,.840,93,31,81,.383,29,63,.460,2,18,.111,21,25,.840,85
1006,MIA,2016-02-07,93,,LAC,L 93-100,240,33,83,.398,26,66,.394,7,17,.412,20,29,.690,93,37,81,.457,28,56,.500,9,25,.360,17,33,.515,100
1007,ORL,2016-02-05,93,,LAC,L 93-107,240,34,81,.420,30,61,.492,4,20,.200,21,28,.750,93,40,74,.541,32,47,.681,8,27,.296,19,23,.826,107
1008,LAL,2016-01-20,93,,SAC,L 93-112,240,32,90,.356,28,65,.431,4,25,.160,25,31,.806,93,43,89,.483,37,69,.536,6,20,.300,20,28,.714,112
1009,LAL,2016-01-01,93,,PHI,W 93-84,240,33,87,.379,28,71,.394,5,16,.313,22,29,.759,93,31,84,.369,27,60,.450,4,24,.167,18,25,.720,84
1010,IND,2015-12-28,93,,ATL,W 93-87,240,38,87,.437,31,61,.508,7,26,.269,10,18,.556,93,31,74,.419,25,49,.510,6,25,.240,19,25,.760,87
1011,DET,2015-12-26,93,,BOS,L 93-99,240,35,91,.385,29,66,.439,6,25,.240,17,25,.680,93,39,84,.464,35,61,.574,4,23,.174,17,23,.739,99
1012,CHO,2015-12-12,93,,BOS,L 93-98,240,36,88,.409,25,53,.472,11,35,.314,10,10,1.000,93,40,96,.417,31,71,.437,9,25,.360,9,10,.900,98
1013,NOP,2015-12-07,93,,BOS,L 93-111,240,37,90,.411,33,77,.429,4,13,.308,15,18,.833,93,40,81,.494,28,53,.528,12,28,.429,19,24,.792,111
1014,MIN,2015-12-01,93,,ORL,L 93-96,240,29,77,.377,25,58,.431,4,19,.211,31,38,.816,93,38,86,.442,33,69,.478,5,17,.294,15,20,.750,96
1015,HOU,2015-11-25,93,,MEM,L 93-102,240,30,71,.423,20,37,.541,10,34,.294,23,27,.852,93,39,80,.488,36,64,.563,3,16,.188,21,23,.913,102
1016,LAL,2015-11-22,93,,POR,L 93-107,240,32,88,.364,26,70,.371,6,18,.333,23,27,.852,93,43,87,.494,35,62,.565,8,25,.320,13,17,.765,107
1017,UTA,2015-11-18,93,,TOR,W 93-89,240,35,72,.486,28,50,.560,7,22,.318,16,22,.727,93,34,80,.425,29,60,.483,5,20,.250,16,18,.889,89
1018,SAS,2015-11-16,93,,POR,W 93-80,240,38,89,.427,31,66,.470,7,23,.304,10,13,.769,93,31,75,.413,24,56,.429,7,19,.368,11,13,.846,80
1019,CHI,2015-11-07,93,,MIN,L 93-102 (OT),265,33,93,.355,22,61,.361,11,32,.344,16,23,.696,93,39,96,.406,32,80,.400,7,16,.438,17,27,.630,102
1020,LAL,2015-11-01,93,,DAL,L 93-103,240,31,85,.365,21,51,.412,10,34,.294,21,28,.750,93,40,87,.460,29,57,.509,11,30,.367,12,16,.750,103
1021,MIL,2016-04-13,92,,IND,L 92-97,240,37,87,.425,30,64,.469,7,23,.304,11,13,.846,92,39,90,.433,28,66,.424,11,24,.458,8,10,.800,97
1022,UTA,2016-04-11,92,,DAL,L 92-101,240,35,77,.455,26,44,.591,9,33,.273,13,18,.722,92,36,81,.444,25,49,.510,11,32,.344,18,22,.818,101
1023,IND,2016-03-24,92,,NOP,W 92-84,240,36,79,.456,29,59,.492,7,20,.350,13,15,.867,92,35,85,.412,31,69,.449,4,16,.250,10,14,.714,84
1024,DET,2016-03-21,92,,MIL,W 92-91,240,35,85,.412,26,52,.500,9,33,.273,13,17,.765,92,41,76,.539,36,67,.537,5,9,.556,4,7,.571,91
1025,CHI,2016-03-19,92,,UTA,W 92-85,240,39,80,.488,33,61,.541,6,19,.316,8,11,.727,92,35,86,.407,27,59,.458,8,27,.296,7,12,.583,85
1026,SAC,2016-02-24,92,,SAS,L 92-108,240,39,96,.406,33,78,.423,6,18,.333,8,15,.533,92,44,85,.518,36,66,.545,8,19,.421,12,15,.800,108
1027,ATL,2016-02-22,92,,GSW,L 92-102,240,36,86,.419,26,52,.500,10,34,.294,10,16,.625,92,39,89,.438,25,44,.568,14,45,.311,10,12,.833,102
1028,OKC,2016-02-21,92,,CLE,L 92-115,240,37,90,.411,32,69,.464,5,21,.238,13,19,.684,92,41,80,.513,31,57,.544,10,23,.435,23,27,.852,115
1029,DET,2016-02-10,92,,DEN,L 92-103,240,38,88,.432,28,61,.459,10,27,.370,6,7,.857,92,39,83,.470,33,64,.516,6,19,.316,19,24,.792,103
1030,PHI,2016-02-08,92,,LAC,L 92-98 (OT),265,34,90,.378,28,65,.431,6,25,.240,18,21,.857,92,35,95,.368,30,73,.411,5,22,.227,23,31,.742,98
1031,UTA,2016-01-25,92,,DET,L 92-95,240,34,85,.400,25,56,.446,9,29,.310,15,18,.833,92,34,75,.453,23,53,.434,11,22,.500,16,33,.485,95
1032,PHI,2016-01-24,92,,BOS,L 92-112,240,35,89,.393,27,63,.429,8,26,.308,14,20,.700,92,43,97,.443,32,72,.444,11,25,.440,15,19,.789,112
1033,CHO,2016-01-16,92,,MIL,L 92-105,240,33,87,.379,24,51,.471,9,36,.250,17,22,.773,92,39,72,.542,34,60,.567,5,12,.417,22,26,.846,105
1034,UTA,2016-01-02,92,,MEM,W 92-87 (OT),265,31,75,.413,22,48,.458,9,27,.333,21,28,.750,92,33,81,.407,26,63,.413,7,18,.389,14,26,.538,87
1035,MIA,2015-12-22,92,,DET,L 92-93,240,39,88,.443,35,70,.500,4,18,.222,10,12,.833,92,35,78,.449,20,48,.417,15,30,.500,8,14,.571,93
1036,DET,2015-12-09,92,,MEM,L 92-93,240,37,87,.425,29,58,.500,8,29,.276,10,15,.667,92,41,88,.466,37,73,.507,4,15,.267,7,13,.538,93
1037,CHI,2015-11-30,92,,SAS,W 92-89,240,37,86,.430,31,70,.443,6,16,.375,12,20,.600,92,37,90,.411,35,76,.461,2,14,.143,13,18,.722,89
1038,MIL,2015-11-30,92,,DEN,W 92-74,240,35,77,.455,29,59,.492,6,18,.333,16,22,.727,92,28,75,.373,22,56,.393,6,19,.316,12,16,.750,74
1039,MEM,2015-11-29,92,,PHI,W 92-84,240,34,81,.420,30,68,.441,4,13,.308,20,27,.741,92,30,77,.390,18,41,.439,12,36,.333,12,16,.750,84
1040,DAL,2015-11-28,92,,DEN,W 92-81,240,33,77,.429,26,51,.510,7,26,.269,19,27,.704,92,30,75,.400,22,50,.440,8,25,.320,13,17,.765,81
1041,SAS,2015-11-21,92,,MEM,W 92-82,240,34,72,.472,27,51,.529,7,21,.333,17,22,.773,92,32,74,.432,31,65,.477,1,9,.111,17,17,1.000,82
1042,SAS,2015-11-14,92,,PHI,W 92-83,240,33,85,.388,28,69,.406,5,16,.313,21,25,.840,92,33,82,.402,25,60,.417,8,22,.364,9,11,.818,83
1043,MIA,2015-11-12,92,,UTA,W 92-91,240,36,77,.468,32,64,.500,4,13,.308,16,25,.640,92,34,89,.382,30,72,.417,4,17,.235,19,25,.760,91
1044,NYK,2015-11-06,92,,MIL,L 92-99,240,33,81,.407,29,57,.509,4,24,.167,22,28,.786,92,35,81,.432,32,67,.478,3,14,.214,26,29,.897,99
1045,ORL,2015-11-06,92,,TOR,W 92-87,240,33,77,.429,24,52,.462,9,25,.360,17,22,.773,92,30,86,.349,25,63,.397,5,23,.217,22,29,.759,87
1046,PHO,2015-11-06,92,,DET,L 92-100,240,37,92,.402,27,62,.435,10,30,.333,8,13,.615,92,37,74,.500,29,52,.558,8,22,.364,18,36,.500,100
1047,UTA,2015-11-04,92,,POR,L 92-108,240,33,88,.375,28,64,.438,5,24,.208,21,33,.636,92,41,77,.532,30,52,.577,11,25,.440,15,32,.469,108
1048,MIA,2015-11-03,92,,ATL,L 92-98,240,38,86,.442,33,58,.569,5,28,.179,11,16,.688,92,37,90,.411,30,69,.435,7,21,.333,17,22,.773,98
1049,CHO,2015-11-01,92,,ATL,L 92-94,240,32,86,.372,18,49,.367,14,37,.378,14,15,.933,92,37,88,.420,30,59,.508,7,29,.241,13,14,.929,94
1050,CHI,2015-11-01,92,,ORL,W 92-87,240,33,87,.379,26,59,.441,7,28,.250,19,22,.864,92,35,90,.389,28,67,.418,7,23,.304,10,17,.588,87
1051,HOU,2015-10-30,92,,GSW,L 92-112,240,30,82,.366,25,59,.424,5,23,.217,27,36,.750,92,43,93,.462,34,67,.507,9,26,.346,17,25,.680,112
1052,DET,2015-10-28,92,,UTA,W 92-87,240,30,74,.405,23,55,.418,7,19,.368,25,34,.735,92,35,75,.467,33,63,.524,2,12,.167,15,21,.714,87
1053,DAL,2016-04-13,91,,SAS,L 91-96,240,31,77,.403,19,38,.500,12,39,.308,17,21,.810,91,35,74,.473,29,51,.569,6,23,.261,20,26,.769,96
1054,DAL,2016-03-30,91,,NYK,W 91-89,240,35,85,.412,27,60,.450,8,25,.320,13,17,.765,91,35,77,.455,32,60,.533,3,17,.176,16,18,.889,89
1055,NOP,2016-03-26,91,,TOR,L 91-115,240,37,85,.435,33,70,.471,4,15,.267,13,20,.650,91,39,73,.534,27,44,.614,12,29,.414,25,28,.893,115
1056,MIL,2016-03-26,91,,CHO,L 91-115,240,37,84,.440,33,69,.478,4,15,.267,13,15,.867,91,41,74,.554,25,45,.556,16,29,.552,17,21,.810,115
1057,BOS,2016-03-23,91,,TOR,W 91-79,240,35,80,.438,27,60,.450,8,20,.400,13,21,.619,91,31,89,.348,25,67,.373,6,22,.273,11,20,.550,79
1058,IND,2016-03-21,91,,PHI,W 91-75,240,35,81,.432,25,55,.455,10,26,.385,11,13,.846,91,31,80,.388,27,62,.435,4,18,.222,9,14,.643,75
1059,CHO,2016-03-21,91,,SAS,W 91-88,240,35,87,.402,27,68,.397,8,19,.421,13,19,.684,91,37,86,.430,33,69,.478,4,17,.235,10,13,.769,88
1060,MIN,2016-03-08,91,,SAS,L 91-116,240,36,79,.456,32,64,.500,4,15,.267,15,19,.789,91,47,85,.553,43,66,.652,4,19,.211,18,19,.947,116
1061,MIL,2016-02-27,91,,DET,L 91-102,240,38,78,.487,31,66,.470,7,12,.583,8,12,.667,91,37,88,.420,25,58,.431,12,30,.400,16,24,.667,102
1062,DAL,2016-01-31,91,,PHO,W 91-78,240,31,78,.397,23,49,.469,8,29,.276,21,23,.913,91,27,74,.365,22,51,.431,5,23,.217,19,24,.792,78
1063,DAL,2016-01-29,91,,BRK,W 91-79,240,37,80,.463,29,59,.492,8,21,.381,9,15,.600,91,28,78,.359,24,58,.414,4,20,.200,19,23,.826,79
1064,LAL,2016-01-28,91,,CHI,L 91-114,240,32,85,.376,23,60,.383,9,25,.360,18,23,.783,91,47,95,.495,41,78,.526,6,17,.353,14,16,.875,114
1065,WAS,2016-01-25,91,,BOS,L 91-116,240,32,75,.427,25,51,.490,7,24,.292,20,30,.667,91,44,90,.489,35,68,.515,9,22,.409,19,23,.826,116
1066,SAC,2016-01-21,91,,ATL,W 91-88,240,33,92,.359,26,68,.382,7,24,.292,18,24,.750,91,35,84,.417,27,51,.529,8,33,.242,10,15,.667,88
1067,MEM,2016-01-12,91,,HOU,L 91-107,240,33,72,.458,26,54,.481,7,18,.389,18,24,.750,91,33,77,.429,15,42,.357,18,35,.514,23,27,.852,107
1068,MEM,2016-01-08,91,,DEN,W 91-84,240,30,82,.366,22,64,.344,8,18,.444,23,30,.767,91,32,87,.368,28,68,.412,4,19,.211,16,19,.842,84
1069,NOP,2016-01-06,91,,DAL,L 91-100,240,34,92,.370,27,62,.435,7,30,.233,16,20,.800,91,37,87,.425,30,59,.508,7,28,.250,19,22,.864,100
1070,UTA,2016-01-04,91,,HOU,L 91-93,240,30,75,.400,18,46,.391,12,29,.414,19,25,.760,91,33,68,.485,22,42,.524,11,26,.423,16,21,.762,93
1071,WAS,2015-12-28,91,,LAC,L 91-108,240,34,87,.391,27,63,.429,7,24,.292,16,24,.667,91,41,78,.526,34,55,.618,7,23,.304,19,25,.760,108
1072,CLE,2015-12-23,91,,NYK,W 91-84,240,32,83,.386,27,61,.443,5,22,.227,22,25,.880,91,32,82,.390,27,66,.409,5,16,.313,15,16,.938,84
1073,LAC,2015-12-02,91,,IND,L 91-103,240,30,79,.380,24,52,.462,6,27,.222,25,39,.641,91,32,76,.421,25,56,.446,7,20,.350,32,39,.821,103
1074,SAC,2015-11-27,91,,MIN,L 91-101,240,37,86,.430,29,64,.453,8,22,.364,9,15,.600,91,37,77,.481,28,52,.538,9,25,.360,18,19,.947,101
1075,LAC,2015-11-25,91,,UTA,L 91-102,240,38,75,.507,34,63,.540,4,12,.333,11,17,.647,91,39,77,.506,33,64,.516,6,13,.462,18,25,.720,102
1076,ORL,2015-11-21,91,,SAC,L 91-97,240,38,92,.413,29,61,.475,9,31,.290,6,8,.750,91,31,81,.383,24,61,.393,7,20,.350,28,31,.903,97
1077,LAL,2015-11-20,91,,TOR,L 91-102,240,35,77,.455,27,52,.519,8,25,.320,13,17,.765,91,34,78,.436,19,45,.422,15,33,.455,19,24,.792,102
1078,MIA,2015-11-17,91,,MIN,L 91-103,240,36,79,.456,31,55,.564,5,24,.208,14,30,.467,91,36,97,.371,32,76,.421,4,21,.190,27,35,.771,103
1079,BOS,2015-11-11,91,,IND,L 91-102,240,32,77,.416,28,53,.528,4,24,.167,23,32,.719,91,38,79,.481,32,62,.516,6,17,.353,20,31,.645,102
1080,MIL,2015-11-04,91,,PHI,W 91-87,240,35,86,.407,27,63,.429,8,23,.348,13,17,.765,91,34,81,.420,28,53,.528,6,28,.214,13,15,.867,87
1081,DAL,2015-11-03,91,,TOR,L 91-102,240,33,86,.384,26,63,.413,7,23,.304,18,25,.720,91,37,82,.451,32,65,.492,5,17,.294,23,26,.885,102
1082,CHI,2016-04-02,90,,DET,L 90-94,240,34,88,.386,25,63,.397,9,25,.360,13,15,.867,90,32,76,.421,22,56,.393,10,20,.500,20,34,.588,94
1083,LAL,2016-03-18,90,,PHO,L 90-95,240,31,86,.360,25,63,.397,6,23,.261,22,26,.846,90,32,89,.360,24,59,.407,8,30,.267,23,26,.885,95
1084,LAC,2016-03-13,90,,CLE,L 90-114,240,32,79,.405,22,47,.468,10,32,.313,16,19,.842,90,41,84,.488,23,47,.489,18,37,.486,14,20,.700,114
1085,DAL,2016-03-07,90,,LAC,L 90-109,240,30,81,.370,26,56,.464,4,25,.160,26,32,.813,90,39,83,.470,27,51,.529,12,32,.375,19,29,.655,109
1086,CHI,2016-02-10,90,,ATL,L 90-113,240,38,86,.442,33,72,.458,5,14,.357,9,12,.750,90,43,90,.478,30,57,.526,13,33,.394,14,15,.933,113
1087,BRK,2016-02-10,90,,MEM,L 90-109,240,33,71,.465,22,49,.449,11,22,.500,13,19,.684,90,45,86,.523,36,66,.545,9,20,.450,10,12,.833,109
1088,DAL,2016-02-05,90,,SAS,L 90-116,240,33,73,.452,30,58,.517,3,15,.200,21,27,.778,90,41,80,.513,29,58,.500,12,22,.545,22,25,.880,116
1089,DAL,2016-02-03,90,,MIA,L 90-93,240,34,87,.391,26,67,.388,8,20,.400,14,19,.737,90,37,88,.420,35,73,.479,2,15,.133,17,23,.739,93
1090,LAL,2016-01-26,90,,DAL,L 90-92,240,30,74,.405,23,49,.469,7,25,.280,23,28,.821,90,33,76,.434,27,51,.529,6,25,.240,20,26,.769,92
1091,MIA,2016-01-06,90,,NYK,L 90-98,240,37,82,.451,35,65,.538,2,17,.118,14,15,.933,90,39,70,.557,36,62,.581,3,8,.375,17,18,.944,98
1092,CHO,2016-01-02,90,,OKC,L 90-109,240,29,84,.345,23,62,.371,6,22,.273,26,34,.765,90,35,79,.443,26,56,.464,9,23,.391,30,37,.811,109
1093,MIL,2015-12-26,90,,TOR,L 90-111,240,34,81,.420,28,67,.418,6,14,.429,16,18,.889,90,42,81,.519,29,52,.558,13,29,.448,14,19,.737,111
1094,PHI,2015-12-22,90,,MEM,L 90-104,240,31,66,.470,24,43,.558,7,23,.304,21,32,.656,90,40,85,.471,35,70,.500,5,15,.333,19,24,.792,104
1095,TOR,2015-12-11,90,,MIL,W 90-83,240,34,70,.486,27,50,.540,7,20,.350,15,23,.652,90,33,80,.413,29,69,.420,4,11,.364,13,16,.813,83
1096,UTA,2015-12-11,90,,OKC,L 90-94,240,33,78,.423,25,50,.500,8,28,.286,16,24,.667,90,37,79,.468,31,62,.500,6,17,.353,14,16,.875,94
1097,MIL,2015-12-07,90,,POR,W 90-88,240,30,73,.411,26,60,.433,4,13,.308,26,33,.788,90,33,85,.388,25,52,.481,8,33,.242,14,18,.778,88
1098,CLE,2015-11-28,90,,BRK,W 90-88,240,35,87,.402,26,60,.433,9,27,.333,11,17,.647,90,33,81,.407,29,64,.453,4,17,.235,18,24,.750,88
1099,CHO,2015-11-27,90,,CLE,L 90-95,240,33,80,.413,28,55,.509,5,25,.200,19,25,.760,90,34,81,.420,26,56,.464,8,25,.320,19,25,.760,95
1100,OKC,2015-11-20,90,,NYK,L 90-93,240,35,92,.380,32,63,.508,3,29,.103,17,23,.739,90,33,72,.458,21,52,.404,12,20,.600,15,23,.652,93
1101,BRK,2015-11-17,90,,ATL,W 90-88,240,37,84,.440,28,64,.438,9,20,.450,7,13,.538,90,33,76,.434,21,47,.447,12,29,.414,10,14,.714,88
1102,DAL,2015-11-13,90,,LAL,W 90-82,240,30,82,.366,23,55,.418,7,27,.259,23,29,.793,90,29,88,.330,20,61,.328,9,27,.333,15,18,.833,82
1103,IND,2015-11-06,90,,MIA,W 90-87,240,36,80,.450,31,65,.477,5,15,.333,13,24,.542,90,36,81,.444,30,61,.492,6,20,.300,9,13,.692,87
1104,POR,2015-10-31,90,,PHO,L 90-101,240,33,79,.418,25,49,.510,8,30,.267,16,28,.571,90,39,94,.415,28,62,.452,11,32,.344,12,16,.750,101
1105,NYK,2016-04-10,89,,TOR,L 89-93,240,32,89,.360,25,69,.362,7,20,.350,18,21,.857,89,37,78,.474,30,58,.517,7,20,.350,12,19,.632,93
1106,DET,2016-04-01,89,,DAL,L 89-98,240,31,81,.383,18,48,.375,13,33,.394,14,24,.583,89,39,85,.459,31,61,.508,8,24,.333,12,14,.857,98
1107,MIL,2016-03-15,89,,TOR,L 89-107,240,34,77,.442,32,64,.500,2,13,.154,19,26,.731,89,39,83,.470,25,53,.472,14,30,.467,15,17,.882,107
1108,DET,2016-02-08,89,,TOR,L 89-103,240,36,80,.450,28,52,.538,8,28,.286,9,17,.529,89,39,70,.557,28,50,.560,11,20,.550,14,17,.824,103
1109,IND,2016-02-08,89,,LAL,W 89-87,240,31,78,.397,27,51,.529,4,27,.148,23,33,.697,89,29,93,.312,21,58,.362,8,35,.229,21,26,.808,87
1110,PHO,2016-02-06,89,,UTA,L 89-98,240,30,80,.375,21,56,.375,9,24,.375,20,26,.769,89,34,78,.436,29,62,.468,5,16,.313,25,31,.806,98
1111,NYK,2016-02-02,89,,BOS,L 89-97,240,31,82,.378,25,62,.403,6,20,.300,21,28,.750,89,40,90,.444,37,71,.521,3,19,.158,14,17,.824,97
1112,IND,2016-01-26,89,,LAC,L 89-91,240,35,83,.422,30,67,.448,5,16,.313,14,24,.583,89,32,78,.410,17,41,.415,15,37,.405,12,24,.500,91
1113,PHO,2016-01-21,89,,SAS,L 89-117,240,32,81,.395,26,63,.413,6,18,.333,19,23,.826,89,42,86,.488,33,72,.458,9,14,.643,24,28,.857,117
1114,NOP,2015-12-31,89,,LAC,L 89-95,240,36,82,.439,29,57,.509,7,25,.280,10,15,.667,89,35,90,.389,25,56,.446,10,34,.294,15,19,.789,95
1115,GSW,2015-12-25,89,,CLE,W 89-83,240,32,78,.410,27,60,.450,5,18,.278,20,27,.741,89,30,95,.316,25,65,.385,5,30,.167,18,25,.720,83
1116,CHO,2015-12-23,89,,BOS,L 89-102,240,29,81,.358,21,53,.396,8,28,.286,23,32,.719,89,36,85,.424,29,56,.518,7,29,.241,23,26,.885,102
1117,UTA,2015-11-23,89,,OKC,L 89-111,240,28,73,.384,23,54,.426,5,19,.263,28,40,.700,89,42,77,.545,31,50,.620,11,27,.407,16,18,.889,111
1118,UTA,2015-11-07,89,,MEM,W 89-79,240,31,74,.419,19,47,.404,12,27,.444,15,18,.833,89,30,91,.330,24,72,.333,6,19,.316,13,14,.929,79
1119,SAC,2015-11-03,89,,MEM,L 89-103,240,29,74,.392,22,54,.407,7,20,.350,24,40,.600,89,40,83,.482,37,63,.587,3,20,.150,20,25,.800,103
1120,DAL,2016-04-06,88,,HOU,W 88-86,240,33,80,.413,23,47,.489,10,33,.303,12,14,.857,88,34,78,.436,28,58,.483,6,20,.300,12,18,.667,86
1121,DET,2016-03-29,88,,OKC,W 88-82,240,33,87,.379,29,68,.426,4,19,.211,18,20,.900,88,31,82,.378,25,61,.410,6,21,.286,14,22,.636,82
1122,DEN,2016-03-28,88,,DAL,L 88-97,240,31,70,.443,22,46,.478,9,24,.375,17,19,.895,88,36,88,.409,25,56,.446,11,32,.344,14,15,.933,97
1123,LAL,2016-03-27,88,,WAS,L 88-101,240,33,87,.379,26,59,.441,7,28,.250,15,17,.882,88,39,72,.542,32,54,.593,7,18,.389,16,29,.552,101
1124,CLE,2016-02-22,88,,DET,L 88-96,240,34,79,.430,26,53,.491,8,26,.308,12,13,.923,88,37,80,.463,29,55,.527,8,25,.320,14,21,.667,96
1125,NYK,2016-01-22,88,,LAC,L 88-116,240,33,85,.388,29,67,.433,4,18,.222,18,20,.900,88,43,76,.566,30,53,.566,13,23,.565,17,24,.708,116
1126,WAS,2016-01-08,88,,TOR,L 88-97,240,33,84,.393,25,59,.424,8,25,.320,14,15,.933,88,34,75,.453,29,61,.475,5,14,.357,24,26,.923,97
1127,LAL,2016-01-05,88,,GSW,L 88-109,240,29,91,.319,24,70,.343,5,21,.238,25,30,.833,88,40,86,.465,27,55,.491,13,31,.419,16,21,.762,109
1128,MIN,2015-12-26,88,,IND,L 88-102,240,35,75,.467,31,63,.492,4,12,.333,14,18,.778,88,40,80,.500,31,54,.574,9,26,.346,13,14,.929,102
1129,HOU,2015-12-25,88,,SAS,W 88-84,240,32,74,.432,25,59,.424,7,15,.467,17,26,.654,88,36,88,.409,31,68,.456,5,20,.250,7,8,.875,84
1130,ATL,2015-12-14,88,,MIA,L 88-100,240,33,84,.393,25,51,.490,8,33,.242,14,15,.933,88,40,89,.449,33,73,.452,7,16,.438,13,15,.867,100
1131,MEM,2015-12-08,88,,OKC,L 88-125,240,33,81,.407,30,67,.448,3,14,.214,19,22,.864,88,47,84,.560,34,58,.586,13,26,.500,18,23,.783,125
1132,SAS,2015-11-25,88,,DAL,W 88-83,240,33,81,.407,25,53,.472,8,28,.286,14,19,.737,88,34,83,.410,28,61,.459,6,22,.273,9,12,.750,83
1133,POR,2015-11-24,88,,CHI,L 88-93,240,31,88,.352,25,66,.379,6,22,.273,20,27,.741,88,33,86,.384,26,68,.382,7,18,.389,20,23,.870,93
1134,PHI,2015-11-09,88,,CHI,L 88-111,240,35,100,.350,30,75,.400,5,25,.200,13,23,.565,88,41,96,.427,31,71,.437,10,25,.400,19,23,.826,111
1135,SAC,2015-11-09,88,,SAS,L 88-106,240,34,84,.405,27,65,.415,7,19,.368,13,19,.684,88,46,87,.529,40,64,.625,6,23,.261,8,11,.727,106
1136,BRK,2016-04-03,87,,NOP,L 87-106,240,33,85,.388,25,62,.403,8,23,.348,13,21,.619,87,42,76,.553,34,54,.630,8,22,.364,14,23,.609,106
1137,NYK,2016-04-03,87,,IND,L 87-92,240,33,96,.344,26,71,.366,7,25,.280,14,20,.700,87,34,81,.420,27,59,.458,7,22,.318,17,20,.850,92
1138,MEM,2016-03-28,87,,SAS,L 87-101,240,33,83,.398,27,64,.422,6,19,.316,15,24,.625,87,37,72,.514,32,57,.561,5,15,.333,22,30,.733,101
1139,HOU,2016-03-23,87,,UTA,L 87-89,240,33,74,.446,24,51,.471,9,23,.391,12,22,.545,87,31,77,.403,20,48,.417,11,29,.379,16,20,.800,89
1140,SAS,2016-03-19,87,,GSW,W 87-79,240,32,78,.410,24,57,.421,8,21,.381,15,18,.833,87,31,82,.378,22,46,.478,9,36,.250,8,10,.800,79
1141,LAL,2016-03-13,87,,NYK,L 87-90,240,34,85,.400,31,69,.449,3,16,.188,16,21,.762,87,33,75,.440,28,54,.519,5,21,.238,19,27,.704,90
1142,ATL,2016-02-28,87,,CHO,W 87-76,240,38,77,.494,30,60,.500,8,17,.471,3,5,.600,87,27,81,.333,20,49,.408,7,32,.219,15,23,.652,76
1143,ORL,2016-01-20,87,,PHI,L 87-96,240,33,84,.393,29,67,.433,4,17,.235,17,26,.654,87,36,74,.486,27,55,.491,9,19,.474,15,21,.714,96
1144,MIN,2016-01-10,87,,DAL,L 87-93,240,33,79,.418,29,63,.460,4,16,.250,17,22,.773,87,36,77,.468,30,57,.526,6,20,.300,15,21,.714,93
1145,DEN,2015-12-29,87,,CLE,L 87-93,240,37,89,.416,32,65,.492,5,24,.208,8,11,.727,87,38,86,.442,34,64,.531,4,22,.182,13,22,.591,93
1146,LAL,2015-12-17,87,,HOU,L 87-107,240,36,84,.429,31,60,.517,5,24,.208,10,18,.556,87,34,88,.386,22,57,.386,12,31,.387,27,42,.643,107
1147,CHO,2015-11-29,87,,MIL,W 87-82,240,27,70,.386,12,39,.308,15,31,.484,18,22,.818,87,33,82,.402,25,54,.463,8,28,.286,8,14,.571,82
1148,BRK,2015-11-29,87,,DET,W 87-83,240,35,81,.432,31,69,.449,4,12,.333,13,16,.813,87,34,101,.337,28,77,.364,6,24,.250,9,21,.429,83
1149,BOS,2015-11-01,87,,SAS,L 87-95,240,35,98,.357,29,69,.420,6,29,.207,11,14,.786,87,36,83,.434,31,64,.484,5,19,.263,18,25,.720,95
1150,ORL,2015-10-28,87,,WAS,L 87-88,240,37,100,.370,32,74,.432,5,26,.192,8,12,.667,87,33,84,.393,26,56,.464,7,28,.250,15,25,.600,88
1151,SAS,2016-04-10,86,,GSW,L 86-92,240,34,90,.378,31,73,.425,3,17,.176,15,19,.789,86,34,77,.442,24,50,.480,10,27,.370,14,18,.778,92
1152,UTA,2016-04-05,86,,SAS,L 86-88,240,32,68,.471,27,51,.529,5,17,.294,17,21,.810,86,32,72,.444,25,55,.455,7,17,.412,17,19,.895,88
1153,PHO,2016-04-03,86,,UTA,L 86-101,240,33,78,.423,25,51,.490,8,27,.296,12,19,.632,86,39,81,.481,29,54,.537,10,27,.370,13,17,.765,101
1154,NOP,2016-03-03,86,,SAS,L 86-94,240,35,89,.393,27,65,.415,8,24,.333,8,8,1.000,86,36,81,.444,28,60,.467,8,21,.381,14,15,.933,94
1155,PHI,2016-02-03,86,,ATL,L 86-124,240,35,84,.417,29,57,.509,6,27,.222,10,14,.714,86,48,92,.522,38,72,.528,10,20,.500,18,25,.720,124
1156,BRK,2016-01-22,86,,UTA,L 86-108,240,33,75,.440,27,59,.458,6,16,.375,14,18,.778,86,43,75,.573,34,59,.576,9,16,.563,13,15,.867,108
1157,NOP,2016-01-08,86,,IND,L 86-91,240,31,83,.373,22,54,.407,9,29,.310,15,20,.750,86,36,81,.444,31,60,.517,5,21,.238,14,19,.737,91
1158,ORL,2016-01-06,86,,IND,L 86-95,240,32,79,.405,26,48,.542,6,31,.194,16,17,.941,86,32,76,.421,26,54,.481,6,22,.273,25,29,.862,95
1159,ATL,2015-12-02,86,,TOR,L 86-96,240,33,90,.367,25,63,.397,8,27,.296,12,16,.750,86,36,79,.456,30,54,.556,6,25,.240,18,24,.750,96
1160,MIN,2015-11-20,86,,DET,L 86-96,240,33,77,.429,30,64,.469,3,13,.231,17,25,.680,86,40,87,.460,34,59,.576,6,28,.214,10,13,.769,96
1161,PHI,2015-11-16,86,,DAL,L 86-92,240,34,76,.447,29,54,.537,5,22,.227,13,20,.650,86,30,76,.395,23,52,.442,7,24,.292,25,30,.833,92
1162,PHI,2016-03-29,85,,CHO,L 85-100,240,30,96,.313,14,52,.269,16,44,.364,9,10,.900,85,38,87,.437,31,62,.500,7,25,.280,17,18,.944,100
1163,MIL,2016-03-20,85,,UTA,L 85-94,240,34,65,.523,31,57,.544,3,8,.375,14,17,.824,85,34,83,.410,21,45,.467,13,38,.342,13,14,.929,94
1164,NYK,2016-03-01,85,,POR,L 85-104,240,33,88,.375,27,67,.403,6,21,.286,13,18,.722,85,37,88,.420,25,58,.431,12,30,.400,18,20,.900,104
1165,NYK,2016-02-05,85,,MEM,L 85-91,240,30,80,.375,20,51,.392,10,29,.345,15,17,.882,85,33,76,.434,29,58,.500,4,18,.222,21,24,.875,91
1166,UTA,2016-02-03,85,,DEN,W 85-81,240,33,74,.446,28,52,.538,5,22,.227,14,20,.700,85,26,70,.371,22,52,.423,4,18,.222,25,33,.758,81
1167,PHI,2016-01-10,85,,CLE,L 85-95,240,35,77,.455,29,59,.492,6,18,.333,9,19,.474,85,35,90,.389,26,58,.448,9,32,.281,16,23,.696,95
1168,MIN,2016-01-02,85,,MIL,L 85-95,240,33,84,.393,30,70,.429,3,14,.214,16,24,.667,85,32,75,.427,24,59,.407,8,16,.500,23,28,.821,95
1169,LAL,2015-12-23,85,,OKC,L 85-120,240,32,89,.360,25,64,.391,7,25,.280,14,22,.636,85,51,95,.537,46,76,.605,5,19,.263,13,17,.765,120
1170,BRK,2015-12-20,85,,MIN,L 85-100,240,32,78,.410,27,57,.474,5,21,.238,16,20,.800,85,38,80,.475,35,68,.515,3,12,.250,21,24,.875,100
1171,CLE,2015-12-01,85,,WAS,L 85-97,240,28,83,.337,19,53,.358,9,30,.300,20,23,.870,85,39,83,.470,32,55,.582,7,28,.250,12,16,.750,97
1172,PHI,2015-11-18,85,,IND,L 85-112,240,35,76,.461,30,51,.588,5,25,.200,10,16,.625,85,42,92,.457,30,65,.462,12,27,.444,16,20,.800,112
1173,OKC,2015-11-15,85,,BOS,L 85-100,240,28,77,.364,22,52,.423,6,25,.240,23,29,.793,85,39,82,.476,30,59,.508,9,23,.391,13,20,.650,100
1174,HOU,2015-10-28,85,,DEN,L 85-105,240,30,87,.345,22,52,.423,8,35,.229,17,26,.654,85,40,79,.506,27,52,.519,13,27,.481,12,18,.667,105
1175,DEN,2016-04-10,84,,UTA,L 84-100,240,32,80,.400,26,53,.491,6,27,.222,14,19,.737,84,36,79,.456,24,48,.500,12,31,.387,16,21,.762,100
1176,MIN,2016-03-26,84,,UTA,L 84-93,240,32,84,.381,28,73,.384,4,11,.364,16,19,.842,84,39,83,.470,30,62,.484,9,21,.429,6,7,.857,93
1177,UTA,2016-03-08,84,,ATL,L 84-91,240,30,86,.349,23,60,.383,7,26,.269,17,23,.739,84,38,80,.475,30,55,.545,8,25,.320,7,14,.500,91
1178,ORL,2016-03-04,84,,PHO,L 84-102,240,35,101,.347,28,74,.378,7,27,.259,7,14,.500,84,35,78,.449,30,64,.469,5,14,.357,27,39,.692,102
1179,UTA,2016-02-05,84,,MIL,W 84-81,240,30,77,.390,22,50,.440,8,27,.296,16,23,.696,84,30,71,.423,23,57,.404,7,14,.500,14,21,.667,81
1180,CHI,2016-01-25,84,,MIA,L 84-89,240,35,88,.398,30,70,.429,5,18,.278,9,12,.750,84,37,81,.457,34,67,.507,3,14,.214,12,17,.706,89
1181,LAL,2015-12-25,84,,LAC,L 84-94,240,32,77,.416,25,54,.463,7,23,.304,13,25,.520,84,38,85,.447,28,59,.475,10,26,.385,8,11,.727,94
1182,BOS,2015-11-25,84,,PHI,W 84-80,240,31,91,.341,22,62,.355,9,29,.310,13,18,.722,84,31,83,.373,24,56,.429,7,27,.259,11,15,.733,80
1183,NYK,2015-11-13,84,,CLE,L 84-90,240,29,79,.367,20,52,.385,9,27,.333,17,21,.810,84,33,78,.423,27,50,.540,6,28,.214,18,31,.581,90
1184,MEM,2015-11-11,84,,GSW,L 84-100,240,24,70,.343,21,55,.382,3,15,.200,33,36,.917,84,36,75,.480,25,48,.521,11,27,.407,17,23,.739,100
1185,DEN,2015-11-05,84,,UTA,L 84-96,240,28,72,.389,23,52,.442,5,20,.250,23,34,.676,84,37,85,.435,26,61,.426,11,24,.458,11,17,.647,96
1186,MIN,2015-11-05,84,,MIA,L 84-96,240,30,85,.353,26,73,.356,4,12,.333,20,22,.909,84,37,76,.487,33,62,.532,4,14,.286,18,25,.720,96
1187,NYK,2015-11-02,84,,SAS,L 84-94,240,32,89,.360,28,76,.368,4,13,.308,16,21,.762,84,39,79,.494,35,66,.530,4,13,.308,12,17,.706,94
1188,ATL,2016-01-27,83,,LAC,L 83-85,240,33,79,.418,23,56,.411,10,23,.435,7,14,.500,83,33,85,.388,28,58,.483,5,27,.185,14,21,.667,85
1189,CLE,2016-01-23,83,,CHI,L 83-96,240,35,94,.372,31,70,.443,4,24,.167,9,22,.409,83,38,87,.437,31,70,.443,7,17,.412,13,15,.867,96
1190,MIN,2015-12-23,83,,SAS,L 83-108,240,30,72,.417,27,62,.435,3,10,.300,20,25,.800,83,44,82,.537,34,58,.586,10,24,.417,10,14,.714,108
1191,CHI,2015-12-10,83,,LAC,W 83-80,240,31,87,.356,24,64,.375,7,23,.304,14,16,.875,83,30,88,.341,20,66,.303,10,22,.455,10,12,.833,80
1192,MEM,2015-12-03,83,,SAS,L 83-103,240,30,80,.375,28,64,.438,2,16,.125,21,25,.840,83,40,80,.500,30,62,.484,10,18,.556,13,18,.722,103
1193,MIL,2015-11-10,83,,BOS,L 83-99,240,30,73,.411,24,56,.429,6,17,.353,17,23,.739,83,38,86,.442,31,56,.554,7,30,.233,16,19,.842,99
1194,LAL,2016-01-31,82,,CHO,L 82-101,240,27,80,.338,19,51,.373,8,29,.276,20,23,.870,82,36,96,.375,23,60,.383,13,36,.361,16,26,.615,101
1195,BRK,2015-12-14,82,,ORL,L 82-105,240,31,80,.388,24,61,.393,7,19,.368,13,16,.813,82,41,76,.539,32,55,.582,9,21,.429,14,20,.700,105
1196,WAS,2015-11-28,82,,TOR,L 82-84,240,27,82,.329,20,59,.339,7,23,.304,21,27,.778,82,31,72,.431,20,48,.417,11,24,.458,11,14,.786,84
1197,DET,2015-11-03,82,,IND,L 82-94,240,33,86,.384,28,64,.438,5,22,.227,11,17,.647,82,38,88,.432,31,65,.477,7,23,.304,11,12,.917,94
1198,LAL,2016-04-06,81,,LAC,L 81-91,240,32,90,.356,28,71,.394,4,19,.211,13,17,.765,81,37,83,.446,30,58,.517,7,25,.280,10,14,.714,91
1199,NYK,2016-02-28,81,,MIA,L 81-98,240,32,87,.368,26,72,.361,6,15,.400,11,12,.917,81,40,84,.476,39,76,.513,1,8,.125,17,21,.810,98
1200,LAC,2016-02-24,81,,DEN,L 81-87,240,30,85,.353,17,39,.436,13,46,.283,8,14,.571,81,34,90,.378,28,66,.424,6,24,.250,13,17,.765,87
1201,MIL,2016-04-05,80,,CLE,L 80-109,240,35,88,.398,31,72,.431,4,16,.250,6,12,.500,80,41,75,.547,23,39,.590,18,36,.500,9,10,.900,109
1202,NYK,2016-03-20,80,,SAC,L 80-88,240,32,91,.352,28,72,.389,4,19,.211,12,15,.800,80,35,88,.398,28,63,.444,7,25,.280,11,14,.786,88
1203,DEN,2015-11-27,80,,SAS,L 80-91,240,31,77,.403,24,57,.421,7,20,.350,11,13,.846,80,36,75,.480,28,53,.528,8,22,.364,11,14,.786,91
1204,LAC,2015-11-22,80,,TOR,L 80-91,240,29,74,.392,22,42,.524,7,32,.219,15,20,.750,80,29,78,.372,25,61,.410,4,17,.235,29,31,.935,91
1205,MIN,2016-03-30,79,,LAC,L 79-99,240,30,87,.345,22,64,.344,8,23,.348,11,17,.647,79,37,84,.440,28,53,.528,9,31,.290,16,18,.889,99
1206,HOU,2016-02-06,79,,POR,L 79-96,240,25,77,.325,18,41,.439,7,36,.194,22,30,.733,79,35,87,.402,24,52,.462,11,35,.314,15,23,.652,96
1207,MIA,2016-01-19,79,,MIL,L 79-91,240,27,74,.365,22,52,.423,5,22,.227,20,26,.769,79,36,74,.486,31,62,.500,5,12,.417,14,16,.875,91
1208,BRK,2016-01-11,79,,SAS,L 79-106,240,33,73,.452,31,61,.508,2,12,.167,11,13,.846,79,44,82,.537,40,69,.580,4,13,.308,14,19,.737,106
1209,MIN,2016-04-03,78,,DAL,L 78-88,240,29,71,.408,25,50,.500,4,21,.190,16,18,.889,78,32,83,.386,18,43,.419,14,40,.350,10,17,.588,88
1210,UTA,2016-02-25,78,,SAS,L 78-96,240,33,77,.429,30,60,.500,3,17,.176,9,12,.750,78,38,79,.481,29,61,.475,9,18,.500,11,12,.917,96
1211,BRK,2016-01-20,78,,CLE,L 78-91,240,35,84,.417,31,65,.477,4,19,.211,4,8,.500,78,36,77,.468,31,60,.517,5,17,.294,14,20,.700,91
1212,POR,2016-01-04,78,,MEM,L 78-91,240,28,72,.389,21,44,.477,7,28,.250,15,24,.625,78,35,91,.385,32,76,.421,3,15,.200,18,26,.692,91
1213,ATL,2015-12-12,78,,SAS,L 78-103,240,30,80,.375,25,56,.446,5,24,.208,13,16,.813,78,36,74,.486,26,54,.481,10,20,.500,21,22,.955,103
1214,NYK,2015-11-27,78,,MIA,L 78-97,240,32,85,.376,29,71,.408,3,14,.214,11,15,.733,78,33,76,.434,26,59,.441,7,17,.412,24,28,.857,97
1215,DEN,2015-10-30,78,,MIN,L 78-95,240,29,95,.305,24,70,.343,5,25,.200,15,20,.750,78,30,71,.423,28,60,.467,2,11,.182,33,41,.805,95
1216,LAL,2016-03-04,77,,ATL,L 77-106,240,29,85,.341,24,58,.414,5,27,.185,14,20,.700,77,37,68,.544,24,40,.600,13,28,.464,19,26,.731,106
1217,CHI,2016-01-15,77,,DAL,L 77-83,240,31,86,.360,29,67,.433,2,19,.105,13,15,.867,77,30,77,.390,22,55,.400,8,22,.364,15,17,.882,83
1218,HOU,2016-01-15,77,,CLE,L 77-91,240,26,74,.351,20,49,.408,6,25,.240,19,29,.655,77,34,87,.391,26,52,.500,8,35,.229,15,23,.652,91
1219,BRK,2016-01-08,77,,ORL,L 77-83,240,29,73,.397,22,51,.431,7,22,.318,12,20,.600,77,33,83,.398,20,55,.364,13,28,.464,4,6,.667,83
1220,BOS,2015-12-15,77,,CLE,L 77-89,240,28,87,.322,19,55,.345,9,32,.281,12,14,.857,77,36,78,.462,28,55,.509,8,23,.348,9,10,.900,89
1221,ORL,2015-12-11,76,,CLE,L 76-111,240,28,72,.389,22,50,.440,6,22,.273,14,20,.700,76,41,72,.569,30,51,.588,11,21,.524,18,27,.667,111
1222,IND,2015-10-31,76,,UTA,L 76-97,240,28,70,.400,24,53,.453,4,17,.235,16,21,.762,76,39,88,.443,33,73,.452,6,15,.400,13,18,.722,97
1223,MEM,2015-10-28,76,,CLE,L 76-106,240,29,82,.354,27,66,.409,2,16,.125,16,22,.727,76,41,84,.488,28,55,.509,13,29,.448,11,17,.647,106
1224,WAS,2016-01-03,75,,MIA,L 75-97,240,31,91,.341,27,61,.443,4,30,.133,9,13,.692,75,39,86,.453,30,63,.476,9,23,.391,10,12,.833,97
1225,LAL,2016-01-10,74,,UTA,L 74-86,240,29,89,.326,26,68,.382,3,21,.143,13,15,.867,74,31,69,.449,26,53,.491,5,16,.313,19,25,.760,86
1226,BRK,2016-01-06,74,,TOR,L 74-91,240,31,78,.397,26,62,.419,5,16,.313,7,12,.583,74,35,80,.438,31,58,.534,4,22,.182,17,18,.944,91
1227,MIN,2016-01-06,74,,DEN,L 74-78,240,28,73,.384,25,62,.403,3,11,.273,15,20,.750,74,29,81,.358,21,61,.344,8,20,.400,12,17,.706,78
1228,DEN,2015-12-08,74,,ORL,L 74-85,240,28,84,.333,21,60,.350,7,24,.292,11,20,.550,74,38,88,.432,37,72,.514,1,16,.063,8,10,.800,85
1229,PHI,2015-10-30,71,,UTA,L 71-99,240,19,63,.302,13,48,.271,6,15,.400,27,37,.730,71,36,88,.409,29,75,.387,7,13,.538,20,25,.800,99
1230,PHI,2015-12-07,68,,SAS,L 68-119,240,26,75,.347,22,51,.431,4,24,.167,12,21,.571,68,47,76,.618,43,65,.662,4,11,.364,21,25,.840,119
