Rk,Team,Date,PTS,,Opp,Result,MP,FG,FGA,FG%,2P,2PA,2P%,3P,3PA,3P%,FT,FTA,FT%,PTS,FG,FGA,FG%,2P,2PA,2P%,3P,3PA,3P%,FT,FTA,FT%,PTS
1,MEM,2024-12-26,155,,TOR,W 155-126,240,58,109,.532,40,64,.625,18,45,.400,21,29,.724,155,49,108,.454,35,65,.538,14,43,.326,14,18,.778,126
2,MEM,2025-02-25,151,,PHO,W 151-148 (OT),265,52,99,.525,32,51,.627,20,48,.417,27,30,.900,151,53,99,.535,32,62,.516,21,37,.568,21,26,.808,148
3,DEN,2025-03-07,149,,PHO,W 149-141 (OT),265,57,97,.588,36,57,.632,21,40,.525,14,18,.778,149,51,91,.560,35,53,.660,16,38,.421,23,29,.793,141
4,NYK,2025-02-12,149,,ATL,W 149-148 (OT),265,54,94,.574,43,68,.632,11,26,.423,30,37,.811,149,55,110,.500,41,72,.569,14,38,.368,24,35,.686,148
5,ATL,2025-04-06,147,,UTA,W 147-134,240,54,95,.568,32,54,.593,22,41,.537,17,20,.850,147,45,87,.517,25,40,.625,20,47,.426,24,28,.857,134
6,HOU,2025-03-08,146,,NOP,W 146-117,240,55,99,.556,38,59,.644,17,40,.425,19,21,.905,146,48,99,.485,36,65,.554,12,34,.353,9,16,.563,117
7,DEN,2025-02-10,146,,POR,W 146-117,240,60,91,.659,52,66,.788,8,25,.320,18,20,.900,146,40,88,.455,25,51,.490,15,37,.405,22,26,.846,117
8,OKC,2025-03-31,145,,CHI,W 145-117,240,52,98,.531,29,55,.527,23,43,.535,18,23,.783,145,44,98,.449,28,47,.596,16,51,.314,13,16,.813,117
9,HOU,2025-03-17,144,,PHI,W 144-137 (OT),265,51,107,.477,29,54,.537,22,53,.415,20,24,.833,144,48,95,.505,24,46,.522,24,49,.490,17,25,.680,137
10,DEN,2025-02-05,144,,NOP,W 144-119,240,57,100,.570,41,57,.719,16,43,.372,14,15,.933,144,43,93,.462,33,64,.516,10,29,.345,23,26,.885,119
11,CLE,2025-02-02,144,,DAL,W 144-101,240,53,93,.570,27,48,.563,26,45,.578,12,16,.750,144,40,103,.388,31,60,.517,9,43,.209,12,15,.800,101
12,OKC,2025-02-01,144,,SAC,W 144-110,240,57,107,.533,38,61,.623,19,46,.413,11,16,.688,144,40,100,.400,29,56,.518,11,44,.250,19,26,.731,110
13,SAS,2025-01-31,144,,MIL,W 144-118,240,50,102,.490,26,52,.500,24,50,.480,20,25,.800,144,43,100,.430,31,63,.492,12,37,.324,20,26,.769,118
14,DEN,2025-01-21,144,,PHI,W 144-109,240,52,85,.612,36,54,.667,16,31,.516,24,25,.960,144,44,96,.458,29,58,.500,15,38,.395,6,8,.750,109
15,MEM,2024-12-19,144,,GSW,W 144-93,240,53,98,.541,26,50,.520,27,48,.563,11,15,.733,144,32,90,.356,20,54,.370,12,36,.333,17,24,.708,93
16,LAC,2024-12-16,144,,UTA,W 144-107,240,49,82,.598,28,43,.651,21,39,.538,25,32,.781,144,36,80,.450,23,41,.561,13,39,.333,22,30,.733,107
17,CLE,2024-11-15,144,,CHI,W 144-126,240,51,93,.548,30,50,.600,21,43,.488,21,24,.875,144,45,88,.511,25,46,.543,20,42,.476,16,20,.800,126
18,HOU,2025-04-02,143,,UTA,W 143-105,240,56,104,.538,37,59,.627,19,45,.422,12,19,.632,143,40,94,.426,30,54,.556,10,40,.250,15,23,.652,105
19,ATL,2025-02-23,143,,DET,L 143-148,240,48,96,.500,27,51,.529,21,45,.467,26,36,.722,143,55,93,.591,35,53,.660,20,40,.500,18,25,.720,148
20,NYK,2025-01-27,143,,MEM,W 143-106,240,56,108,.519,39,64,.609,17,44,.386,14,18,.778,143,41,91,.451,32,67,.478,9,24,.375,15,17,.882,106
21,NYK,2025-01-25,143,,SAC,W 143-120,240,52,105,.495,35,69,.507,17,36,.472,22,23,.957,143,46,95,.484,32,59,.542,14,36,.389,14,16,.875,120
22,CLE,2025-02-21,142,,NYK,W 142-105,240,56,92,.609,37,55,.673,19,37,.514,11,15,.733,142,42,89,.472,32,61,.525,10,28,.357,11,18,.611,105
23,BOS,2024-12-27,142,,IND,W 142-105,240,47,92,.511,24,36,.667,23,56,.411,25,29,.862,142,38,91,.418,27,52,.519,11,39,.282,18,25,.720,105
24,OKC,2025-03-21,141,,CHO,W 141-106,240,54,94,.574,33,55,.600,21,39,.538,12,17,.706,141,37,80,.463,18,39,.462,19,41,.463,13,13,1.000,106
25,MIN,2025-03-09,141,,SAS,W 141-124,240,53,95,.558,32,53,.604,21,42,.500,14,15,.933,141,47,85,.553,36,55,.655,11,30,.367,19,24,.792,124
26,POR,2025-02-22,141,,CHO,W 141-88,240,51,87,.586,31,44,.705,20,43,.465,19,27,.704,141,34,98,.347,29,66,.439,5,32,.156,15,21,.714,88
27,ATL,2024-12-26,141,,CHI,W 141-133,240,46,89,.517,29,44,.659,17,45,.378,32,34,.941,141,53,98,.541,31,55,.564,22,43,.512,5,6,.833,133
28,SAC,2024-12-08,141,,UTA,W 141-97,240,57,100,.570,35,56,.625,22,44,.500,5,8,.625,141,31,80,.388,16,38,.421,15,42,.357,20,21,.952,97
29,MIL,2025-04-13,140,,DET,W 140-133 (OT),265,50,86,.581,27,42,.643,23,44,.523,17,22,.773,140,51,107,.477,29,48,.604,22,59,.373,9,14,.643,133
30,LAL,2025-04-11,140,,HOU,W 140-109,240,53,87,.609,34,50,.680,19,37,.514,15,25,.600,140,41,90,.456,23,39,.590,18,51,.353,9,12,.750,109
31,IND,2025-04-04,140,,UTA,W 140-112,240,51,89,.573,39,57,.684,12,32,.375,26,38,.684,140,39,104,.375,23,52,.442,16,52,.308,18,21,.857,112
32,NOP,2025-02-13,140,,SAC,W 140-133 (OT),265,46,92,.500,25,42,.595,21,50,.420,27,34,.794,140,49,112,.438,32,65,.492,17,47,.362,18,21,.857,133
33,OKC,2025-02-05,140,,PHO,W 140-109,240,52,102,.510,40,60,.667,12,42,.286,24,27,.889,140,33,70,.471,19,34,.559,14,36,.389,29,33,.879,109
34,NYK,2025-01-12,140,,MIL,W 140-106,240,51,88,.580,33,47,.702,18,41,.439,20,24,.833,140,43,94,.457,33,60,.550,10,34,.294,10,17,.588,106
35,DEN,2025-04-01,139,,MIN,L 139-140 (2OT),290,47,86,.547,35,52,.673,12,34,.353,33,44,.750,139,52,111,.468,33,61,.541,19,50,.380,17,25,.680,140
36,MEM,2025-01-24,139,,NOP,W 139-126,240,56,101,.554,37,59,.627,19,42,.452,8,8,1.000,139,45,83,.542,31,49,.633,14,34,.412,22,32,.688,126
37,CHI,2025-01-04,139,,NYK,W 139-126,240,51,94,.543,31,57,.544,20,37,.541,17,18,.944,139,48,97,.495,40,67,.597,8,30,.267,22,28,.786,126
38,GSW,2025-01-02,139,,PHI,W 139-105,240,53,87,.609,31,48,.646,22,39,.564,11,15,.733,139,34,81,.420,25,50,.500,9,31,.290,28,34,.824,105
39,DEN,2025-01-01,139,,ATL,W 139-120,240,53,94,.564,41,64,.641,12,30,.400,21,21,1.000,139,45,100,.450,29,54,.537,16,46,.348,14,21,.667,120
40,NYK,2024-12-23,139,,TOR,W 139-125,240,51,86,.593,34,49,.694,17,37,.459,20,29,.690,139,42,77,.545,31,49,.633,11,28,.393,30,37,.811,125
41,SAS,2024-11-13,139,,WAS,W 139-130,240,48,92,.522,30,48,.625,18,44,.409,25,32,.781,139,49,95,.516,31,51,.608,18,44,.409,14,16,.875,130
42,BRK,2024-10-29,139,,DEN,L 139-144 (OT),265,49,96,.510,29,44,.659,20,52,.385,21,27,.778,139,46,89,.517,33,62,.532,13,27,.481,39,47,.830,144
43,CHI,2025-01-10,138,,WAS,W 138-105,240,53,95,.558,30,46,.652,23,49,.469,9,14,.643,138,39,98,.398,21,52,.404,18,46,.391,9,13,.692,105
44,SAC,2025-01-03,138,,MEM,W 138-133,240,49,99,.495,28,52,.538,21,47,.447,19,23,.826,138,43,89,.483,26,52,.500,17,37,.459,30,36,.833,133
45,CHO,2024-10-30,138,,TOR,W 138-133,240,49,94,.521,29,49,.592,20,45,.444,20,25,.800,138,52,91,.571,43,63,.683,9,28,.321,20,30,.667,133
46,CHI,2025-04-01,137,,TOR,W 137-118,240,50,88,.568,36,54,.667,14,34,.412,23,27,.852,137,44,97,.454,24,52,.462,20,45,.444,10,11,.909,118
47,MIL,2025-03-05,137,,DAL,W 137-107,240,52,89,.584,36,54,.667,16,35,.457,17,19,.895,137,45,98,.459,32,59,.542,13,39,.333,4,10,.400,107
48,OKC,2025-03-03,137,,HOU,W 137-128,240,48,97,.495,31,60,.517,17,37,.459,24,27,.889,137,49,101,.485,33,66,.500,16,35,.457,14,17,.824,128
49,OKC,2025-02-10,137,,NOP,W 137-101,240,49,95,.516,22,40,.550,27,55,.491,12,16,.750,137,36,82,.439,26,55,.473,10,27,.370,19,28,.679,101
50,CLE,2025-01-30,137,,ATL,W 137-115,240,53,91,.582,40,52,.769,13,39,.333,18,20,.900,137,41,90,.456,28,51,.549,13,39,.333,20,27,.741,115
51,MIL,2025-04-10,136,,NOP,W 136-111,240,49,90,.544,31,45,.689,18,45,.400,20,30,.667,136,41,96,.427,26,49,.531,15,47,.319,14,19,.737,111
52,OKC,2025-04-08,136,,LAL,W 136-120,240,52,104,.500,34,67,.507,18,37,.486,14,20,.700,136,37,80,.463,19,40,.475,18,40,.450,28,37,.757,120
53,DET,2025-03-23,136,,NOP,W 136-130,240,47,86,.547,34,59,.576,13,27,.481,29,40,.725,136,49,85,.576,29,45,.644,20,40,.500,12,16,.750,130
54,LAL,2025-03-04,136,,NOP,W 136-115,240,48,90,.533,29,38,.763,19,52,.365,21,27,.778,136,46,93,.495,37,59,.627,9,34,.265,14,21,.667,115
55,NOP,2025-01-29,136,,DAL,L 136-137,240,51,96,.531,36,65,.554,15,31,.484,19,22,.864,136,52,96,.542,32,53,.604,20,43,.465,13,17,.765,137
56,NOP,2025-01-17,136,,UTA,W 136-123,240,47,100,.470,25,50,.500,22,50,.440,20,31,.645,136,43,86,.500,30,48,.625,13,38,.342,24,30,.800,123
57,MEM,2024-12-01,136,,IND,W 136-121,240,49,93,.527,33,47,.702,16,46,.348,22,27,.815,136,43,90,.478,29,48,.604,14,42,.333,21,26,.808,121
58,CHI,2024-11-22,136,,ATL,W 136-122,240,49,86,.570,30,43,.698,19,43,.442,19,21,.905,136,49,107,.458,39,73,.534,10,34,.294,14,19,.737,122
59,CLE,2024-11-08,136,,GSW,W 136-117,240,46,85,.541,26,43,.605,20,42,.476,24,28,.857,136,47,98,.480,34,56,.607,13,42,.310,10,14,.714,117
60,CLE,2025-04-08,135,,CHI,W 135-113,240,51,100,.510,26,50,.520,25,50,.500,8,13,.615,135,41,86,.477,26,43,.605,15,43,.349,16,19,.842,113
61,LAC,2025-04-05,135,,DAL,W 135-104,240,54,96,.563,43,68,.632,11,28,.393,16,20,.800,135,34,78,.436,27,51,.529,7,27,.259,29,38,.763,104
62,IND,2025-03-19,135,,DAL,W 135-131,240,45,82,.549,29,47,.617,16,35,.457,29,37,.784,135,48,88,.545,37,61,.607,11,27,.407,24,32,.750,131
63,MIL,2025-02-09,135,,PHI,W 135-127,240,46,105,.438,22,50,.440,24,55,.436,19,20,.950,135,47,89,.528,29,44,.659,18,45,.400,15,19,.789,127
64,PHO,2025-02-07,135,,UTA,W 135-127 (OT),265,47,104,.452,25,48,.521,22,56,.393,19,21,.905,135,48,117,.410,35,69,.507,13,48,.271,18,20,.900,127
65,DEN,2024-12-27,135,,CLE,L 135-149,240,53,94,.564,38,63,.603,15,31,.484,14,18,.778,135,54,96,.563,31,48,.646,23,48,.479,18,22,.818,149
66,MEM,2024-12-13,135,,BRK,W 135-119,240,52,99,.525,35,63,.556,17,36,.472,14,21,.667,135,42,92,.457,22,39,.564,20,53,.377,15,19,.789,119
67,DEN,2024-11-08,135,,MIA,W 135-122,240,50,81,.617,32,46,.696,18,35,.514,17,19,.895,135,46,94,.489,26,51,.510,20,43,.465,10,13,.769,122
68,IND,2024-10-30,135,,BOS,W 135-132 (OT),265,50,104,.481,35,66,.530,15,38,.395,20,24,.833,135,44,109,.404,25,52,.481,19,57,.333,25,31,.806,132
69,LAC,2025-04-09,134,,HOU,W 134-117,240,48,90,.533,29,53,.547,19,37,.514,19,19,1.000,134,45,88,.511,25,48,.521,20,40,.500,7,10,.700,117
70,MIN,2025-03-21,134,,NOP,W 134-93,240,48,89,.539,29,45,.644,19,44,.432,19,20,.950,134,34,68,.500,23,37,.622,11,31,.355,14,22,.636,93
71,SAS,2025-03-14,134,,CHO,L 134-145,240,48,95,.505,27,49,.551,21,46,.457,17,22,.773,134,51,85,.600,25,39,.641,26,46,.565,17,19,.895,145
72,PHI,2025-01-31,134,,DEN,L 134-137,240,50,90,.556,29,50,.580,21,40,.525,13,16,.813,134,54,82,.659,42,59,.712,12,23,.522,17,18,.944,137
73,OKC,2025-01-16,134,,CLE,W 134-114,240,53,105,.505,35,52,.673,18,53,.340,10,11,.909,134,42,90,.467,29,48,.604,13,42,.310,17,21,.810,114
74,DEN,2024-12-28,134,,DET,W 134-121,240,46,82,.561,33,55,.600,13,27,.481,29,36,.806,134,46,95,.484,34,56,.607,12,39,.308,17,23,.739,121
75,ATL,2024-12-06,134,,LAL,W 134-132 (OT),265,50,100,.500,33,60,.550,17,40,.425,17,22,.773,134,51,99,.515,35,64,.547,16,35,.457,14,16,.875,132
76,MIA,2024-12-04,134,,LAL,W 134-93,240,52,90,.578,28,43,.651,24,47,.511,6,9,.667,134,37,88,.420,32,66,.485,5,22,.227,14,19,.737,93
77,NYK,2024-11-18,134,,WAS,W 134-106,240,51,91,.560,31,51,.608,20,40,.500,12,13,.923,134,43,91,.473,32,58,.552,11,33,.333,9,16,.563,106
78,OKC,2024-11-11,134,,LAC,W 134-128,240,47,91,.516,29,45,.644,18,46,.391,22,23,.957,134,44,80,.550,24,43,.558,20,37,.541,20,29,.690,128
79,CLE,2024-10-30,134,,LAL,W 134-110,240,56,97,.577,39,56,.696,17,41,.415,5,8,.625,134,38,77,.494,32,49,.653,6,28,.214,28,33,.848,110
80,UTA,2025-04-09,133,,POR,W 133-126 (OT),265,50,98,.510,35,62,.565,15,36,.417,18,22,.818,133,48,104,.462,37,59,.627,11,45,.244,19,28,.679,126
81,MIL,2025-04-01,133,,PHO,W 133-123,240,51,74,.689,34,45,.756,17,29,.586,14,15,.933,133,44,92,.478,26,47,.553,18,45,.400,17,21,.810,123
82,DET,2025-03-28,133,,CLE,W 133-122,240,44,92,.478,29,58,.500,15,34,.441,30,35,.857,133,39,84,.464,24,44,.545,15,40,.375,29,38,.763,122
83,OKC,2025-03-19,133,,PHI,W 133-100,240,47,90,.522,23,38,.605,24,52,.462,15,20,.750,133,35,95,.368,17,38,.447,18,57,.316,12,16,.750,100
84,HOU,2025-03-14,133,,DAL,W 133-96,240,54,105,.514,39,74,.527,15,31,.484,10,12,.833,133,39,94,.415,31,72,.431,8,22,.364,10,12,.833,96
85,CLE,2025-03-02,133,,POR,W 133-129 (OT),265,42,97,.433,23,51,.451,19,46,.413,30,35,.857,133,42,96,.438,28,56,.500,14,40,.350,31,35,.886,129
86,CHI,2025-02-04,133,,MIA,W 133-124,240,48,91,.527,29,50,.580,19,41,.463,18,22,.818,133,43,90,.478,26,46,.565,17,44,.386,21,26,.808,124
87,IND,2025-01-29,133,,DET,W 133-119,240,46,81,.568,27,43,.628,19,38,.500,22,31,.710,133,44,89,.494,32,55,.582,12,34,.353,19,26,.731,119
88,MIN,2025-01-25,133,,DEN,W 133-104,240,53,95,.558,39,65,.600,14,30,.467,13,15,.867,133,43,88,.489,32,56,.571,11,32,.344,7,13,.538,104
89,HOU,2024-12-19,133,,NOP,W 133-113,240,50,87,.575,33,48,.688,17,39,.436,16,19,.842,133,41,92,.446,28,64,.438,13,28,.464,18,25,.720,113
90,SAS,2024-12-19,133,,ATL,W 133-126 (OT),265,49,101,.485,30,59,.508,19,42,.452,16,23,.696,133,46,97,.474,30,59,.508,16,38,.421,18,21,.857,126
91,GSW,2024-12-15,133,,DAL,L 133-143,240,49,103,.476,22,49,.449,27,54,.500,8,11,.727,133,52,87,.598,31,46,.674,21,41,.512,18,25,.720,143
92,OKC,2024-12-03,133,,UTA,W 133-106,240,53,102,.520,36,55,.655,17,47,.362,10,11,.909,133,38,70,.543,25,35,.714,13,35,.371,17,22,.773,106
93,ORL,2024-11-27,133,,CHI,W 133-119,240,46,90,.511,31,51,.608,15,39,.385,26,28,.929,133,46,87,.529,30,45,.667,16,42,.381,11,16,.688,119
94,WAS,2024-10-30,133,,ATL,W 133-120,240,47,89,.528,31,51,.608,16,38,.421,23,25,.920,133,45,95,.474,33,56,.589,12,39,.308,18,21,.857,120
95,MEM,2025-04-13,132,,DAL,W 132-97,240,52,104,.500,37,63,.587,15,41,.366,13,15,.867,132,38,87,.437,33,59,.559,5,28,.179,16,22,.727,97
96,OKC,2025-03-29,132,,IND,W 132-111,240,48,94,.511,31,58,.534,17,36,.472,19,23,.826,132,39,87,.448,25,45,.556,14,42,.333,19,26,.731,111
97,ATL,2025-03-23,132,,PHI,W 132-119,240,48,87,.552,31,50,.620,17,37,.459,19,22,.864,132,40,91,.440,29,57,.509,11,34,.324,28,37,.757,119
98,LAC,2025-03-18,132,,CLE,W 132-119,240,46,84,.548,30,49,.612,16,35,.457,24,28,.857,132,44,90,.489,30,49,.612,14,41,.341,17,26,.654,119
99,SAC,2025-03-17,132,,MEM,W 132-122,240,46,88,.523,26,47,.553,20,41,.488,20,30,.667,132,44,90,.489,31,60,.517,13,30,.433,21,21,1.000,122
100,ATL,2025-03-10,132,,PHI,W 132-123,240,53,98,.541,38,61,.623,15,37,.405,11,14,.786,132,46,91,.505,30,49,.612,16,42,.381,15,20,.750,123
101,SAS,2025-03-02,132,,OKC,L 132-146,240,51,91,.560,33,48,.688,18,43,.419,12,16,.750,132,55,101,.545,36,57,.632,19,44,.432,17,20,.850,146
102,DEN,2025-02-12,132,,POR,W 132-121,240,49,96,.510,34,58,.586,15,38,.395,19,24,.792,132,43,94,.457,29,56,.518,14,38,.368,21,29,.724,121
103,LAL,2025-02-10,132,,UTA,W 132-113,240,50,92,.543,35,50,.700,15,42,.357,17,18,.944,132,39,84,.464,27,44,.614,12,40,.300,23,27,.852,113
104,IND,2025-02-01,132,,ATL,W 132-127,240,49,90,.544,37,57,.649,12,33,.364,22,25,.880,132,45,90,.500,31,53,.585,14,37,.378,23,32,.719,127
105,PHI,2025-01-24,132,,CLE,W 132-129,240,44,87,.506,23,48,.479,21,39,.538,23,27,.852,132,45,90,.500,20,38,.526,25,52,.481,14,19,.737,129
106,DEN,2025-01-23,132,,SAC,W 132-123,240,49,101,.485,36,64,.563,13,37,.351,21,31,.677,132,47,107,.439,32,66,.485,15,41,.366,14,19,.737,123
107,MEM,2025-01-22,132,,CHO,W 132-120,240,49,98,.500,28,51,.549,21,47,.447,13,14,.929,132,41,86,.477,30,55,.545,11,31,.355,27,32,.844,120
108,SAC,2025-01-16,132,,HOU,W 132-127,240,49,98,.500,35,65,.538,14,33,.424,20,22,.909,132,49,93,.527,37,60,.617,12,33,.364,17,24,.708,127
109,CLE,2025-01-09,132,,TOR,W 132-126,240,47,89,.528,29,44,.659,18,45,.400,20,25,.800,132,53,89,.596,39,58,.672,14,31,.452,6,13,.462,126
110,NOP,2025-01-03,132,,WAS,W 132-120,240,48,96,.500,30,55,.545,18,41,.439,18,22,.818,132,45,84,.536,36,56,.643,9,28,.321,21,27,.778,120
111,LAL,2024-12-28,132,,SAC,W 132-122,240,46,77,.597,32,51,.627,14,26,.538,26,33,.788,132,50,98,.510,39,58,.672,11,40,.275,11,15,.733,122
112,WAS,2024-12-28,132,,NYK,L 132-136 (OT),265,51,99,.515,34,61,.557,17,38,.447,13,15,.867,132,51,97,.526,41,57,.719,10,40,.250,24,26,.923,136
113,DAL,2024-12-23,132,,POR,W 132-108,240,48,90,.533,36,54,.667,12,36,.333,24,34,.706,132,43,93,.462,35,64,.547,8,29,.276,14,19,.737,108
114,DAL,2024-11-19,132,,NOP,W 132-91,240,49,94,.521,35,63,.556,14,31,.452,20,25,.800,132,31,78,.397,20,46,.435,11,32,.344,18,21,.857,91
115,IND,2024-11-10,132,,NYK,W 132-121,240,45,88,.511,24,42,.571,21,46,.457,21,25,.840,132,46,83,.554,39,58,.672,7,25,.280,22,27,.815,121
116,BOS,2024-10-22,132,,NYK,W 132-109,240,48,95,.505,19,34,.559,29,61,.475,7,8,.875,132,43,78,.551,32,48,.667,11,30,.367,12,16,.750,109
117,DEN,2025-03-14,131,,LAL,W 131-126,240,44,85,.518,31,54,.574,13,31,.419,30,38,.789,131,49,105,.467,34,65,.523,15,40,.375,13,16,.813,126
118,MIA,2025-02-26,131,,ATL,W 131-109,240,45,76,.592,22,34,.647,23,42,.548,18,22,.818,131,41,81,.506,29,49,.592,12,32,.375,15,19,.789,109
119,UTA,2025-02-12,131,,LAL,W 131-119,240,45,86,.523,30,45,.667,15,41,.366,26,33,.788,131,41,92,.446,21,42,.500,20,50,.400,17,30,.567,119
120,UTA,2025-02-05,131,,GSW,W 131-128,240,48,92,.522,35,55,.636,13,37,.351,22,27,.815,131,46,100,.460,29,52,.558,17,48,.354,19,27,.704,128
121,CLE,2025-01-25,131,,HOU,L 131-135,240,47,91,.516,30,52,.577,17,39,.436,20,26,.769,131,45,82,.549,32,54,.593,13,28,.464,32,45,.711,135
122,GSW,2025-01-23,131,,CHI,W 131-106,240,46,102,.451,21,45,.467,25,57,.439,14,14,1.000,131,34,87,.391,18,47,.383,16,40,.400,22,27,.815,106
123,LAC,2025-01-04,131,,ATL,W 131-105,240,53,96,.552,40,60,.667,13,36,.361,12,17,.706,131,38,88,.432,22,42,.524,16,46,.348,13,17,.765,105
124,POR,2024-12-01,131,,DAL,L 131-137,240,49,84,.583,31,53,.585,18,31,.581,15,18,.833,131,48,87,.552,30,51,.588,18,36,.500,23,29,.793,137
125,MEM,2024-11-27,131,,DET,W 131-111,240,51,93,.548,34,47,.723,17,46,.370,12,16,.750,131,40,85,.471,27,47,.574,13,38,.342,18,25,.720,111
126,CHI,2024-11-23,131,,MEM,L 131-142,240,49,97,.505,30,55,.545,19,42,.452,14,19,.737,131,55,96,.573,36,54,.667,19,42,.452,13,20,.650,142
127,MEM,2024-11-06,131,,LAL,W 131-114,240,48,93,.516,31,59,.525,17,34,.500,18,23,.783,131,41,93,.441,26,45,.578,15,48,.313,17,21,.810,114
128,TOR,2024-11-02,131,,SAC,W 131-128 (OT),265,46,95,.484,29,58,.500,17,37,.459,22,31,.710,131,46,100,.460,36,60,.600,10,40,.250,26,32,.813,128
129,LAL,2024-10-26,131,,SAC,W 131-127,240,48,92,.522,34,58,.586,14,34,.412,21,24,.875,131,45,88,.511,30,44,.682,15,44,.341,22,25,.880,127
130,BOS,2025-04-11,130,,CHO,W 130-94,240,49,95,.516,26,44,.591,23,51,.451,9,12,.750,130,36,93,.387,21,53,.396,15,40,.375,7,10,.700,94
131,MIN,2025-03-17,130,,IND,L 130-132 (OT),265,44,97,.454,31,55,.564,13,42,.310,29,36,.806,130,48,97,.495,31,60,.517,17,37,.459,19,23,.826,132
132,GSW,2025-03-13,130,,SAC,W 130-104,240,45,78,.577,23,39,.590,22,39,.564,18,24,.750,130,37,79,.468,23,42,.548,14,37,.378,16,22,.727,104
133,GSW,2025-03-10,130,,POR,W 130-120,240,45,85,.529,24,44,.545,21,41,.512,19,21,.905,130,44,91,.484,26,49,.531,18,42,.429,14,17,.824,120
134,MEM,2025-03-03,130,,ATL,L 130-132,240,47,93,.505,34,60,.567,13,33,.394,23,25,.920,130,55,96,.573,42,68,.618,13,28,.464,9,17,.529,132
135,SAC,2025-02-24,130,,CHO,W 130-88,240,47,87,.540,27,49,.551,20,38,.526,16,18,.889,130,30,85,.353,20,45,.444,10,40,.250,18,24,.750,88
136,WAS,2025-02-12,130,,IND,L 130-134 (OT),265,47,97,.485,24,52,.462,23,45,.511,13,16,.813,130,50,107,.467,34,72,.472,16,35,.457,18,20,.900,134
137,LAC,2025-02-08,130,,UTA,W 130-110,240,51,88,.580,40,62,.645,11,26,.423,17,21,.810,130,39,83,.470,22,40,.550,17,43,.395,15,18,.833,110
138,DET,2025-02-03,130,,ATL,L 130-132,240,43,83,.518,34,56,.607,9,27,.333,35,38,.921,130,42,81,.519,26,44,.591,16,37,.432,32,39,.821,132
139,DAL,2025-01-27,130,,WAS,W 130-108,240,49,92,.533,29,47,.617,20,45,.444,12,17,.706,130,42,101,.416,31,64,.484,11,37,.297,13,17,.765,108
140,MIL,2025-01-17,130,,TOR,W 130-112,240,42,81,.519,29,50,.580,13,31,.419,33,41,.805,130,43,91,.473,35,57,.614,8,34,.235,18,24,.750,112
141,MIL,2025-01-14,130,,SAC,W 130-115,240,49,99,.495,32,54,.593,17,45,.378,15,18,.833,130,42,95,.442,25,53,.472,17,42,.405,14,18,.778,115
142,TOR,2025-01-01,130,,BRK,W 130-113,240,52,88,.591,36,56,.643,16,32,.500,10,13,.769,130,42,87,.483,31,50,.620,11,37,.297,18,20,.900,113
143,OKC,2024-12-29,130,,MEM,W 130-106,240,52,103,.505,38,59,.644,14,44,.318,12,12,1.000,130,37,97,.381,23,46,.500,14,51,.275,18,21,.857,106
144,BOS,2024-12-04,130,,DET,W 130-120,240,45,94,.479,24,41,.585,21,53,.396,19,25,.760,130,43,84,.512,23,45,.511,20,39,.513,14,18,.778,120
145,HOU,2024-11-20,130,,IND,W 130-113,240,47,102,.461,35,66,.530,12,36,.333,24,33,.727,130,44,83,.530,39,61,.639,5,22,.227,20,25,.800,113
146,TOR,2024-11-18,130,,IND,W 130-119,240,48,82,.585,34,53,.642,14,29,.483,20,28,.714,130,44,99,.444,29,59,.492,15,40,.375,16,20,.800,119
147,DEN,2025-03-28,129,,UTA,W 129-93,240,48,83,.578,37,54,.685,11,29,.379,22,28,.786,129,33,93,.355,26,53,.491,7,40,.175,20,24,.833,93
148,PHO,2025-03-17,129,,TOR,W 129-89,240,47,92,.511,27,53,.509,20,39,.513,15,15,1.000,129,31,87,.356,21,52,.404,10,35,.286,17,23,.739,89
149,SAS,2025-03-10,129,,DAL,L 129-133,240,49,94,.521,32,53,.604,17,41,.415,14,24,.583,129,47,88,.534,35,50,.700,12,38,.316,27,30,.900,133
150,CLE,2025-02-23,129,,MEM,W 129-123,240,46,99,.465,33,52,.635,13,47,.277,24,35,.686,129,42,92,.457,27,53,.509,15,39,.385,24,31,.774,123
151,IND,2025-02-23,129,,LAC,W 129-111,240,46,84,.548,34,48,.708,12,36,.333,25,27,.926,129,38,85,.447,28,45,.622,10,40,.250,25,33,.758,111
152,DEN,2025-02-20,129,,CHO,W 129-115,240,49,98,.500,30,55,.545,19,43,.442,12,16,.750,129,43,99,.434,28,62,.452,15,37,.405,14,17,.824,115
153,CHI,2025-01-27,129,,DEN,W 129-121,240,49,98,.500,25,45,.556,24,53,.453,7,8,.875,129,52,100,.520,46,73,.630,6,27,.222,11,11,1.000,121
154,CLE,2025-01-08,129,,OKC,W 129-122,240,47,90,.522,32,54,.593,15,36,.417,20,27,.741,129,48,90,.533,37,59,.627,11,31,.355,15,17,.882,122
155,IND,2025-01-08,129,,CHI,W 129-113,240,52,100,.520,42,71,.592,10,29,.345,15,24,.625,129,44,86,.512,32,51,.627,12,35,.343,13,19,.684,113
156,NOP,2024-12-22,129,,DEN,L 129-132 (OT),265,50,108,.463,38,68,.559,12,40,.300,17,23,.739,129,49,97,.505,39,64,.609,10,33,.303,24,32,.750,132
157,SAC,2024-12-16,129,,DEN,L 129-130,240,49,102,.480,37,67,.552,12,35,.343,19,20,.950,129,51,102,.500,41,74,.554,10,28,.357,18,24,.750,130
158,CHI,2024-11-29,129,,BOS,L 129-138,240,48,93,.516,28,42,.667,20,51,.392,13,16,.813,129,49,98,.500,26,44,.591,23,54,.426,17,23,.739,138
159,DAL,2024-11-27,129,,NYK,W 129-114,240,48,85,.565,31,52,.596,17,33,.515,16,21,.762,129,40,86,.465,33,57,.579,7,29,.241,27,30,.900,114
160,MIL,2024-11-22,129,,IND,W 129-117,240,48,90,.533,31,54,.574,17,36,.472,16,20,.800,129,43,91,.473,32,57,.561,11,34,.324,20,27,.741,117
161,ATL,2024-11-15,129,,WAS,W 129-117,240,46,98,.469,34,61,.557,12,37,.324,25,30,.833,129,43,106,.406,28,63,.444,15,43,.349,16,21,.762,117
162,DEN,2024-11-02,129,,UTA,W 129-103,240,48,99,.485,32,67,.478,16,32,.500,17,23,.739,129,32,77,.416,19,35,.543,13,42,.310,26,31,.839,103
163,SAC,2025-03-27,128,,POR,W 128-107,240,48,74,.649,38,47,.809,10,27,.370,22,27,.815,128,35,88,.398,19,38,.500,16,50,.320,21,26,.808,107
164,NYK,2025-03-25,128,,DAL,W 128-113,240,53,89,.596,43,63,.683,10,26,.385,12,18,.667,128,43,80,.538,37,61,.607,6,19,.316,21,25,.840,113
165,LAC,2025-03-21,128,,MEM,W 128-108,240,45,78,.577,28,44,.636,17,34,.500,21,26,.808,128,40,95,.421,21,46,.457,19,49,.388,9,13,.692,108
166,POR,2025-03-21,128,,DEN,W 128-109,240,47,87,.540,33,52,.635,14,35,.400,20,25,.800,128,38,76,.500,29,50,.580,9,26,.346,24,28,.857,109
167,SAS,2025-03-21,128,,PHI,W 128-120,240,47,89,.528,28,50,.560,19,39,.487,15,18,.833,128,46,81,.568,32,44,.727,14,37,.378,14,20,.700,120
168,UTA,2025-03-19,128,,WAS,W 128-112,240,50,89,.562,33,47,.702,17,42,.405,11,18,.611,128,43,93,.462,31,48,.646,12,45,.267,14,18,.778,112
169,MIN,2025-03-16,128,,UTA,W 128-102,240,48,97,.495,34,54,.630,14,43,.326,18,26,.692,128,39,90,.433,27,52,.519,12,38,.316,12,15,.800,102
170,BOS,2025-03-05,128,,POR,W 128-118,240,45,97,.464,22,43,.512,23,54,.426,15,17,.882,128,45,90,.500,29,50,.580,16,40,.400,12,17,.706,118
171,MEM,2025-03-01,128,,SAS,L 128-130,240,50,95,.526,39,57,.684,11,38,.289,17,20,.850,128,50,96,.521,36,60,.600,14,36,.389,16,22,.727,130
172,GSW,2025-02-25,128,,CHO,W 128-92,240,49,100,.490,34,58,.586,15,42,.357,15,18,.833,128,33,89,.371,22,49,.449,11,40,.275,15,18,.833,92
173,OKC,2025-02-24,128,,MIN,L 128-131 (OT),265,45,106,.425,30,57,.526,15,49,.306,23,29,.793,128,44,97,.454,35,65,.538,9,32,.281,34,39,.872,131
174,LAC,2025-02-12,128,,MEM,W 128-114,240,47,93,.505,34,58,.586,13,35,.371,21,22,.955,128,44,89,.494,26,53,.491,18,36,.500,8,15,.533,114
175,CLE,2025-02-10,128,,MIN,W 128-107,240,48,94,.511,31,51,.608,17,43,.395,15,20,.750,128,36,90,.400,24,51,.471,12,39,.308,23,30,.767,107
176,DAL,2025-02-10,128,,SAC,L 128-129 (OT),265,49,95,.516,34,58,.586,15,37,.405,15,24,.625,128,53,96,.552,44,70,.629,9,26,.346,14,19,.737,129
177,MEM,2025-02-03,128,,SAS,W 128-109,240,48,99,.485,34,63,.540,14,36,.389,18,20,.900,128,41,91,.451,29,55,.527,12,36,.333,15,20,.750,109
178,MIA,2025-01-19,128,,SAS,W 128-107,240,50,95,.526,32,62,.516,18,33,.545,10,10,1.000,128,41,91,.451,26,51,.510,15,40,.375,10,16,.625,107
179,CHI,2024-12-02,128,,BRK,W 128-102,240,48,92,.522,32,45,.711,16,47,.340,16,19,.842,128,38,95,.400,24,53,.453,14,42,.333,12,15,.800,102
180,CLE,2024-11-20,128,,NOP,W 128-100,240,49,93,.527,31,51,.608,18,42,.429,12,14,.857,128,39,92,.424,31,61,.508,8,31,.258,14,22,.636,100
181,CLE,2024-11-17,128,,CHO,W 128-114,240,44,77,.571,31,47,.660,13,30,.433,27,28,.964,128,42,103,.408,22,51,.431,20,52,.385,10,12,.833,114
182,LAL,2024-11-13,128,,MEM,W 128-123,240,43,85,.506,23,44,.523,20,41,.488,22,32,.688,128,42,89,.472,30,56,.536,12,33,.364,27,33,.818,123
183,MEM,2024-11-08,128,,WAS,W 128-104,240,46,97,.474,32,54,.593,14,43,.326,22,25,.880,128,38,93,.409,29,58,.500,9,35,.257,19,23,.826,104
184,OKC,2024-10-27,128,,ATL,W 128-104,240,44,89,.494,28,49,.571,16,40,.400,24,32,.750,128,36,91,.396,26,60,.433,10,31,.323,22,29,.759,104
185,HOU,2024-10-25,128,,MEM,W 128-108,240,43,98,.439,26,55,.473,17,43,.395,25,36,.694,128,38,91,.418,28,63,.444,10,28,.357,22,36,.611,108
186,CLE,2025-03-30,127,,LAC,W 127-122,240,47,93,.505,32,48,.667,15,45,.333,18,23,.783,127,45,93,.484,29,52,.558,16,41,.390,16,22,.727,122
187,MEM,2025-03-29,127,,LAL,L 127-134,240,50,95,.526,36,63,.571,14,32,.438,13,18,.722,127,45,89,.506,26,46,.565,19,43,.442,25,27,.926,134
188,DEN,2025-03-26,127,,MIL,W 127-117,240,49,90,.544,33,53,.623,16,37,.432,13,22,.591,127,46,89,.517,30,52,.577,16,37,.432,9,13,.692,117
189,PHO,2025-03-19,127,,CHI,W 127-121,240,47,96,.490,32,56,.571,15,40,.375,18,20,.900,127,49,90,.544,34,52,.654,15,38,.395,8,12,.667,121
190,NOP,2025-03-11,127,,LAC,W 127-120,240,47,85,.553,30,54,.556,17,31,.548,16,18,.889,127,46,92,.500,32,50,.640,14,42,.333,14,18,.778,120
191,OKC,2025-03-10,127,,DEN,L 127-140,240,47,100,.470,28,53,.528,19,47,.404,14,16,.875,127,52,86,.605,34,54,.630,18,32,.563,18,20,.900,140
192,OKC,2025-03-09,127,,DEN,W 127-103,240,46,94,.489,33,56,.589,13,38,.342,22,25,.880,127,40,97,.412,28,57,.491,12,40,.300,11,20,.550,103
193,SAC,2025-03-07,127,,SAS,W 127-109,240,49,96,.510,32,58,.552,17,38,.447,12,19,.632,127,40,87,.460,24,45,.533,16,42,.381,13,23,.565,109
194,SAS,2025-03-04,127,,BRK,W 127-113,240,52,95,.547,34,56,.607,18,39,.462,5,10,.500,127,39,86,.453,22,36,.611,17,50,.340,18,21,.857,113
195,IND,2025-03-02,127,,CHI,W 127-112,240,48,87,.552,29,43,.674,19,44,.432,12,18,.667,127,44,88,.500,34,55,.618,10,33,.303,14,18,.778,112
196,TOR,2025-02-23,127,,PHO,W 127-109,240,43,88,.489,23,53,.434,20,35,.571,21,30,.700,127,43,85,.506,36,57,.632,7,28,.250,16,22,.727,109
197,IND,2025-02-20,127,,MEM,W 127-113,240,46,91,.505,29,46,.630,17,45,.378,18,22,.818,127,41,99,.414,29,60,.483,12,39,.308,19,22,.864,113
198,MIN,2025-02-06,127,,HOU,W 127-114,240,45,94,.479,29,55,.527,16,39,.410,21,24,.875,127,41,84,.488,29,53,.547,12,31,.387,20,28,.714,114
199,MIN,2025-02-05,127,,CHI,W 127-108,240,42,98,.429,22,51,.431,20,47,.426,23,28,.821,127,40,83,.482,28,47,.596,12,36,.333,16,22,.727,108
200,DET,2025-02-02,127,,CHI,W 127-119,240,54,99,.545,44,69,.638,10,30,.333,9,13,.692,127,41,89,.461,22,37,.595,19,52,.365,18,20,.900,119
201,POR,2025-02-01,127,,PHO,W 127-108,240,46,89,.517,37,58,.638,9,31,.290,26,31,.839,127,38,84,.452,28,51,.549,10,33,.303,22,26,.846,108
202,LAC,2025-01-25,127,,MIL,W 127-117,240,44,97,.454,33,63,.524,11,34,.324,28,28,1.000,127,37,79,.468,24,44,.545,13,35,.371,30,34,.882,117
203,OKC,2025-01-19,127,,BRK,W 127-101,240,48,87,.552,29,44,.659,19,43,.442,12,13,.923,127,37,87,.425,25,44,.568,12,43,.279,15,19,.789,101
204,LAC,2024-12-03,127,,POR,W 127-105,240,47,85,.553,28,48,.583,19,37,.514,14,17,.824,127,41,80,.513,31,51,.608,10,29,.345,13,16,.813,105
205,PHO,2024-11-26,127,,LAL,W 127-100,240,51,99,.515,34,57,.596,17,42,.405,8,10,.800,127,37,85,.435,29,51,.569,8,34,.235,18,25,.720,100
206,MIL,2024-11-13,127,,DET,W 127-120 (OT),265,45,95,.474,30,60,.500,15,35,.429,22,25,.880,127,46,100,.460,28,62,.452,18,38,.474,10,13,.769,120
207,SAC,2024-11-13,127,,PHO,W 127-104,240,50,78,.641,35,50,.700,15,28,.536,12,17,.706,127,36,97,.371,23,54,.426,13,43,.302,19,26,.731,104
208,MIN,2024-11-08,127,,POR,W 127-102,240,47,97,.485,25,47,.532,22,50,.440,11,14,.786,127,39,91,.429,33,66,.500,6,25,.240,18,24,.750,102
209,HOU,2024-11-06,127,,SAS,W 127-100,240,54,96,.563,44,69,.638,10,27,.370,9,15,.600,127,37,83,.446,23,47,.489,14,36,.389,12,16,.750,100
210,DAL,2024-11-04,127,,IND,L 127-134,240,46,89,.517,31,53,.585,15,36,.417,20,25,.800,127,54,95,.568,41,63,.651,13,32,.406,13,20,.650,134
211,TOR,2025-04-09,126,,CHO,W 126-96,240,49,104,.471,30,52,.577,19,52,.365,9,12,.750,126,36,82,.439,25,47,.532,11,35,.314,13,16,.813,96
212,MIL,2025-03-15,126,,IND,W 126-119,240,43,79,.544,28,42,.667,15,37,.405,25,26,.962,126,46,96,.479,29,53,.547,17,43,.395,10,13,.769,119
213,MIL,2025-03-13,126,,LAL,W 126-106,240,41,86,.477,24,46,.522,17,40,.425,27,33,.818,126,38,87,.437,23,47,.489,15,40,.375,15,18,.833,106
214,SAS,2025-03-12,126,,DAL,W 126-116,240,50,94,.532,39,59,.661,11,35,.314,15,16,.938,126,45,81,.556,32,49,.653,13,32,.406,13,17,.765,116
215,PHI,2025-03-09,126,,UTA,W 126-122,240,43,96,.448,27,49,.551,16,47,.340,24,25,.960,126,39,93,.419,21,47,.447,18,46,.391,26,31,.839,122
216,MIN,2025-03-04,126,,PHI,W 126-112,240,46,81,.568,28,41,.683,18,40,.450,16,17,.941,126,42,86,.488,33,54,.611,9,32,.281,19,27,.704,112
217,PHI,2025-03-01,126,,GSW,W 126-119,240,45,85,.529,26,52,.500,19,33,.576,17,28,.607,126,46,100,.460,34,58,.586,12,42,.286,15,19,.789,119
218,GSW,2025-02-23,126,,DAL,W 126-102,240,47,98,.480,35,58,.603,12,40,.300,20,23,.870,126,38,82,.463,25,50,.500,13,32,.406,13,19,.684,102
219,LAC,2025-01-15,126,,BRK,W 126-67,240,43,79,.544,31,47,.660,12,32,.375,28,30,.933,126,25,83,.301,20,55,.364,5,28,.179,12,22,.545,67
220,DEN,2025-01-08,126,,LAC,W 126-103,240,49,89,.551,32,54,.593,17,35,.486,11,17,.647,126,30,80,.375,19,42,.452,11,38,.289,32,40,.800,103
221,IND,2025-01-04,126,,PHO,W 126-108,240,46,96,.479,31,56,.554,15,40,.375,19,21,.905,126,38,78,.487,26,48,.542,12,30,.400,20,21,.952,108
222,POR,2024-12-28,126,,DAL,W 126-122,240,46,92,.500,35,66,.530,11,26,.423,23,29,.793,126,43,89,.483,28,51,.549,15,38,.395,21,26,.808,122
223,CLE,2024-12-21,126,,PHI,W 126-99,240,48,90,.533,26,47,.553,22,43,.512,8,15,.533,126,34,85,.400,23,51,.451,11,34,.324,20,27,.741,99
224,POR,2024-12-19,126,,DEN,W 126-124,240,45,97,.464,29,51,.569,16,46,.348,20,24,.833,126,47,87,.540,32,53,.604,15,34,.441,15,21,.714,124
225,UTA,2024-12-13,126,,PHO,L 126-134,240,43,77,.558,21,38,.553,22,39,.564,18,22,.818,126,47,89,.528,25,44,.568,22,45,.489,18,20,.900,134
226,CLE,2024-12-05,126,,DEN,W 126-114,240,47,94,.500,25,46,.543,22,48,.458,10,16,.625,126,46,96,.479,40,72,.556,6,24,.250,16,22,.727,114
227,NOP,2024-12-05,126,,PHO,W 126-124,240,47,95,.495,33,59,.559,14,36,.389,18,25,.720,126,43,85,.506,26,40,.650,17,45,.378,21,26,.808,124
228,LAC,2024-12-01,126,,DEN,W 126-122,240,43,90,.478,25,51,.490,18,39,.462,22,27,.815,126,51,88,.580,41,64,.641,10,24,.417,10,19,.526,122
229,BOS,2024-11-25,126,,LAC,W 126-94,240,45,88,.511,23,37,.622,22,51,.431,14,20,.700,126,39,90,.433,32,64,.500,7,26,.269,9,13,.692,94
230,SAS,2024-11-21,126,,UTA,W 126-118,240,41,88,.466,32,56,.571,9,32,.281,35,46,.761,126,41,98,.418,28,53,.528,13,45,.289,23,26,.885,118
231,BOS,2024-11-16,126,,TOR,W 126-123 (OT),265,44,99,.444,23,38,.605,21,61,.344,17,19,.895,126,50,98,.510,41,75,.547,9,23,.391,14,21,.667,123
232,SAC,2024-11-15,126,,MIN,L 126-130 (OT),265,48,96,.500,36,59,.610,12,37,.324,18,20,.900,126,48,101,.475,28,52,.538,20,49,.408,14,16,.875,130
233,OKC,2024-11-08,126,,HOU,W 126-107,240,46,90,.511,32,53,.604,14,37,.378,20,23,.870,126,39,90,.433,28,60,.467,11,30,.367,18,26,.692,107
234,CHI,2024-11-04,126,,UTA,L 126-135,240,45,95,.474,31,58,.534,14,37,.378,22,25,.880,126,48,89,.539,32,53,.604,16,36,.444,23,30,.767,135
235,SAS,2025-04-13,125,,TOR,W 125-118,240,43,84,.512,32,52,.615,11,32,.344,28,32,.875,125,46,97,.474,32,58,.552,14,39,.359,12,16,.750,118
236,MEM,2025-04-10,125,,MIN,L 125-141,240,46,89,.517,28,53,.528,18,36,.500,15,21,.714,125,48,87,.552,28,43,.651,20,44,.455,25,28,.893,141
237,HOU,2025-04-04,125,,OKC,W 125-111,240,45,92,.489,32,63,.508,13,29,.448,22,26,.846,125,43,89,.483,30,54,.556,13,35,.371,12,15,.800,111
238,MEM,2025-04-01,125,,GSW,L 125-134,240,44,92,.478,26,48,.542,18,44,.409,19,22,.864,125,42,99,.424,20,43,.465,22,56,.393,28,28,1.000,134
239,OKC,2025-03-27,125,,MEM,W 125-104,240,44,90,.489,31,59,.525,13,31,.419,24,28,.857,125,33,79,.418,17,37,.459,16,42,.381,22,23,.957,104
240,LAL,2025-03-17,125,,SAS,W 125-109,240,44,90,.489,25,42,.595,19,48,.396,18,24,.750,125,41,88,.466,26,50,.520,15,38,.395,12,14,.857,109
241,DAL,2025-03-16,125,,PHI,L 125-130,240,46,87,.529,36,53,.679,10,34,.294,23,30,.767,125,48,92,.522,34,56,.607,14,36,.389,20,24,.833,130
242,MEM,2025-03-15,125,,MIA,W 125-91,240,51,92,.554,39,61,.639,12,31,.387,11,12,.917,125,35,88,.398,26,51,.510,9,37,.243,12,15,.800,91
243,DET,2025-03-13,125,,WAS,L 125-129,240,39,85,.459,29,55,.527,10,30,.333,37,43,.860,125,43,90,.478,23,45,.511,20,45,.444,23,27,.852,129
244,WAS,2025-03-05,125,,UTA,W 125-122,240,42,95,.442,25,48,.521,17,47,.362,24,29,.828,125,47,101,.465,33,61,.541,14,40,.350,14,20,.700,122
245,CHI,2025-02-28,125,,TOR,W 125-115 (OT),265,45,101,.446,32,52,.615,13,49,.265,22,25,.880,125,43,103,.417,30,66,.455,13,37,.351,16,20,.800,115
246,MIA,2025-02-28,125,,IND,W 125-120,240,48,84,.571,31,52,.596,17,32,.531,12,13,.923,125,47,88,.534,26,49,.531,21,39,.538,5,8,.625,120
247,PHO,2025-02-28,125,,NOP,W 125-108,240,47,79,.595,26,39,.667,21,40,.525,10,13,.769,125,44,87,.506,33,59,.559,11,28,.393,9,15,.600,108
248,DET,2025-02-07,125,,PHI,W 125-112,240,44,97,.454,27,53,.509,17,44,.386,20,26,.769,125,41,83,.494,28,52,.538,13,31,.419,17,20,.850,112
249,ATL,2025-02-05,125,,SAS,L 125-126,240,48,91,.527,32,49,.653,16,42,.381,13,18,.722,125,51,101,.505,39,64,.609,12,37,.324,12,16,.750,126
250,DEN,2025-02-03,125,,NOP,W 125-113,240,46,92,.500,34,59,.576,12,33,.364,21,26,.808,125,38,88,.432,20,50,.400,18,38,.474,19,22,.864,113
251,OKC,2025-02-03,125,,MIL,W 125-96,240,51,99,.515,35,58,.603,16,41,.390,7,8,.875,125,35,93,.376,22,54,.407,13,39,.333,13,21,.619,96
252,POR,2025-01-28,125,,MIL,W 125-112,240,45,88,.511,33,60,.550,12,28,.429,23,28,.821,125,44,87,.506,33,52,.635,11,35,.314,13,18,.722,112
253,MIA,2025-01-27,125,,ORL,W 125-119 (2OT),290,48,92,.522,33,51,.647,15,41,.366,14,21,.667,125,45,98,.459,31,59,.525,14,39,.359,15,25,.600,119
254,MEM,2025-01-25,125,,UTA,W 125-103,240,43,84,.512,29,46,.630,14,38,.368,25,34,.735,125,39,92,.424,27,45,.600,12,47,.255,13,16,.813,103
255,MIL,2025-01-23,125,,MIA,W 125-96,240,46,98,.469,28,58,.483,18,40,.450,15,20,.750,125,34,92,.370,22,41,.537,12,51,.235,16,21,.762,96
256,MIN,2025-01-11,125,,MEM,L 125-127,240,47,83,.566,30,41,.732,17,42,.405,14,19,.737,125,48,108,.444,32,67,.478,16,41,.390,15,19,.789,127
257,WAS,2025-01-01,125,,CHI,W 125-107,240,49,99,.495,32,63,.508,17,36,.472,10,12,.833,125,41,92,.446,27,45,.600,14,47,.298,11,14,.786,107
258,BOS,2024-12-31,125,,TOR,W 125-71,240,47,87,.540,25,44,.568,22,43,.512,9,15,.600,125,27,86,.314,17,46,.370,10,40,.250,7,11,.636,71
259,PHO,2024-12-21,125,,DET,L 125-133,240,45,78,.577,31,49,.633,14,29,.483,21,23,.913,125,49,89,.551,30,50,.600,19,39,.487,16,22,.727,133
260,DET,2024-12-16,125,,MIA,W 125-124 (OT),265,44,90,.489,24,50,.480,20,40,.500,17,23,.739,125,45,99,.455,33,56,.589,12,43,.279,22,24,.917,124
261,NYK,2024-12-05,125,,CHO,W 125-101,240,41,76,.539,23,43,.535,18,33,.545,25,32,.781,125,40,89,.449,25,50,.500,15,39,.385,6,10,.600,101
262,SAC,2024-12-01,125,,SAS,L 125-127,240,47,101,.465,35,69,.507,12,32,.375,19,24,.792,125,42,82,.512,19,36,.528,23,46,.500,20,24,.833,127
263,MIL,2024-11-23,125,,CHO,W 125-119,240,43,89,.483,25,52,.481,18,37,.486,21,26,.808,125,41,100,.410,22,53,.415,19,47,.404,18,21,.857,119
264,HOU,2024-11-15,125,,LAC,W 125-104,240,46,95,.484,27,51,.529,19,44,.432,14,18,.778,125,34,90,.378,24,50,.480,10,40,.250,26,33,.788,104
265,NOP,2024-11-01,125,,IND,W 125-118,240,49,101,.485,37,70,.529,12,31,.387,15,19,.789,125,46,89,.517,30,51,.588,16,38,.421,10,13,.769,118
266,TOR,2024-11-01,125,,LAL,L 125-131,240,52,107,.486,42,72,.583,10,35,.286,11,13,.846,125,42,88,.477,31,56,.554,11,32,.344,36,41,.878,131
267,TOR,2024-10-28,125,,DEN,L 125-127 (OT),265,49,109,.450,39,74,.527,10,35,.286,17,21,.810,125,47,96,.490,38,76,.500,9,20,.450,24,30,.800,127
268,POR,2024-10-27,125,,NOP,W 125-103,240,43,93,.462,29,58,.500,14,35,.400,25,32,.781,125,38,88,.432,30,59,.508,8,29,.276,19,24,.792,103
269,ATL,2024-10-25,125,,CHO,W 125-120,240,39,81,.481,25,43,.581,14,38,.368,33,38,.868,125,37,96,.385,16,45,.356,21,51,.412,25,31,.806,120
270,DAL,2025-04-11,124,,TOR,W 124-102,240,49,89,.551,34,55,.618,15,34,.441,11,17,.647,124,40,100,.400,29,61,.475,11,39,.282,11,18,.611,102
271,BOS,2025-04-06,124,,WAS,W 124-90,240,48,98,.490,24,46,.522,24,52,.462,4,6,.667,124,35,86,.407,23,41,.561,12,45,.267,8,10,.800,90
272,LAL,2025-04-04,124,,NOP,W 124-108,240,41,79,.519,25,38,.658,16,41,.390,26,28,.929,124,40,82,.488,26,48,.542,14,34,.412,14,22,.636,108
273,CLE,2025-04-02,124,,NYK,W 124-105,240,50,94,.532,38,57,.667,12,37,.324,12,14,.857,124,40,90,.444,29,54,.537,11,36,.306,14,17,.824,105
274,MIL,2025-03-30,124,,ATL,L 124-145,240,39,82,.476,27,47,.574,12,35,.343,34,43,.791,124,50,94,.532,33,46,.717,17,48,.354,28,35,.800,145
275,MIN,2025-03-28,124,,PHO,W 124-109,240,47,89,.528,28,50,.560,19,39,.487,11,13,.846,124,41,79,.519,23,42,.548,18,37,.486,9,13,.692,109
276,CLE,2025-03-27,124,,SAS,W 124-116,240,46,99,.465,29,51,.569,17,48,.354,15,18,.833,124,43,106,.406,29,63,.460,14,43,.326,16,21,.762,116
277,ATL,2025-03-22,124,,GSW,W 124-115,240,49,86,.570,34,50,.680,15,36,.417,11,18,.611,124,39,84,.464,23,46,.500,16,38,.421,21,26,.808,115
278,MEM,2025-03-14,124,,CLE,L 124-133,240,48,97,.495,37,61,.607,11,36,.306,17,21,.810,124,44,88,.500,25,37,.676,19,51,.373,26,33,.788,133
279,ATL,2025-03-06,124,,IND,W 124-118,240,50,94,.532,40,64,.625,10,30,.333,14,18,.778,124,44,91,.484,30,52,.577,14,39,.359,16,17,.941,118
280,UTA,2025-02-22,124,,HOU,W 124-115,240,49,98,.500,36,58,.621,13,40,.325,13,27,.481,124,44,100,.440,27,57,.474,17,43,.395,10,18,.556,115
281,LAL,2025-02-08,124,,IND,W 124-117,240,46,88,.523,35,55,.636,11,33,.333,21,23,.913,124,37,87,.425,25,49,.510,12,38,.316,31,32,.969,117
282,WAS,2025-02-07,124,,CLE,L 124-134,240,46,94,.489,30,50,.600,16,44,.364,16,25,.640,124,48,94,.511,32,56,.571,16,38,.421,22,24,.917,134
283,NYK,2025-02-03,124,,HOU,W 124-118,240,47,93,.505,41,67,.612,6,26,.231,24,30,.800,124,48,104,.462,40,76,.526,8,28,.286,14,15,.933,118
284,DEN,2025-01-10,124,,BRK,W 124-105,240,45,87,.517,36,63,.571,9,24,.375,25,33,.758,124,38,90,.422,24,45,.533,14,45,.311,15,19,.789,105
285,NOP,2024-12-27,124,,MEM,L 124-132,240,43,96,.448,32,58,.552,11,38,.289,27,29,.931,124,42,89,.472,25,48,.521,17,41,.415,31,35,.886,132
286,CLE,2024-12-23,124,,UTA,W 124-113,240,43,91,.473,23,45,.511,20,46,.435,18,23,.783,124,38,92,.413,19,48,.396,19,44,.432,18,26,.692,113
287,CLE,2024-12-20,124,,MIL,W 124-101,240,46,91,.505,26,44,.591,20,47,.426,12,14,.857,124,40,85,.471,30,58,.517,10,27,.370,11,18,.611,101
288,SAS,2024-12-05,124,,CHI,L 124-139,240,44,95,.463,36,67,.537,8,28,.286,28,39,.718,124,52,90,.578,35,53,.660,17,37,.459,18,23,.783,139
289,ATL,2024-12-02,124,,NOP,W 124-112,240,49,96,.510,39,58,.672,10,38,.263,16,20,.800,124,44,100,.440,31,58,.534,13,42,.310,11,17,.647,112
290,MIL,2024-11-30,124,,WAS,W 124-114,240,44,86,.512,28,51,.549,16,35,.457,20,25,.800,124,41,87,.471,32,55,.582,9,32,.281,23,24,.958,114
291,CLE,2024-11-27,124,,ATL,L 124-135,240,44,95,.463,29,47,.617,15,48,.313,21,28,.750,124,46,97,.474,26,55,.473,20,42,.476,23,25,.920,135
292,LAL,2024-11-19,124,,UTA,W 124-118,240,42,76,.553,28,45,.622,14,31,.452,26,36,.722,124,45,90,.500,33,54,.611,12,36,.333,16,19,.842,118
293,NYK,2024-11-15,124,,BRK,W 124-122,240,44,83,.530,31,45,.689,13,38,.342,23,28,.821,124,39,89,.438,20,43,.465,19,46,.413,25,28,.893,122
294,DEN,2024-11-06,124,,OKC,W 124-122,240,42,89,.472,26,51,.510,16,38,.421,24,33,.727,124,44,100,.440,28,60,.467,16,40,.400,18,23,.783,122
295,GSW,2024-10-29,124,,NOP,W 124-106,240,46,97,.474,25,51,.490,21,46,.457,11,13,.846,124,40,74,.541,31,52,.596,9,22,.409,17,24,.708,106
296,MEM,2024-10-26,124,,ORL,W 124-111,240,46,86,.535,33,52,.635,13,34,.382,19,24,.792,124,37,87,.425,20,39,.513,17,48,.354,20,28,.714,111
297,UTA,2024-10-23,124,,MEM,L 124-126,240,40,85,.471,30,59,.508,10,26,.385,34,45,.756,124,43,91,.473,26,46,.565,17,45,.378,23,32,.719,126
298,BOS,2025-04-04,123,,PHO,W 123-103,240,45,87,.517,31,48,.646,14,39,.359,19,22,.864,123,41,93,.441,29,56,.518,12,37,.324,9,11,.818,103
299,MIN,2025-03-30,123,,DET,W 123-104,240,44,93,.473,32,62,.516,12,31,.387,23,31,.742,123,34,95,.358,22,57,.386,12,38,.316,24,32,.750,104
300,DAL,2025-03-21,123,,DET,W 123-117,240,42,80,.525,30,46,.652,12,34,.353,27,36,.750,123,46,98,.469,35,67,.522,11,31,.355,14,19,.737,117
301,PHO,2025-03-21,123,,CLE,W 123-112,240,48,92,.522,29,50,.580,19,42,.452,8,8,1.000,123,42,94,.447,25,49,.510,17,45,.378,11,14,.786,112
302,SAC,2025-03-19,123,,CLE,W 123-119,240,46,91,.505,30,56,.536,16,35,.457,15,16,.938,123,46,84,.548,33,50,.660,13,34,.382,14,18,.778,119
303,LAC,2025-03-16,123,,CHO,W 123-88,240,45,93,.484,32,67,.478,13,26,.500,20,23,.870,123,37,94,.394,31,61,.508,6,33,.182,8,9,.889,88
304,DEN,2025-03-15,123,,WAS,L 123-126,240,48,95,.505,36,61,.590,12,34,.353,15,17,.882,123,46,95,.484,27,50,.540,19,45,.422,15,17,.882,126
305,ATL,2025-03-12,123,,CHO,W 123-110,240,37,88,.420,23,52,.442,14,36,.389,35,39,.897,123,40,88,.455,26,53,.491,14,35,.400,16,18,.889,110
306,DET,2025-03-11,123,,WAS,W 123-103,240,48,104,.462,32,66,.485,16,38,.421,11,15,.733,123,37,92,.402,24,53,.453,13,39,.333,16,20,.800,103
307,BOS,2025-03-06,123,,PHI,W 123-105,240,46,91,.505,27,43,.628,19,48,.396,12,13,.923,123,40,95,.421,25,56,.446,15,39,.385,10,12,.833,105
308,ORL,2025-03-06,123,,CHI,L 123-125,240,40,87,.460,31,54,.574,9,33,.273,34,40,.850,123,43,86,.500,28,46,.609,15,40,.375,24,30,.800,125
309,LAC,2025-03-05,123,,DET,W 123-115,240,44,80,.550,31,56,.554,13,24,.542,22,26,.846,123,45,86,.523,34,51,.667,11,35,.314,14,19,.737,115
310,MIN,2025-02-23,123,,OKC,L 123-130,240,39,89,.438,21,44,.477,18,45,.400,27,28,.964,123,48,86,.558,29,51,.569,19,35,.543,15,20,.750,130
311,SAC,2025-02-08,123,,NOP,W 123-118,240,43,91,.473,32,50,.640,11,41,.268,26,33,.788,123,43,90,.478,29,54,.537,14,36,.389,18,25,.720,118
312,CHO,2025-01-25,123,,NOP,W 123-92,240,42,84,.500,21,34,.618,21,50,.420,18,25,.720,123,32,84,.381,24,53,.453,8,31,.258,20,26,.769,92
313,OKC,2025-01-22,123,,UTA,W 123-114,240,44,95,.463,32,56,.571,12,39,.308,23,25,.920,123,42,90,.467,28,53,.528,14,37,.378,16,24,.667,114
314,SAC,2025-01-22,123,,GSW,W 123-117,240,41,81,.506,30,51,.588,11,30,.367,30,32,.938,123,43,92,.467,21,44,.477,22,48,.458,9,13,.692,117
315,NOP,2025-01-20,123,,UTA,W 123-119 (OT),265,41,92,.446,26,51,.510,15,41,.366,26,29,.897,123,42,106,.396,31,60,.517,11,46,.239,24,30,.800,119
316,MIL,2025-01-19,123,,PHI,W 123-109,240,43,87,.494,29,50,.580,14,37,.378,23,30,.767,123,39,86,.453,23,41,.561,16,45,.356,15,22,.682,109
317,SAC,2025-01-19,123,,WAS,W 123-100,240,46,95,.484,34,56,.607,12,39,.308,19,24,.792,123,32,89,.360,22,47,.468,10,42,.238,26,32,.813,100
318,CHI,2025-01-17,123,,CHO,L 123-125,240,48,95,.505,34,55,.618,14,40,.350,13,14,.929,123,48,96,.500,35,62,.565,13,34,.382,16,20,.800,125
319,WAS,2025-01-16,123,,PHO,L 123-130,240,46,92,.500,33,51,.647,13,41,.317,18,27,.667,123,44,85,.518,28,52,.538,16,33,.485,26,31,.839,130
320,DET,2025-01-11,123,,TOR,W 123-114,240,44,84,.524,25,51,.490,19,33,.576,16,21,.762,123,40,92,.435,24,54,.444,16,38,.421,18,27,.667,114
321,PHO,2025-01-09,123,,ATL,W 123-115,240,49,85,.576,36,52,.692,13,33,.394,12,15,.800,123,42,86,.488,27,54,.500,15,32,.469,16,17,.941,115
322,SAC,2025-01-06,123,,MIA,W 123-118 (2OT),290,45,108,.417,32,70,.457,13,38,.342,20,26,.769,123,43,102,.422,32,60,.533,11,42,.262,21,27,.778,118
323,OKC,2024-12-23,123,,WAS,W 123-105,240,47,106,.443,37,68,.544,10,38,.263,19,22,.864,123,36,91,.396,20,48,.417,16,43,.372,17,20,.850,105
324,WAS,2024-12-19,123,,CHO,W 123-114,240,41,83,.494,24,41,.585,17,42,.405,24,31,.774,123,43,106,.406,35,63,.556,8,43,.186,20,27,.741,114
325,BOS,2024-12-12,123,,DET,W 123-99,240,46,90,.511,26,42,.619,20,48,.417,11,13,.846,123,42,98,.429,35,61,.574,7,37,.189,8,10,.800,99
326,CHI,2024-12-06,123,,IND,L 123-132,240,46,97,.474,25,47,.532,21,50,.420,10,12,.833,123,52,92,.565,34,62,.548,18,30,.600,10,12,.833,132
327,MEM,2024-11-25,123,,POR,W 123-98,240,43,87,.494,31,59,.525,12,28,.429,25,34,.735,123,34,102,.333,26,56,.464,8,46,.174,22,28,.786,98
328,MIA,2024-11-24,123,,DAL,W 123-118 (OT),265,46,107,.430,32,66,.485,14,41,.341,17,27,.630,123,44,105,.419,34,65,.523,10,40,.250,20,25,.800,118
329,CHO,2024-11-21,123,,DET,W 123-121 (OT),265,44,93,.473,24,49,.490,20,44,.455,15,21,.714,123,42,99,.424,25,51,.490,17,48,.354,20,25,.800,121
330,GSW,2024-11-15,123,,MEM,W 123-118,240,43,98,.439,24,52,.462,19,46,.413,18,25,.720,123,42,103,.408,35,61,.574,7,42,.167,27,33,.818,118
331,NYK,2024-11-13,123,,CHI,L 123-124,240,48,94,.511,33,57,.579,15,37,.405,12,18,.667,123,44,82,.537,30,46,.652,14,36,.389,22,27,.815,124
332,DET,2024-11-12,123,,MIA,W 123-121 (OT),265,43,92,.467,30,56,.536,13,36,.361,24,28,.857,123,47,101,.465,30,56,.536,17,45,.378,10,13,.769,121
333,LAL,2024-11-10,123,,TOR,W 123-103,240,44,86,.512,32,49,.653,12,37,.324,23,28,.821,123,37,82,.451,27,53,.509,10,29,.345,19,22,.864,103
334,MIL,2024-11-07,123,,UTA,W 123-100,240,43,84,.512,28,49,.571,15,35,.429,22,30,.733,123,33,77,.429,16,36,.444,17,41,.415,17,18,.944,100
335,MEM,2024-10-28,123,,CHI,L 123-126,240,51,111,.459,37,68,.544,14,43,.326,7,13,.538,123,45,100,.450,20,47,.426,25,53,.472,11,17,.647,126
336,LAL,2024-10-25,123,,PHO,W 123-116,240,40,75,.533,26,48,.542,14,27,.519,29,39,.744,123,42,82,.512,25,45,.556,17,37,.459,15,17,.882,116
337,NYK,2024-10-25,123,,IND,W 123-98,240,44,84,.524,32,57,.561,12,27,.444,23,29,.793,123,41,83,.494,38,53,.717,3,30,.100,13,20,.650,98
338,NOP,2024-10-23,123,,CHI,W 123-111,240,45,97,.464,31,60,.517,14,37,.378,19,21,.905,123,42,86,.488,32,52,.615,10,34,.294,17,25,.680,111
339,LAC,2025-04-08,122,,SAS,W 122-117,240,48,93,.516,34,63,.540,14,30,.467,12,16,.750,122,45,85,.529,28,43,.651,17,42,.405,10,16,.625,117
340,MIA,2025-03-27,122,,ATL,W 122-112,240,44,82,.537,26,49,.531,18,33,.545,16,20,.800,122,43,83,.518,25,42,.595,18,41,.439,8,11,.727,112
341,DET,2025-03-25,122,,SAS,W 122-96,240,44,78,.564,29,47,.617,15,31,.484,19,25,.760,122,33,91,.363,19,47,.404,14,44,.318,16,20,.800,96
342,MIA,2025-03-23,122,,CHO,W 122-105,240,47,82,.573,35,53,.660,12,29,.414,16,20,.800,122,41,87,.471,30,54,.556,11,33,.333,12,13,.923,105
343,NYK,2025-03-22,122,,WAS,W 122-103,240,44,91,.484,31,56,.554,13,35,.371,21,27,.778,122,39,88,.443,28,52,.538,11,36,.306,14,19,.737,103
344,BRK,2025-03-16,122,,ATL,W 122-114,240,43,90,.478,26,55,.473,17,35,.486,19,23,.826,122,42,90,.467,31,53,.585,11,37,.297,19,24,.792,114
345,PHO,2025-03-14,122,,SAC,W 122-106,240,41,79,.519,17,36,.472,24,43,.558,16,19,.842,122,40,81,.494,32,49,.653,8,32,.250,18,20,.900,106
346,MEM,2025-03-12,122,,UTA,W 122-115,240,43,94,.457,23,50,.460,20,44,.455,16,21,.762,122,42,90,.467,30,56,.536,12,34,.353,19,28,.679,115
347,BOS,2025-01-29,122,,CHI,W 122-100,240,41,87,.471,23,43,.535,18,44,.409,22,27,.815,122,37,92,.402,22,43,.512,15,49,.306,11,12,.917,100
348,NYK,2025-01-29,122,,DEN,W 122-112,240,48,93,.516,34,59,.576,14,34,.412,12,18,.667,122,41,84,.488,31,56,.554,10,28,.357,20,23,.870,112
349,GSW,2025-01-18,122,,WAS,W 122-114,240,45,96,.469,31,55,.564,14,41,.341,18,24,.750,122,38,86,.442,16,41,.390,22,45,.489,16,23,.696,114
350,MIL,2025-01-15,122,,ORL,W 122-93,240,45,72,.625,38,60,.633,7,12,.583,25,35,.714,122,33,95,.347,21,49,.429,12,46,.261,15,21,.714,93
351,ATL,2025-01-14,122,,PHO,W 122-117,240,43,98,.439,26,57,.456,17,41,.415,19,26,.731,122,43,84,.512,30,49,.612,13,35,.371,18,27,.667,117
352,DAL,2025-01-03,122,,CLE,L 122-134,240,43,100,.430,31,56,.554,12,44,.273,24,30,.800,122,52,98,.531,37,58,.638,15,40,.375,15,20,.750,134
353,SAS,2024-12-31,122,,LAC,W 122-86,240,48,98,.490,39,58,.672,9,40,.225,17,19,.895,122,30,87,.345,19,46,.413,11,41,.268,15,18,.833,86
354,POR,2024-12-26,122,,UTA,W 122-120,240,45,89,.506,30,51,.588,15,38,.395,17,22,.773,122,41,86,.477,20,44,.455,21,42,.500,17,25,.680,120
355,MIA,2024-12-08,122,,CLE,W 122-113,240,41,86,.477,25,49,.510,16,37,.432,24,26,.923,122,41,86,.477,27,53,.509,14,33,.424,17,18,.944,113
356,WAS,2024-12-07,122,,DEN,W 122-113,240,45,93,.484,29,52,.558,16,41,.390,16,22,.727,122,46,95,.484,41,70,.586,5,25,.200,16,27,.593,113
357,TOR,2024-12-03,122,,IND,W 122-111,240,44,81,.543,31,48,.646,13,33,.394,21,29,.724,122,38,84,.452,26,54,.481,12,30,.400,23,28,.821,111
358,CLE,2024-11-24,122,,TOR,W 122-108,240,48,97,.495,32,56,.571,16,41,.390,10,14,.714,122,37,92,.402,25,53,.472,12,39,.308,22,34,.647,108
359,MIL,2024-11-20,122,,CHI,W 122-106,240,44,80,.550,31,44,.705,13,36,.361,21,31,.677,122,41,88,.466,24,43,.558,17,45,.378,7,7,1.000,106
360,PHO,2024-11-20,122,,NYK,L 122-138,240,45,92,.489,26,42,.619,19,50,.380,13,17,.765,122,50,86,.581,31,47,.660,19,39,.487,19,21,.905,138
361,POR,2024-11-12,122,,MIN,W 122-108,240,43,84,.512,25,52,.481,18,32,.563,18,20,.900,122,37,73,.507,24,38,.632,13,35,.371,21,23,.913,108
362,DEN,2024-11-10,122,,DAL,W 122-120,240,45,89,.506,31,60,.517,14,29,.483,18,26,.692,122,48,90,.533,38,57,.667,10,33,.303,14,19,.737,120
363,DET,2024-11-08,122,,ATL,W 122-121,240,44,86,.512,31,53,.585,13,33,.394,21,31,.677,122,44,97,.454,29,61,.475,15,36,.417,18,23,.783,121
364,NOP,2024-11-06,122,,CLE,L 122-131,240,42,88,.477,29,61,.475,13,27,.481,25,28,.893,122,52,96,.542,35,61,.574,17,35,.486,10,13,.769,131
365,SAC,2024-11-06,122,,TOR,W 122-107,240,42,90,.467,32,55,.582,10,35,.286,28,32,.875,122,43,88,.489,33,54,.611,10,34,.294,11,15,.733,107
366,MEM,2024-10-31,122,,MIL,W 122-99,240,43,82,.524,35,54,.648,8,28,.286,28,31,.903,122,41,96,.427,32,54,.593,9,42,.214,8,19,.421,99
367,MIL,2024-10-25,122,,CHI,L 122-133,240,46,93,.495,33,53,.623,13,40,.325,17,25,.680,122,46,96,.479,25,49,.510,21,47,.447,20,23,.870,133
368,ORL,2025-03-29,121,,SAC,W 121-91,240,44,89,.494,26,50,.520,18,39,.462,15,24,.625,121,34,81,.420,27,53,.509,7,28,.250,16,20,.800,91
369,HOU,2025-03-25,121,,ATL,W 121-114,240,42,93,.452,31,54,.574,11,39,.282,26,29,.897,121,43,103,.417,28,54,.519,15,49,.306,13,15,.867,114
370,CHI,2025-03-10,121,,IND,W 121-103,240,49,98,.500,37,65,.569,12,33,.364,11,14,.786,121,40,101,.396,30,61,.492,10,40,.250,13,19,.684,103
371,ATL,2025-03-04,121,,MIL,L 121-127,240,46,101,.455,30,60,.500,16,41,.390,13,17,.765,121,49,96,.510,38,59,.644,11,37,.297,18,23,.783,127
372,UTA,2025-03-02,121,,NOP,L 121-128,240,46,96,.479,30,52,.577,16,44,.364,13,17,.765,121,53,102,.520,38,58,.655,15,44,.341,7,13,.538,128
373,MIL,2025-02-27,121,,DEN,W 121-112,240,42,90,.467,28,56,.500,14,34,.412,23,28,.821,121,47,105,.448,38,71,.535,9,34,.265,9,11,.818,112
374,BRK,2025-02-26,121,,OKC,L 121-129,240,38,93,.409,15,32,.469,23,61,.377,22,25,.880,121,48,90,.533,39,60,.650,9,30,.300,24,29,.828,129
375,WAS,2025-02-26,121,,POR,L 121-129,240,43,83,.518,31,47,.660,12,36,.333,23,33,.697,121,45,101,.446,33,64,.516,12,37,.324,27,35,.771,129
376,HOU,2025-02-21,121,,MIN,W 121-115,240,42,84,.500,29,58,.500,13,26,.500,24,32,.750,121,41,92,.446,30,54,.556,11,38,.289,22,26,.846,115
377,WAS,2025-02-10,121,,SAS,L 121-131,240,45,93,.484,31,46,.674,14,47,.298,17,19,.895,121,45,88,.511,28,50,.560,17,38,.447,24,29,.828,131
378,OKC,2025-02-07,121,,TOR,W 121-109,240,43,84,.512,34,53,.642,9,31,.290,26,31,.839,121,39,91,.429,20,50,.400,19,41,.463,12,19,.632,109
379,POR,2025-02-03,121,,PHO,W 121-119 (OT),265,40,89,.449,24,49,.490,16,40,.400,25,30,.833,121,40,85,.471,25,43,.581,15,42,.357,24,28,.857,119
380,ORL,2025-01-25,121,,DET,W 121-113,240,40,83,.482,25,50,.500,15,33,.455,26,38,.684,121,40,86,.465,30,61,.492,10,25,.400,23,28,.821,113
381,DET,2025-01-18,121,,PHO,L 121-125,240,44,94,.468,35,61,.574,9,33,.273,24,36,.667,121,43,86,.500,36,61,.590,7,25,.280,32,40,.800,125
382,BOS,2025-01-17,121,,ORL,W 121-94,240,42,80,.525,25,43,.581,17,37,.459,20,22,.909,121,34,82,.415,29,50,.580,5,32,.156,21,31,.677,94
383,MIL,2025-01-08,121,,SAS,W 121-105,240,44,92,.478,25,50,.500,19,42,.452,14,20,.700,121,35,95,.368,17,43,.395,18,52,.346,17,20,.850,105
384,UTA,2025-01-07,121,,ATL,L 121-124,240,40,96,.417,21,48,.438,19,48,.396,22,25,.880,121,47,98,.480,29,54,.537,18,44,.409,12,15,.800,124
385,GSW,2025-01-04,121,,MEM,W 121-113,240,44,84,.524,21,41,.512,23,43,.535,10,16,.625,121,46,88,.523,37,61,.607,9,27,.333,12,16,.750,113
386,UTA,2024-12-30,121,,DEN,L 121-132,240,44,86,.512,31,48,.646,13,38,.342,20,22,.909,121,53,105,.505,44,75,.587,9,30,.300,17,19,.895,132
387,ORL,2024-12-21,121,,MIA,W 121-114,240,43,87,.494,32,50,.640,11,37,.297,24,27,.889,121,36,75,.480,27,43,.628,9,32,.281,33,42,.786,114
388,TOR,2024-12-16,121,,CHI,L 121-122,240,45,92,.489,36,66,.545,9,26,.346,22,30,.733,121,43,93,.462,29,53,.547,14,40,.350,22,28,.786,122
389,SAS,2024-12-08,121,,NOP,W 121-116,240,42,93,.452,30,54,.556,12,39,.308,25,31,.806,121,43,99,.434,30,61,.492,13,38,.342,17,21,.810,116
390,BOS,2024-12-07,121,,MEM,L 121-127,240,42,105,.400,24,45,.533,18,60,.300,19,28,.679,121,47,94,.500,32,61,.525,15,33,.455,18,23,.783,127
391,MIA,2024-12-07,121,,PHO,W 121-111,240,45,86,.523,32,54,.593,13,32,.406,18,23,.783,121,36,82,.439,20,41,.488,16,41,.390,23,25,.920,111
392,DAL,2024-12-03,121,,MEM,W 121-116,240,39,81,.481,26,49,.531,13,32,.406,30,44,.682,121,45,97,.464,32,57,.561,13,40,.325,13,14,.929,116
393,NYK,2024-12-03,121,,ORL,W 121-106,240,43,85,.506,28,50,.560,15,35,.429,20,20,1.000,121,38,87,.437,29,48,.604,9,39,.231,21,25,.840,106
394,MIA,2024-11-29,121,,TOR,W 121-111,240,43,94,.457,22,40,.550,21,54,.389,14,17,.824,121,43,80,.538,32,51,.627,11,29,.379,14,17,.824,111
395,IND,2024-11-27,121,,POR,W 121-114,240,46,94,.489,33,62,.532,13,32,.406,16,20,.800,121,44,87,.506,28,52,.538,16,35,.457,10,17,.588,114
396,UTA,2024-11-23,121,,NYK,W 121-106,240,44,87,.506,25,53,.472,19,34,.559,14,19,.737,121,39,100,.390,22,49,.449,17,51,.333,11,12,.917,106
397,SAC,2024-11-16,121,,UTA,W 121-117,240,42,83,.506,23,42,.548,19,41,.463,18,25,.720,121,37,75,.493,25,49,.510,12,26,.462,31,42,.738,117
398,ORL,2024-11-10,121,,WAS,W 121-94,240,41,91,.451,24,43,.558,17,48,.354,22,25,.880,121,33,72,.458,23,39,.590,10,33,.303,18,25,.720,94
399,ATL,2024-11-06,121,,NYK,W 121-116,240,45,100,.450,30,62,.484,15,38,.395,16,22,.727,121,41,84,.488,19,37,.514,22,47,.468,12,15,.800,116
400,DEN,2024-11-04,121,,TOR,W 121-119,240,41,83,.494,31,52,.596,10,31,.323,29,38,.763,121,47,103,.456,34,64,.531,13,39,.333,12,18,.667,119
401,HOU,2024-11-02,121,,GSW,L 121-127 (OT),265,44,107,.411,29,62,.468,15,45,.333,18,24,.750,121,40,78,.513,25,46,.543,15,32,.469,32,50,.640,127
402,DEN,2025-04-06,120,,IND,L 120-125,240,50,93,.538,42,62,.677,8,31,.258,12,18,.667,120,46,96,.479,31,52,.596,15,44,.341,18,21,.857,125
403,POR,2025-04-06,120,,SAS,W 120-109,240,42,89,.472,27,48,.563,15,41,.366,21,27,.778,120,41,95,.432,30,61,.492,11,34,.324,16,21,.762,109
404,DAL,2025-04-02,120,,ATL,W 120-118,240,44,83,.530,29,50,.580,15,33,.455,17,21,.810,120,42,97,.433,27,58,.466,15,39,.385,19,22,.864,118
405,LAL,2025-03-19,120,,DEN,W 120-108,240,42,83,.506,26,45,.578,16,38,.421,20,28,.714,120,41,87,.471,28,48,.583,13,39,.333,13,21,.619,108
406,SAS,2025-03-19,120,,NYK,W 120-105,240,45,90,.500,29,55,.527,16,35,.457,14,20,.700,120,39,92,.424,28,55,.509,11,37,.297,16,21,.762,105
407,MEM,2025-03-10,120,,PHO,W 120-118,240,40,86,.465,23,40,.575,17,46,.370,23,27,.852,120,41,90,.456,21,52,.404,20,38,.526,16,22,.727,118
408,ATL,2025-03-08,120,,IND,W 120-118,240,45,97,.464,35,63,.556,10,34,.294,20,21,.952,120,41,94,.436,31,61,.508,10,33,.303,26,30,.867,118
409,MIL,2025-02-23,120,,MIA,W 120-113,240,44,86,.512,30,47,.638,14,39,.359,18,22,.818,120,41,88,.466,32,57,.561,9,31,.290,22,26,.846,113
410,SAS,2025-02-20,120,,PHO,W 120-109,240,44,93,.473,29,52,.558,15,41,.366,17,22,.773,120,38,81,.469,22,37,.595,16,44,.364,17,20,.850,109
411,BOS,2025-02-06,120,,DAL,L 120-127,240,46,89,.517,30,52,.577,16,37,.432,12,15,.800,120,49,88,.557,34,55,.618,15,33,.455,14,18,.778,127
412,LAL,2025-02-06,120,,GSW,W 120-112,240,39,78,.500,26,43,.605,13,35,.371,29,36,.806,120,41,101,.406,25,48,.521,16,53,.302,14,20,.700,112
413,MEM,2025-01-30,120,,HOU,W 120-119,240,48,93,.516,39,65,.600,9,28,.321,15,20,.750,120,42,97,.433,29,65,.446,13,32,.406,22,28,.786,119
414,HOU,2025-01-13,120,,MEM,W 120-118,240,41,81,.506,25,50,.500,16,31,.516,22,31,.710,120,45,84,.536,31,52,.596,14,32,.438,14,21,.667,118
415,BOS,2025-01-12,120,,NOP,W 120-119,240,44,101,.436,31,57,.544,13,44,.295,19,23,.826,120,40,86,.465,23,49,.469,17,37,.459,22,26,.846,119
416,PHO,2025-01-12,120,,CHO,W 120-113,240,42,87,.483,25,46,.543,17,41,.415,19,22,.864,120,41,92,.446,26,52,.500,15,40,.375,16,20,.800,113
417,ATL,2024-12-28,120,,MIA,W 120-110,240,44,86,.512,29,49,.592,15,37,.405,17,22,.773,120,40,90,.444,27,49,.551,13,41,.317,17,18,.944,110
418,DEN,2024-12-13,120,,LAC,W 120-98,240,42,77,.545,32,48,.667,10,29,.345,26,32,.813,120,37,83,.446,23,42,.548,14,41,.341,10,18,.556,98
419,SAC,2024-12-03,120,,HOU,W 120-111,240,47,91,.516,33,61,.541,14,30,.467,12,20,.600,120,41,93,.441,27,54,.500,14,39,.359,15,21,.714,111
420,MEM,2024-11-29,120,,NOP,W 120-109,240,47,96,.490,35,55,.636,12,41,.293,14,17,.824,120,38,91,.418,29,62,.468,9,29,.310,24,30,.800,109
421,GSW,2024-11-25,120,,BRK,L 120-128,240,45,93,.484,26,47,.553,19,46,.413,11,17,.647,120,41,83,.494,21,38,.553,20,45,.444,26,30,.867,128
422,DEN,2024-11-22,120,,DAL,L 120-123,240,43,90,.478,28,61,.459,15,29,.517,19,29,.655,120,46,91,.505,36,64,.563,10,27,.370,21,27,.778,123
423,GSW,2024-11-20,120,,ATL,W 120-97,240,47,101,.465,33,61,.541,14,40,.350,12,18,.667,120,35,105,.333,23,60,.383,12,45,.267,15,24,.625,97
424,BOS,2024-11-19,120,,CLE,W 120-117,240,44,86,.512,22,45,.489,22,41,.537,10,14,.714,120,46,93,.495,36,64,.563,10,29,.345,15,17,.882,117
425,MIN,2024-11-17,120,,PHO,W 120-117,240,42,80,.525,25,41,.610,17,39,.436,19,26,.731,120,46,85,.541,32,54,.593,14,31,.452,11,15,.733,117
426,GSW,2024-11-12,120,,DAL,W 120-117,240,45,94,.479,31,53,.585,14,41,.341,16,27,.593,120,44,84,.524,33,50,.660,11,34,.324,18,24,.750,117
427,CLE,2024-11-01,120,,ORL,W 120-109,240,44,87,.506,29,49,.592,15,38,.395,17,20,.850,120,41,90,.456,30,57,.526,11,33,.333,16,24,.667,109
428,BRK,2024-11-01,120,,CHI,W 120-112,240,49,94,.521,38,58,.655,11,36,.306,11,13,.846,120,38,88,.432,21,44,.477,17,44,.386,19,24,.792,112
429,DAL,2024-10-24,120,,SAS,W 120-109,240,42,102,.412,23,58,.397,19,44,.432,17,23,.739,120,39,86,.453,27,50,.540,12,36,.333,19,24,.792,109
430,ATL,2024-10-23,120,,BRK,W 120-116,240,39,80,.488,30,52,.577,9,28,.321,33,46,.717,120,40,91,.440,23,48,.479,17,43,.395,19,25,.760,116
431,GSW,2025-04-13,119,,LAC,L 119-124 (OT),265,43,79,.544,28,46,.609,15,33,.455,18,23,.783,119,48,86,.558,34,56,.607,14,30,.467,14,18,.778,124
432,CHI,2025-04-11,119,,WAS,W 119-89,240,43,93,.462,30,52,.577,13,41,.317,20,22,.909,119,35,91,.385,25,50,.500,10,41,.244,9,12,.750,89
433,DET,2025-04-11,119,,MIL,L 119-125,240,46,93,.495,28,54,.519,18,39,.462,9,18,.500,119,43,94,.457,26,55,.473,17,39,.436,22,27,.815,125
434,CHI,2025-04-09,119,,MIA,W 119-111,240,46,89,.517,32,52,.615,14,37,.378,13,13,1.000,119,44,92,.478,32,59,.542,12,33,.364,11,17,.647,111
435,BRK,2025-04-08,119,,NOP,W 119-114,240,41,83,.494,24,43,.558,17,40,.425,20,24,.833,119,39,82,.476,27,49,.551,12,33,.364,24,31,.774,114
436,ORL,2025-04-08,119,,ATL,W 119-112,240,42,84,.500,28,50,.560,14,34,.412,21,31,.677,119,40,88,.455,26,47,.553,14,41,.341,18,22,.818,112
437,IND,2025-04-02,119,,CHO,W 119-105,240,47,95,.495,29,51,.569,18,44,.409,7,10,.700,119,41,78,.526,31,54,.574,10,24,.417,13,18,.722,105
438,OKC,2025-04-02,119,,DET,W 119-103,240,42,96,.438,32,58,.552,10,38,.263,25,31,.806,119,36,89,.404,26,56,.464,10,33,.303,21,25,.840,103
439,CHI,2025-03-29,119,,DAL,L 119-120,240,43,91,.473,29,58,.500,14,33,.424,19,24,.792,119,47,101,.465,38,71,.535,9,30,.300,17,21,.810,120
440,CHI,2025-03-27,119,,LAL,W 119-117,240,43,92,.467,24,48,.500,19,44,.432,14,22,.636,119,45,91,.495,33,50,.660,12,41,.293,15,18,.833,117
441,IND,2025-03-26,119,,LAL,L 119-120,240,44,87,.506,29,51,.569,15,36,.417,16,19,.842,119,41,79,.519,24,41,.585,17,38,.447,21,24,.875,120
442,DEN,2025-03-24,119,,CHI,L 119-129,240,46,97,.474,35,61,.574,11,36,.306,16,24,.667,119,45,91,.495,28,52,.538,17,39,.436,22,26,.846,129
443,IND,2025-03-24,119,,MIN,W 119-103,240,46,94,.489,33,59,.559,13,35,.371,14,14,1.000,119,44,91,.484,35,56,.625,9,35,.257,6,10,.600,103
444,SAS,2025-03-15,119,,NOP,W 119-115,240,39,84,.464,23,45,.511,16,39,.410,25,33,.758,119,46,92,.500,34,57,.596,12,35,.343,11,11,1.000,115
445,TOR,2025-03-10,119,,WAS,W 119-104,240,43,109,.394,27,60,.450,16,49,.327,17,29,.586,119,38,105,.362,22,50,.440,16,55,.291,12,15,.800,104
446,BRK,2025-03-06,119,,GSW,L 119-121,240,44,87,.506,29,54,.537,15,33,.455,16,18,.889,119,40,82,.488,28,50,.560,12,32,.375,29,32,.906,121
447,PHO,2025-03-04,119,,LAC,W 119-117,240,41,80,.513,27,46,.587,14,34,.412,23,27,.852,119,43,83,.518,35,53,.660,8,30,.267,23,27,.852,117
448,ATL,2025-02-28,119,,OKC,L 119-135,240,43,88,.489,28,52,.538,15,36,.417,18,23,.783,119,51,101,.505,28,51,.549,23,50,.460,10,12,.833,135
449,DET,2025-02-28,119,,DEN,L 119-134,240,45,99,.455,33,62,.532,12,37,.324,17,23,.739,119,47,84,.560,30,53,.566,17,31,.548,23,31,.742,134
450,HOU,2025-02-12,119,,PHO,W 119-111,240,46,97,.474,33,55,.600,13,42,.310,14,24,.583,119,46,89,.517,36,63,.571,10,26,.385,9,11,.818,111
451,MIL,2025-02-02,119,,MEM,L 119-132,240,44,91,.484,24,46,.522,20,45,.444,11,19,.579,119,52,107,.486,38,68,.559,14,39,.359,14,22,.636,132
452,POR,2025-01-30,119,,ORL,W 119-90,240,41,78,.526,29,53,.547,12,25,.480,25,31,.806,119,34,81,.420,29,55,.527,5,26,.192,17,20,.850,90
453,PHO,2025-01-25,119,,WAS,W 119-109,240,40,90,.444,27,50,.540,13,40,.325,26,28,.929,119,42,90,.467,24,49,.490,18,41,.439,7,9,.778,109
454,ATL,2025-01-23,119,,TOR,L 119-122,240,42,87,.483,29,50,.580,13,37,.351,22,30,.733,119,47,81,.580,38,60,.633,9,21,.429,19,24,.792,122
455,NYK,2025-01-20,119,,ATL,W 119-110,240,47,90,.522,38,64,.594,9,26,.346,16,21,.762,119,40,85,.471,27,55,.491,13,30,.433,17,22,.773,110
456,NOP,2025-01-15,119,,DAL,W 119-116,240,43,97,.443,30,58,.517,13,39,.333,20,24,.833,119,43,90,.478,31,55,.564,12,35,.343,18,25,.720,116
457,PHI,2025-01-15,119,,NYK,L 119-125 (OT),265,46,92,.500,33,57,.579,13,35,.371,14,14,1.000,119,46,86,.535,30,49,.612,16,37,.432,17,24,.708,125
458,NYK,2025-01-13,119,,DET,L 119-124,240,40,80,.500,25,43,.581,15,37,.405,24,29,.828,119,46,92,.500,31,58,.534,15,34,.441,17,18,.944,124
459,CHI,2025-01-12,119,,SAC,L 119-124,240,43,93,.462,25,56,.446,18,37,.486,15,20,.750,119,47,95,.495,34,56,.607,13,39,.333,17,21,.810,124
460,MEM,2025-01-06,119,,DAL,W 119-104,240,40,88,.455,28,53,.528,12,35,.343,27,35,.771,119,40,98,.408,27,62,.435,13,36,.361,11,15,.733,104
461,HOU,2025-01-05,119,,LAL,W 119-115,240,47,99,.475,33,59,.559,14,40,.350,11,19,.579,119,38,78,.487,22,42,.524,16,36,.444,23,28,.821,115
462,DET,2025-01-04,119,,MIN,W 119-105,240,45,93,.484,32,55,.582,13,38,.342,16,20,.800,119,34,80,.425,18,40,.450,16,40,.400,21,26,.808,105
463,LAL,2025-01-03,119,,ATL,W 119-102,240,43,88,.489,30,58,.517,13,30,.433,20,25,.800,119,41,100,.410,35,66,.530,6,34,.176,14,18,.778,102
464,MIA,2025-01-01,119,,NOP,W 119-108,240,44,83,.530,30,49,.612,14,34,.412,17,21,.810,119,40,80,.500,31,46,.674,9,34,.265,19,22,.864,108
465,NYK,2025-01-01,119,,UTA,W 119-103,240,47,85,.553,38,62,.613,9,23,.391,16,23,.696,119,39,96,.406,26,53,.491,13,43,.302,12,15,.800,103
466,DET,2024-12-19,119,,UTA,L 119-126,240,46,105,.438,33,58,.569,13,47,.277,14,18,.778,119,39,83,.470,19,43,.442,20,40,.500,28,31,.903,126
467,IND,2024-12-15,119,,NOP,W 119-104,240,41,81,.506,25,43,.581,16,38,.421,21,24,.875,119,38,97,.392,28,64,.438,10,33,.303,18,23,.783,104
468,DEN,2024-12-03,119,,GSW,W 119-115,240,40,79,.506,29,55,.527,11,24,.458,28,35,.800,119,44,95,.463,32,57,.561,12,38,.316,15,21,.714,115
469,HOU,2024-12-01,119,,OKC,W 119-116,240,38,92,.413,25,55,.455,13,37,.351,30,39,.769,119,42,94,.447,29,55,.527,13,39,.333,19,25,.760,116
470,TOR,2024-12-01,119,,MIA,W 119-116,240,47,88,.534,37,59,.627,10,29,.345,15,20,.750,119,39,88,.443,24,48,.500,15,40,.375,23,28,.821,116
471,ATL,2024-11-25,119,,DAL,L 119-129,240,48,101,.475,39,70,.557,9,31,.290,14,16,.875,119,47,94,.500,31,59,.525,16,35,.457,19,22,.864,129
472,IND,2024-11-17,119,,MIA,W 119-110,240,44,85,.518,31,56,.554,13,29,.448,18,20,.900,119,36,90,.400,17,47,.362,19,43,.442,19,20,.950,110
473,OKC,2024-11-17,119,,DAL,L 119-121,240,43,87,.494,29,45,.644,14,42,.333,19,25,.760,119,40,84,.476,29,57,.509,11,27,.407,30,36,.833,121
474,CHI,2024-11-07,119,,MIN,L 119-135,240,47,88,.534,32,52,.615,15,36,.417,10,15,.667,119,51,93,.548,35,55,.636,16,38,.421,17,17,1.000,135
475,DAL,2024-11-06,119,,CHI,W 119-99,240,45,93,.484,33,55,.600,12,38,.316,17,21,.810,119,36,86,.419,24,44,.545,12,42,.286,15,23,.652,99
476,MIN,2024-11-01,119,,DEN,W 119-116,240,43,83,.518,25,41,.610,18,42,.429,15,18,.833,119,41,92,.446,30,60,.500,11,32,.344,23,29,.793,116
477,LAC,2024-10-31,119,,PHO,L 119-125,240,45,93,.484,33,58,.569,12,35,.343,17,21,.810,119,42,82,.512,24,43,.558,18,39,.462,23,28,.821,125
478,ATL,2024-10-28,119,,WAS,L 119-121,240,39,81,.481,24,41,.585,15,40,.375,26,36,.722,119,41,91,.451,20,47,.426,21,44,.477,18,22,.818,121
479,BOS,2024-10-28,119,,MIL,W 119-108,240,43,87,.494,25,40,.625,18,47,.383,15,19,.789,119,37,82,.451,29,51,.569,8,31,.258,26,31,.839,108
480,ORL,2024-10-28,119,,IND,W 119-115,240,39,83,.470,26,42,.619,13,41,.317,28,38,.737,119,41,88,.466,28,59,.475,13,29,.448,20,30,.667,115
481,CLE,2025-04-13,118,,IND,L 118-126 (2OT),290,44,115,.383,26,55,.473,18,60,.300,12,22,.545,118,48,119,.403,38,77,.494,10,42,.238,20,22,.909,126
482,MIA,2025-04-13,118,,WAS,L 118-119,240,49,98,.500,39,66,.591,10,32,.313,10,12,.833,118,46,90,.511,30,53,.566,16,37,.432,11,17,.647,119
483,CHI,2025-04-04,118,,POR,W 118-113,240,41,87,.471,31,60,.517,10,27,.370,26,31,.839,118,44,115,.383,33,73,.452,11,42,.262,14,18,.778,113
484,GSW,2025-04-04,118,,DEN,W 118-104,240,43,88,.489,27,50,.540,16,38,.421,16,18,.889,118,40,74,.541,28,43,.651,12,31,.387,12,13,.923,104
485,ORL,2025-03-24,118,,LAL,W 118-106,240,42,85,.494,27,45,.600,15,40,.375,19,23,.826,118,37,80,.463,27,48,.563,10,32,.313,22,28,.786,106
486,MIN,2025-03-14,118,,ORL,W 118-111,240,42,80,.525,28,47,.596,14,33,.424,20,28,.714,118,40,89,.449,28,61,.459,12,28,.429,19,22,.864,111
487,UTA,2025-03-14,118,,TOR,L 118-126,240,39,89,.438,23,51,.451,16,38,.421,24,31,.774,118,44,91,.484,32,59,.542,12,32,.375,26,35,.743,126
488,TOR,2025-03-12,118,,PHI,W 118-105,240,44,100,.440,28,60,.467,16,40,.400,14,18,.778,118,41,96,.427,34,61,.557,7,35,.200,16,22,.727,105
489,TOR,2025-03-07,118,,UTA,W 118-109,240,40,104,.385,26,58,.448,14,46,.304,24,28,.857,118,39,84,.464,31,53,.585,8,31,.258,23,39,.590,109
490,HOU,2025-02-26,118,,SAS,W 118-106,240,48,102,.471,37,64,.578,11,38,.289,11,14,.786,118,42,100,.420,35,61,.574,7,39,.179,15,21,.714,106
491,BOS,2025-02-23,118,,NYK,W 118-105,240,45,91,.495,28,47,.596,17,44,.386,11,11,1.000,118,40,92,.435,26,56,.464,14,36,.389,11,11,1.000,105
492,DAL,2025-02-13,118,,MIA,W 118-113,240,46,90,.511,33,54,.611,13,36,.361,13,16,.813,118,43,91,.473,33,55,.600,10,36,.278,17,26,.654,113
493,PHI,2025-02-04,118,,DAL,W 118-116,240,47,86,.547,36,53,.679,11,33,.333,13,19,.684,118,40,85,.471,29,52,.558,11,33,.333,25,31,.806,116
494,PHI,2025-01-28,118,,LAL,W 118-104,240,43,91,.473,32,57,.561,11,34,.324,21,25,.840,118,37,72,.514,27,39,.692,10,33,.303,20,23,.870,104
495,CLE,2025-01-20,118,,PHO,W 118-92,240,41,95,.432,22,49,.449,19,46,.413,17,23,.739,118,36,77,.468,26,51,.510,10,26,.385,10,13,.769,92
496,DAL,2025-01-07,118,,LAL,W 118-97,240,45,86,.523,27,48,.563,18,38,.474,10,14,.714,118,34,75,.453,23,40,.575,11,35,.314,18,24,.750,97
497,DET,2025-01-06,118,,POR,W 118-115,240,42,94,.447,27,51,.529,15,43,.349,19,22,.864,118,48,90,.533,32,55,.582,16,35,.457,3,5,.600,115
498,OKC,2024-12-10,118,,DAL,W 118-104,240,46,101,.455,26,51,.510,20,50,.400,6,7,.857,118,38,80,.475,23,44,.523,15,36,.417,13,19,.684,104
499,TOR,2024-12-07,118,,DAL,L 118-125,240,43,93,.462,28,54,.519,15,39,.385,17,18,.944,118,38,81,.469,21,36,.583,17,45,.378,32,37,.865,125
500,CLE,2024-12-03,118,,WAS,W 118-87,240,43,89,.483,27,43,.628,16,46,.348,16,25,.640,118,32,83,.386,28,57,.491,4,26,.154,19,25,.760,87
501,NYK,2024-12-01,118,,NOP,W 118-85,240,42,92,.457,22,47,.468,20,45,.444,14,16,.875,118,35,94,.372,31,67,.463,4,27,.148,11,17,.647,85
502,DEN,2024-11-25,118,,NYK,L 118-145,240,41,92,.446,30,59,.508,11,33,.333,25,27,.926,118,56,92,.609,37,56,.661,19,36,.528,14,16,.875,145
503,LAL,2024-11-21,118,,ORL,L 118-119,240,44,87,.506,31,56,.554,13,31,.419,17,26,.654,118,43,91,.473,28,51,.549,15,40,.375,18,21,.857,119
504,PHO,2024-11-10,118,,SAC,L 118-127 (OT),265,44,105,.419,26,48,.542,18,57,.316,12,15,.800,118,50,102,.490,39,65,.600,11,37,.297,16,19,.842,127
505,SAS,2024-11-07,118,,POR,W 118-105,240,44,82,.537,28,43,.651,16,39,.410,14,18,.778,118,41,86,.477,32,54,.593,9,32,.281,14,22,.636,105
506,IND,2024-11-06,118,,ORL,W 118-111,240,41,76,.539,29,50,.580,12,26,.462,24,26,.923,118,42,82,.512,35,57,.614,7,25,.280,20,26,.769,111
507,PHO,2024-11-04,118,,PHI,W 118-116,240,42,82,.512,31,50,.620,11,32,.344,23,26,.885,118,40,87,.460,20,36,.556,20,51,.392,16,18,.889,116
508,DET,2024-10-26,118,,BOS,L 118-124,240,43,88,.489,29,49,.592,14,39,.359,18,22,.818,118,38,90,.422,16,42,.381,22,48,.458,26,30,.867,124
509,ATL,2025-04-13,117,,ORL,W 117-105,240,47,88,.534,30,48,.625,17,40,.425,6,10,.600,117,40,88,.455,25,53,.472,15,35,.429,10,15,.667,105
510,DEN,2025-04-11,117,,MEM,W 117-109,240,44,91,.484,39,67,.582,5,24,.208,24,31,.774,117,41,91,.451,27,48,.563,14,43,.326,13,19,.684,109
511,MIN,2025-04-11,117,,BRK,W 117-91,240,42,77,.545,31,46,.674,11,31,.355,22,29,.759,117,33,90,.367,21,49,.429,12,41,.293,13,17,.765,91
512,PHO,2025-04-11,117,,SAS,W 117-98,240,44,95,.463,25,48,.521,19,47,.404,10,11,.909,117,39,90,.433,26,56,.464,13,34,.382,7,10,.700,98
513,NYK,2025-04-08,117,,BOS,L 117-119 (OT),265,48,101,.475,37,63,.587,11,38,.289,10,16,.625,117,40,87,.460,21,38,.553,19,49,.388,20,25,.800,119
514,DET,2025-04-07,117,,SAC,L 117-127,240,42,89,.472,29,50,.580,13,39,.333,20,28,.714,117,47,91,.516,36,64,.563,11,27,.407,22,27,.815,127
515,MIA,2025-04-07,117,,PHI,W 117-105,240,45,89,.506,29,53,.547,16,36,.444,11,15,.733,117,38,88,.432,26,50,.520,12,38,.316,17,25,.680,105
516,CHO,2025-04-06,117,,CHI,L 117-131,240,41,85,.482,33,55,.600,8,30,.267,27,34,.794,117,46,86,.535,30,50,.600,16,36,.444,23,29,.793,131
517,GSW,2025-03-20,117,,TOR,W 117-114,240,38,90,.422,19,43,.442,19,47,.404,22,28,.786,117,44,78,.564,33,52,.635,11,26,.423,15,19,.789,114
518,HOU,2025-03-15,117,,CHI,W 117-114,240,44,98,.449,30,54,.556,14,44,.318,15,26,.577,117,43,93,.462,29,55,.527,14,38,.368,14,16,.875,114
519,TOR,2025-03-08,117,,WAS,L 117-118,240,40,95,.421,30,69,.435,10,26,.385,27,30,.900,117,44,100,.440,31,62,.500,13,38,.342,17,23,.739,118
520,CHO,2025-03-07,117,,CLE,L 117-118,240,44,92,.478,31,55,.564,13,37,.351,16,21,.762,117,32,76,.421,21,42,.500,11,34,.324,43,51,.843,118
521,CHI,2025-03-04,117,,CLE,L 117-139,240,47,106,.443,36,62,.581,11,44,.250,12,17,.706,117,46,98,.469,29,50,.580,17,48,.354,30,33,.909,139
522,DAL,2025-03-01,117,,MIL,L 117-132,240,43,91,.473,32,51,.627,11,40,.275,20,25,.800,117,44,87,.506,31,48,.646,13,39,.333,31,35,.886,132
523,UTA,2025-02-28,117,,MIN,W 117-116,240,47,92,.511,33,57,.579,14,35,.400,9,14,.643,117,44,101,.436,24,49,.490,20,52,.385,8,14,.571,116
524,CHI,2025-02-26,117,,LAC,L 117-122,240,46,94,.489,27,52,.519,19,42,.452,6,11,.545,117,44,85,.518,25,48,.521,19,37,.514,15,17,.882,122
525,DET,2025-02-26,117,,BOS,W 117-97,240,47,89,.528,34,56,.607,13,33,.394,10,17,.588,117,33,80,.413,12,31,.387,21,49,.429,10,15,.667,97
526,CHI,2025-02-22,117,,PHO,L 117-121,240,41,98,.418,23,45,.511,18,53,.340,17,17,1.000,117,43,89,.483,33,59,.559,10,30,.333,25,28,.893,121
527,CHO,2025-02-07,117,,SAS,W 117-116,240,47,101,.465,30,63,.476,17,38,.447,6,6,1.000,117,42,92,.457,30,53,.566,12,39,.308,20,24,.833,116
528,DET,2025-01-31,117,,DAL,W 117-102,240,47,106,.443,38,71,.535,9,35,.257,14,16,.875,117,37,87,.425,26,54,.481,11,33,.333,17,21,.810,102
529,PHI,2025-01-29,117,,SAC,W 117-104,240,43,82,.524,31,53,.585,12,29,.414,19,22,.864,117,40,90,.444,30,49,.612,10,41,.244,14,17,.824,104
530,LAL,2025-01-23,117,,BOS,W 117-96,240,42,89,.472,27,54,.500,15,35,.429,18,20,.900,117,35,91,.385,21,50,.420,14,41,.341,12,18,.667,96
531,MIN,2025-01-18,117,,CLE,L 117-124,240,43,90,.478,28,52,.538,15,38,.395,16,19,.842,117,42,92,.457,25,44,.568,17,48,.354,23,25,.920,124
532,LAL,2025-01-15,117,,MIA,W 117-108,240,47,90,.522,34,56,.607,13,34,.382,10,14,.714,117,39,73,.534,23,37,.622,16,36,.444,14,15,.933,108
533,IND,2025-01-14,117,,CLE,L 117-127,240,44,91,.484,32,63,.508,12,28,.429,17,22,.773,117,43,89,.483,28,45,.622,15,44,.341,26,31,.839,127
534,DAL,2025-01-09,117,,POR,W 117-111,240,40,88,.455,30,58,.517,10,30,.333,27,30,.900,117,39,93,.419,23,57,.404,16,36,.444,17,20,.850,111
535,OKC,2025-01-03,117,,NYK,W 117-107,240,43,84,.512,29,57,.509,14,27,.519,17,21,.810,117,43,90,.478,34,58,.586,9,32,.281,12,17,.706,107
536,NYK,2024-12-25,117,,SAS,W 117-114,240,45,100,.450,32,61,.525,13,39,.333,14,16,.875,117,42,83,.506,26,45,.578,16,38,.421,14,17,.824,114
537,ATL,2024-12-23,117,,MIN,W 117-104,240,39,73,.534,21,37,.568,18,36,.500,21,26,.808,117,39,91,.429,25,48,.521,14,43,.326,12,13,.923,104
538,DEN,2024-12-23,117,,PHO,W 117-90,240,46,90,.511,30,49,.612,16,41,.390,9,11,.818,117,33,83,.398,20,50,.400,13,33,.394,11,15,.733,90
539,ATL,2024-11-29,117,,CLE,W 117-101,240,44,85,.518,30,51,.588,14,34,.412,15,18,.833,117,38,93,.409,27,55,.491,11,38,.289,14,17,.824,101
540,PHO,2024-11-27,117,,BRK,L 117-127,240,41,77,.532,29,46,.630,12,31,.387,23,28,.821,117,44,87,.506,26,45,.578,18,42,.429,21,22,.955,127
541,MEM,2024-11-20,117,,PHI,W 117-111,240,41,85,.482,22,42,.524,19,43,.442,16,16,1.000,117,39,87,.448,28,54,.519,11,33,.333,22,24,.917,111
542,MIN,2025-04-13,116,,UTA,W 116-105,240,46,98,.469,33,55,.600,13,43,.302,11,16,.688,116,40,89,.449,24,47,.511,16,42,.381,9,11,.818,105
543,SAC,2025-04-09,116,,DEN,L 116-124,240,43,92,.467,27,56,.482,16,36,.444,14,17,.824,116,43,86,.500,30,52,.577,13,34,.382,25,31,.806,124
544,LAL,2025-04-03,116,,GSW,L 116-123,240,39,86,.453,21,39,.538,18,47,.383,20,23,.870,116,39,82,.476,20,40,.500,19,42,.452,26,31,.839,123
545,WAS,2025-04-02,116,,SAC,W 116-111,240,43,84,.512,26,41,.634,17,43,.395,13,18,.722,116,40,95,.421,30,56,.536,10,39,.256,21,28,.750,111
546,POR,2025-03-23,116,,BOS,L 116-129,240,43,88,.489,24,41,.585,19,47,.404,11,16,.688,116,48,88,.545,25,38,.658,23,50,.460,10,14,.714,129
547,SAC,2025-03-20,116,,CHI,L 116-128,240,41,86,.477,26,47,.553,15,39,.385,19,23,.826,116,45,86,.523,30,51,.588,15,35,.429,23,26,.885,128
548,NYK,2025-03-17,116,,MIA,W 116-95,240,47,95,.495,31,61,.508,16,34,.471,6,6,1.000,116,39,82,.476,33,59,.559,6,23,.261,11,12,.917,95
549,CHI,2025-03-13,116,,BRK,W 116-110,240,41,90,.456,30,53,.566,11,37,.297,23,26,.885,116,43,96,.448,32,62,.516,11,34,.324,13,18,.722,110
550,DAL,2025-03-09,116,,PHO,L 116-125,240,43,88,.489,26,46,.565,17,42,.405,13,16,.813,116,49,84,.583,39,56,.696,10,28,.357,17,18,.944,125
551,DEN,2025-03-05,116,,SAC,W 116-110,240,40,87,.460,28,52,.538,12,35,.343,24,30,.800,116,44,96,.458,33,69,.478,11,27,.407,11,14,.786,110
552,BOS,2025-02-28,116,,CLE,L 116-123,240,43,89,.483,26,50,.520,17,39,.436,13,17,.765,116,45,94,.479,28,55,.509,17,39,.436,16,19,.842,123
553,PHO,2025-02-27,116,,NOP,L 116-124,240,44,94,.468,24,41,.585,20,53,.377,8,10,.800,116,50,104,.481,33,57,.579,17,47,.362,7,12,.583,124
554,IND,2025-02-24,116,,DEN,L 116-125,240,40,85,.471,26,42,.619,14,43,.326,22,27,.815,116,53,94,.564,45,73,.616,8,21,.381,11,14,.786,125
555,MIL,2025-02-20,116,,LAC,W 116-110,240,38,80,.475,21,37,.568,17,43,.395,23,27,.852,116,41,88,.466,29,58,.500,12,30,.400,16,19,.842,110
556,MIN,2025-02-13,116,,OKC,W 116-101,240,42,99,.424,30,53,.566,12,46,.261,20,22,.909,116,37,88,.420,30,59,.508,7,29,.241,20,24,.833,101
557,UTA,2025-02-13,116,,LAC,L 116-120 (OT),265,38,78,.487,20,33,.606,18,45,.400,22,26,.846,116,39,94,.415,25,56,.446,14,38,.368,28,36,.778,120
558,BOS,2025-02-12,116,,SAS,W 116-103,240,42,91,.462,24,36,.667,18,55,.327,14,21,.667,116,42,96,.438,33,57,.579,9,39,.231,10,12,.833,103
559,DAL,2025-02-08,116,,HOU,W 116-105,240,39,83,.470,27,60,.450,12,23,.522,26,34,.765,116,40,100,.400,32,72,.444,8,28,.286,17,22,.773,105
560,NOP,2025-01-31,116,,BOS,L 116-118,240,44,90,.489,29,53,.547,15,37,.405,13,19,.684,116,42,84,.500,26,43,.605,16,41,.390,18,26,.692,118
561,GSW,2025-01-29,116,,OKC,W 116-109,240,40,81,.494,27,43,.628,13,38,.342,23,28,.821,116,40,99,.404,31,60,.517,9,39,.231,20,25,.800,109
562,SAS,2025-01-29,116,,LAC,L 116-128,240,42,87,.483,28,45,.622,14,42,.333,18,25,.720,116,48,91,.527,36,67,.537,12,24,.500,20,23,.870,128
563,LAC,2025-01-19,116,,LAL,W 116-102,240,47,89,.528,36,59,.610,11,30,.367,11,14,.786,116,38,76,.500,29,49,.592,9,27,.333,17,19,.895,102
564,OKC,2025-01-02,116,,LAC,W 116-98,240,43,86,.500,29,48,.604,14,38,.368,16,20,.800,116,38,81,.469,27,49,.551,11,32,.344,11,17,.647,98
565,CHI,2024-12-28,116,,MIL,W 116-111,240,45,95,.474,31,59,.525,14,36,.389,12,17,.706,116,41,102,.402,26,57,.456,15,45,.333,14,14,1.000,111
566,LAL,2024-12-15,116,,MEM,W 116-110,240,39,82,.476,29,48,.604,10,34,.294,28,39,.718,116,38,97,.392,29,69,.420,9,28,.321,25,30,.833,110
567,PHO,2024-12-15,116,,POR,W 116-109,240,43,89,.483,28,50,.560,15,39,.385,15,19,.789,116,42,94,.447,27,45,.600,15,49,.306,10,13,.769,109
568,POR,2024-12-13,116,,SAS,L 116-118,240,42,82,.512,26,41,.634,16,41,.390,16,17,.941,116,44,85,.518,30,55,.545,14,30,.467,16,21,.762,118
569,HOU,2024-11-22,116,,POR,W 116-88,240,42,93,.452,27,54,.500,15,39,.385,17,25,.680,116,30,91,.330,19,48,.396,11,43,.256,17,22,.773,88
570,BRK,2024-11-19,116,,CHO,W 116-115,240,42,85,.494,24,44,.545,18,41,.439,14,19,.737,116,38,82,.463,18,45,.400,20,37,.541,19,22,.864,115
571,LAC,2024-11-17,116,,UTA,W 116-105,240,46,94,.489,35,54,.648,11,40,.275,13,17,.765,116,39,79,.494,27,39,.692,12,40,.300,15,18,.833,105
572,BOS,2024-11-12,116,,ATL,L 116-117,240,38,75,.507,20,30,.667,18,45,.400,22,27,.815,116,50,99,.505,40,67,.597,10,32,.313,7,13,.538,117
573,SAS,2024-11-11,116,,SAC,W 116-96,240,43,85,.506,21,39,.538,22,46,.478,8,8,1.000,116,39,91,.429,29,53,.547,10,38,.263,8,9,.889,96
574,OKC,2024-11-10,116,,GSW,L 116-127,240,42,94,.447,31,61,.508,11,33,.333,21,26,.808,116,45,89,.506,24,46,.522,21,43,.488,16,23,.696,127
575,LAL,2024-11-08,116,,PHI,W 116-106,240,44,85,.518,28,50,.560,16,35,.457,12,14,.857,116,39,96,.406,26,57,.456,13,39,.333,15,23,.652,106
576,NYK,2024-11-08,116,,MIL,W 116-94,240,43,91,.473,29,45,.644,14,46,.304,16,19,.842,116,36,83,.434,29,53,.547,7,30,.233,15,23,.652,94
577,CLE,2024-11-04,116,,MIL,W 116-114,240,46,91,.505,29,54,.537,17,37,.459,7,13,.538,116,42,86,.488,25,51,.490,17,35,.486,13,15,.867,114
578,WAS,2024-10-26,116,,CLE,L 116-135,240,37,96,.385,22,53,.415,15,43,.349,27,32,.844,116,47,88,.534,29,49,.592,18,39,.462,23,34,.676,135
579,ORL,2024-10-25,116,,BRK,W 116-101,240,39,75,.520,24,45,.533,15,30,.500,23,33,.697,116,35,83,.422,21,46,.457,14,37,.378,17,21,.810,101
580,IND,2025-04-11,115,,ORL,L 115-129,240,40,89,.449,28,60,.467,12,29,.414,23,35,.657,115,49,85,.576,36,53,.679,13,32,.406,18,21,.857,129
581,DET,2025-04-10,115,,NYK,W 115-106,240,47,82,.573,39,60,.650,8,22,.364,13,18,.722,115,42,90,.467,31,56,.554,11,34,.324,11,14,.786,106
582,MIA,2025-04-05,115,,MIL,L 115-121 (OT),265,43,102,.422,28,56,.500,15,46,.326,14,16,.875,115,45,87,.517,37,63,.587,8,24,.333,23,29,.793,121
583,LAL,2025-03-22,115,,CHI,L 115-146,240,41,85,.482,24,44,.545,17,41,.415,16,22,.727,115,56,96,.583,37,55,.673,19,41,.463,15,20,.750,146
584,CHO,2025-03-20,115,,NYK,W 115-98,240,43,88,.489,28,56,.500,15,32,.469,14,17,.824,115,36,90,.400,26,51,.510,10,39,.256,16,20,.800,98
585,MIN,2025-03-19,115,,NOP,L 115-119,240,35,77,.455,19,38,.500,16,39,.410,29,36,.806,115,47,89,.528,34,60,.567,13,29,.448,12,22,.545,119
586,POR,2025-03-19,115,,MEM,W 115-99,240,40,96,.417,22,50,.440,18,46,.391,17,21,.810,115,37,92,.402,29,62,.468,8,30,.267,17,21,.810,99
587,IND,2025-03-11,115,,MIL,W 115-114,240,44,87,.506,31,48,.646,13,39,.333,14,18,.778,115,43,84,.512,29,48,.604,14,36,.389,14,19,.737,114
588,GSW,2025-03-08,115,,DET,W 115-110,240,35,84,.417,23,43,.535,12,41,.293,33,41,.805,115,39,85,.459,34,62,.548,5,23,.217,27,36,.750,110
589,IND,2025-03-04,115,,HOU,W 115-102,240,44,86,.512,27,44,.614,17,42,.405,10,10,1.000,115,40,98,.408,31,68,.456,9,30,.300,13,26,.500,102
590,DET,2025-03-01,115,,BRK,W 115-94,240,39,72,.542,27,44,.614,12,28,.429,25,29,.862,115,29,95,.305,23,56,.411,6,39,.154,30,35,.857,94
591,ORL,2025-02-27,115,,GSW,L 115-121,240,45,89,.506,34,61,.557,11,28,.393,14,18,.778,115,36,79,.456,17,34,.500,19,45,.422,30,34,.882,121
592,OKC,2025-02-12,115,,MIA,W 115-101,240,43,88,.489,28,49,.571,15,39,.385,14,20,.700,115,36,79,.456,25,45,.556,11,34,.324,18,25,.720,101
593,IND,2025-02-11,115,,NYK,L 115-128,240,43,89,.483,34,58,.586,9,31,.290,20,26,.769,115,49,91,.538,39,64,.609,10,27,.370,20,23,.870,128
594,ATL,2025-02-07,115,,MIL,W 115-110,240,45,92,.489,32,56,.571,13,36,.361,12,18,.667,115,41,96,.427,22,46,.478,19,50,.380,9,10,.900,110
595,DET,2025-02-05,115,,CLE,L 115-118,240,39,98,.398,27,61,.443,12,37,.324,25,28,.893,115,41,85,.482,25,47,.532,16,38,.421,20,24,.833,118
596,TOR,2025-02-04,115,,NYK,L 115-121,240,43,82,.524,32,53,.604,11,29,.379,18,19,.947,115,47,94,.500,39,69,.565,8,25,.320,19,23,.826,121
597,TOR,2025-02-02,115,,LAC,W 115-108,240,44,85,.518,31,60,.517,13,25,.520,14,16,.875,115,41,88,.466,32,60,.533,9,28,.321,17,21,.810,108
598,OKC,2025-01-23,115,,DAL,L 115-121,240,42,88,.477,27,51,.529,15,37,.405,16,22,.727,115,39,74,.527,25,43,.581,14,31,.452,29,36,.806,121
599,BOS,2025-01-18,115,,ATL,L 115-119 (OT),265,40,104,.385,25,52,.481,15,52,.288,20,23,.870,115,44,93,.473,35,56,.625,9,37,.243,22,28,.786,119
600,IND,2025-01-18,115,,PHI,W 115-102,240,44,83,.530,33,49,.673,11,34,.324,16,23,.696,115,38,89,.427,28,55,.509,10,34,.294,16,22,.727,102
601,MIN,2025-01-15,115,,GSW,L 115-116,240,38,86,.442,21,49,.429,17,37,.459,22,29,.759,115,40,82,.488,22,46,.478,18,36,.500,18,21,.857,116
602,SAS,2025-01-15,115,,MEM,L 115-129,240,40,89,.449,24,46,.522,16,43,.372,19,27,.704,115,51,103,.495,35,65,.538,16,38,.421,11,17,.647,129
603,PHI,2025-01-10,115,,NOP,L 115-123,240,42,91,.462,28,53,.528,14,38,.368,17,19,.895,115,44,91,.484,26,51,.510,18,40,.450,17,26,.654,123
604,MEM,2025-01-09,115,,HOU,L 115-119,240,42,84,.500,32,52,.615,10,32,.313,21,30,.700,115,41,96,.427,28,62,.452,13,34,.382,24,41,.585,119
605,CHO,2025-01-07,115,,PHO,W 115-104,240,38,98,.388,25,51,.490,13,47,.277,26,29,.897,115,39,92,.424,31,59,.525,8,33,.242,18,19,.947,104
606,CLE,2025-01-05,115,,CHO,W 115-105,240,44,92,.478,29,49,.592,15,43,.349,12,16,.750,115,38,91,.418,23,49,.469,15,42,.357,14,19,.737,105
607,MIA,2025-01-02,115,,IND,L 115-128,240,43,75,.573,32,49,.653,11,26,.423,18,21,.857,115,51,96,.531,34,56,.607,17,40,.425,9,16,.563,128
608,MIN,2025-01-02,115,,BOS,L 115-118,240,37,74,.500,16,35,.457,21,39,.538,20,22,.909,115,46,92,.500,24,35,.686,22,57,.386,4,6,.667,118
609,CLE,2024-12-13,115,,WAS,W 115-105,240,36,91,.396,21,41,.512,15,50,.300,28,40,.700,115,41,86,.477,27,46,.587,14,40,.350,9,11,.818,105
610,ORL,2024-12-08,115,,PHO,W 115-110,240,42,88,.477,30,52,.577,12,36,.333,19,30,.633,115,39,83,.470,26,55,.473,13,28,.464,19,22,.864,110
611,MEM,2024-12-05,115,,SAC,W 115-110,240,38,80,.475,25,42,.595,13,38,.342,26,32,.813,115,39,98,.398,31,63,.492,8,35,.229,24,28,.857,110
612,CLE,2024-12-01,115,,BOS,W 115-111,240,39,80,.488,22,44,.500,17,36,.472,20,25,.800,115,38,95,.400,21,46,.457,17,49,.347,18,19,.947,111
613,POR,2024-11-29,115,,SAC,W 115-106,240,46,90,.511,35,53,.660,11,37,.297,12,15,.800,115,35,78,.449,20,36,.556,15,42,.357,21,28,.750,106
614,PHI,2024-11-27,115,,HOU,L 115-122 (OT),265,43,96,.448,31,63,.492,12,33,.364,17,23,.739,115,40,88,.455,30,57,.526,10,31,.323,32,38,.842,122
615,UTA,2024-11-26,115,,SAS,L 115-128,240,43,84,.512,30,49,.612,13,35,.371,16,20,.800,115,45,93,.484,27,45,.600,18,48,.375,20,26,.769,128
616,IND,2024-11-24,115,,WAS,W 115-103,240,41,86,.477,29,59,.492,12,27,.444,21,27,.778,115,36,79,.456,25,44,.568,11,35,.314,20,25,.800,103
617,CHO,2024-11-16,115,,MIL,W 115-114,240,41,93,.441,26,51,.510,15,42,.357,18,21,.857,115,47,92,.511,32,56,.571,15,36,.417,5,11,.455,114
618,SAS,2024-11-15,115,,LAL,L 115-120,240,43,88,.489,26,43,.605,17,45,.378,12,16,.750,115,44,88,.500,30,57,.526,14,31,.452,18,23,.783,120
619,UTA,2024-11-14,115,,DAL,W 115-113,240,43,85,.506,30,51,.588,13,34,.382,16,21,.762,115,43,85,.506,31,46,.674,12,39,.308,15,20,.750,113
620,ORL,2024-11-08,115,,NOP,W 115-88,240,45,86,.523,37,54,.685,8,32,.250,17,21,.810,115,32,84,.381,22,53,.415,10,31,.323,14,17,.824,88
621,PHO,2024-11-06,115,,MIA,W 115-112,240,42,84,.500,24,41,.585,18,43,.419,13,18,.722,115,40,92,.435,27,58,.466,13,34,.382,19,20,.950,112
622,DET,2024-11-04,115,,LAL,W 115-103,240,45,96,.469,37,62,.597,8,34,.235,17,22,.773,115,37,85,.435,28,60,.467,9,25,.360,20,27,.741,103
623,ATL,2024-11-01,115,,SAC,L 115-123,240,41,92,.446,22,42,.524,19,50,.380,14,18,.778,115,43,89,.483,32,56,.571,11,33,.333,26,30,.867,123
624,BRK,2024-10-27,115,,MIL,W 115-102,240,39,91,.429,23,46,.500,16,45,.356,21,23,.913,115,33,74,.446,23,41,.561,10,33,.303,26,31,.839,102
625,TOR,2024-10-25,115,,PHI,W 115-107,240,35,76,.461,29,53,.547,6,23,.261,39,46,.848,115,29,76,.382,20,47,.426,9,29,.310,40,53,.755,107
626,SAC,2024-10-24,115,,MIN,L 115-117,240,38,82,.463,27,53,.509,11,29,.379,28,35,.800,115,41,86,.477,21,36,.583,20,50,.400,15,17,.882,117
627,IND,2025-04-10,114,,CLE,W 114-112,240,43,93,.462,29,52,.558,14,41,.341,14,20,.700,114,43,98,.439,26,61,.426,17,37,.459,9,13,.692,112
628,LAC,2025-04-04,114,,DAL,W 114-91,240,44,89,.494,30,59,.508,14,30,.467,12,16,.750,114,35,77,.455,31,57,.544,4,20,.200,17,26,.654,91
629,LAC,2025-04-02,114,,NOP,W 114-98,240,40,76,.526,27,44,.614,13,32,.406,21,26,.808,114,43,85,.506,39,63,.619,4,22,.182,8,11,.727,98
630,PHI,2025-03-26,114,,WAS,L 114-119,240,42,98,.429,28,52,.538,14,46,.304,16,20,.800,114,48,95,.505,30,51,.588,18,44,.409,5,12,.417,119
631,BOS,2025-03-10,114,,UTA,W 114-108,240,40,93,.430,22,40,.550,18,53,.340,16,18,.889,114,43,95,.453,30,57,.526,13,38,.342,9,12,.750,108
632,NOP,2025-02-23,114,,SAS,W 114-96,240,42,94,.447,31,61,.508,11,33,.333,19,26,.731,114,32,97,.330,17,46,.370,15,51,.294,17,25,.680,96
633,MIN,2025-02-08,114,,POR,W 114-98,240,43,82,.524,33,54,.611,10,28,.357,18,28,.643,114,37,92,.402,30,57,.526,7,35,.200,17,22,.773,98
634,CHO,2025-02-03,114,,WAS,L 114-124,240,39,89,.438,28,60,.467,11,29,.379,25,28,.893,114,44,99,.444,27,48,.563,17,51,.333,19,23,.826,124
635,MIN,2025-02-03,114,,SAC,L 114-116,240,43,94,.457,31,54,.574,12,40,.300,16,16,1.000,114,45,92,.489,35,68,.515,10,24,.417,16,20,.800,116
636,GSW,2025-01-28,114,,UTA,W 114-103,240,36,92,.391,19,43,.442,17,49,.347,25,31,.806,114,39,76,.513,31,50,.620,8,26,.308,17,24,.708,103
637,DAL,2025-01-22,114,,MIN,L 114-115,240,45,90,.500,37,61,.607,8,29,.276,16,19,.842,114,37,81,.457,26,52,.500,11,29,.379,30,34,.882,115
638,POR,2025-01-14,114,,BRK,L 114-132,240,39,86,.453,22,48,.458,17,38,.447,19,24,.792,114,49,90,.544,30,49,.612,19,41,.463,15,18,.833,132
639,PHO,2025-01-11,114,,UTA,W 114-106,240,44,86,.512,31,49,.633,13,37,.351,13,19,.684,114,42,96,.438,33,54,.611,9,42,.214,13,18,.722,106
640,CHI,2025-01-06,114,,SAS,W 114-110,240,44,102,.431,31,63,.492,13,39,.333,13,15,.867,114,44,95,.463,29,49,.592,15,46,.326,7,12,.583,110
641,LAL,2025-01-02,114,,POR,W 114-106,240,43,94,.457,28,51,.549,15,43,.349,13,14,.929,114,40,80,.500,31,54,.574,9,26,.346,17,21,.810,106
642,BOS,2024-12-29,114,,IND,L 114-123,240,43,93,.462,27,39,.692,16,54,.296,12,19,.632,114,46,87,.529,37,64,.578,9,23,.391,22,27,.815,123
643,IND,2024-12-26,114,,OKC,L 114-120,240,42,89,.472,28,53,.528,14,36,.389,16,22,.727,114,44,95,.463,31,58,.534,13,37,.351,19,24,.792,120
644,BOS,2024-12-25,114,,PHI,L 114-118,240,43,95,.453,23,46,.500,20,49,.408,8,13,.615,114,41,88,.466,24,48,.500,17,40,.425,19,19,1.000,118
645,LAL,2024-12-23,114,,DET,L 114-117,240,40,74,.541,26,44,.591,14,30,.467,20,25,.800,114,47,92,.511,36,62,.581,11,30,.367,12,12,1.000,117
646,SAS,2024-12-21,114,,POR,W 114-94,240,44,93,.473,34,57,.596,10,36,.278,16,18,.889,114,38,96,.396,26,53,.491,12,43,.279,6,9,.667,94
647,MIA,2024-12-12,114,,TOR,W 114-104,240,40,83,.482,27,51,.529,13,32,.406,21,32,.656,114,41,92,.446,30,60,.500,11,32,.344,11,15,.733,104
648,MIL,2024-12-10,114,,ORL,W 114-109,240,42,77,.545,31,47,.660,11,30,.367,19,25,.760,114,41,93,.441,35,66,.530,6,27,.222,21,27,.778,109
649,GSW,2024-12-08,114,,MIN,W 114-106,240,42,90,.467,26,49,.531,16,41,.390,14,20,.700,114,36,79,.456,17,37,.459,19,42,.452,15,20,.750,106
650,IND,2024-11-25,114,,NOP,W 114-110,240,43,91,.473,26,44,.591,17,47,.362,11,16,.688,114,45,87,.517,36,54,.667,9,33,.273,11,19,.579,110
651,NYK,2024-11-17,114,,BRK,W 114-104,240,43,88,.489,30,48,.625,13,40,.325,15,19,.789,114,32,76,.421,15,35,.429,17,41,.415,23,30,.767,104
652,POR,2024-11-17,114,,ATL,W 114-110,240,44,95,.463,30,57,.526,14,38,.368,12,19,.632,114,39,85,.459,28,53,.528,11,32,.344,21,25,.840,110
653,BRK,2024-11-13,114,,BOS,L 114-139,240,40,79,.506,21,36,.583,19,43,.442,15,18,.833,114,50,93,.538,28,47,.596,22,46,.478,17,24,.708,139
654,ORL,2024-11-12,114,,CHO,W 114-89,240,43,93,.462,30,49,.612,13,44,.295,15,19,.789,114,34,84,.405,21,46,.457,13,38,.342,8,14,.571,89
655,MIN,2024-11-04,114,,CHO,W 114-93,240,39,79,.494,21,41,.512,18,38,.474,18,26,.692,114,35,88,.398,25,46,.543,10,42,.238,13,16,.813,93
656,POR,2024-11-01,114,,OKC,L 114-137,240,39,83,.470,24,48,.500,15,35,.429,21,31,.677,114,51,95,.537,32,46,.696,19,49,.388,16,19,.842,137
657,MIN,2024-10-29,114,,DAL,L 114-120,240,39,77,.506,20,38,.526,19,39,.487,17,26,.654,114,45,93,.484,29,54,.537,16,39,.410,14,18,.778,120
658,IND,2024-10-27,114,,PHI,L 114-118 (OT),265,39,84,.464,26,52,.500,13,32,.406,23,34,.676,114,42,98,.429,31,56,.554,11,42,.262,23,31,.742,118
659,PHO,2024-10-26,114,,DAL,W 114-102,240,36,80,.450,22,41,.537,14,39,.359,28,37,.757,114,37,93,.398,24,52,.462,13,41,.317,15,18,.833,102
660,CLE,2025-04-06,113,,SAC,L 113-120,240,46,88,.523,36,50,.720,10,38,.263,11,19,.579,113,44,82,.537,30,49,.612,14,33,.424,18,22,.818,120
661,SAS,2025-04-04,113,,CLE,L 113-114,240,41,94,.436,25,46,.543,16,48,.333,15,19,.789,113,41,87,.471,19,36,.528,22,51,.431,10,14,.714,114
662,PHI,2025-04-03,113,,MIL,L 113-126,240,43,89,.483,31,50,.620,12,39,.308,15,19,.789,113,46,82,.561,30,51,.588,16,31,.516,18,27,.667,126
663,ATL,2025-04-01,113,,POR,L 113-127,240,41,92,.446,34,60,.567,7,32,.219,24,28,.857,113,47,103,.456,34,62,.548,13,41,.317,20,27,.741,127
664,NYK,2025-03-26,113,,LAC,L 113-126,240,42,84,.500,29,50,.580,13,34,.382,16,22,.727,113,45,88,.511,29,58,.500,16,30,.533,20,24,.833,126
665,MIA,2025-03-19,113,,DET,L 113-116,240,44,90,.489,34,58,.586,10,32,.313,15,18,.833,113,46,91,.505,37,68,.544,9,23,.391,15,18,.833,116
666,BRK,2025-03-15,113,,BOS,L 113-115,240,42,90,.467,22,44,.500,20,46,.435,9,13,.692,113,44,84,.524,31,46,.674,13,38,.342,14,19,.737,115
667,POR,2025-03-12,113,,NYK,L 113-114 (OT),265,40,90,.444,23,48,.479,17,42,.405,16,25,.640,113,44,94,.468,32,63,.508,12,31,.387,14,20,.700,114
668,LAL,2025-03-06,113,,NYK,W 113-109 (OT),265,38,89,.427,24,47,.511,14,42,.333,23,28,.821,113,37,94,.394,27,51,.529,10,43,.233,25,32,.781,109
669,ORL,2025-03-04,113,,TOR,L 113-114,240,40,83,.482,25,47,.532,15,36,.417,18,23,.783,113,38,80,.475,26,50,.520,12,30,.400,26,35,.743,114
670,MEM,2025-02-28,113,,NYK,L 113-114,240,44,94,.468,40,63,.635,4,31,.129,21,22,.955,113,44,95,.463,31,57,.544,13,38,.342,13,16,.813,114
671,NYK,2025-02-20,113,,CHI,W 113-111 (OT),265,46,107,.430,32,61,.525,14,46,.304,7,10,.700,113,41,103,.398,22,55,.400,19,48,.396,10,12,.833,111
672,UTA,2025-02-01,113,,ORL,W 113-99,240,39,84,.464,25,49,.510,14,35,.400,21,24,.875,113,30,91,.330,21,50,.420,9,41,.220,30,35,.857,99
673,UTA,2025-01-30,113,,MIN,L 113-138,240,39,77,.506,25,43,.581,14,34,.412,21,25,.840,113,49,82,.598,28,44,.636,21,38,.553,19,24,.792,138
674,PHO,2025-01-29,113,,MIN,L 113-121,240,43,85,.506,31,53,.585,12,32,.375,15,20,.750,113,42,75,.560,29,46,.630,13,29,.448,24,27,.889,121
675,TOR,2025-01-27,113,,NOP,W 113-104,240,43,100,.430,34,67,.507,9,33,.273,18,23,.783,113,39,89,.438,33,61,.541,6,28,.214,20,30,.667,104
676,LAC,2025-01-22,113,,BOS,L 113-117 (OT),265,47,90,.522,38,62,.613,9,28,.321,10,13,.769,113,41,90,.456,22,40,.550,19,50,.380,16,20,.800,117
677,POR,2025-01-19,113,,CHI,W 113-102,240,42,89,.472,33,58,.569,9,31,.290,20,25,.800,113,36,81,.444,28,52,.538,8,29,.276,22,26,.846,102
678,MIA,2025-01-17,113,,DEN,L 113-133,240,45,91,.495,36,58,.621,9,33,.273,14,14,1.000,113,50,92,.543,34,59,.576,16,33,.485,17,19,.895,133
679,CHI,2025-01-14,113,,NOP,L 113-119,240,45,102,.441,31,59,.525,14,43,.326,9,12,.750,113,42,96,.438,28,46,.609,14,50,.280,21,26,.808,119
680,SAC,2025-01-01,113,,PHI,W 113-107,240,41,84,.488,32,53,.604,9,31,.290,22,24,.917,113,40,84,.476,25,44,.568,15,40,.375,12,14,.857,107
681,OKC,2024-12-31,113,,MIN,W 113-105,240,42,89,.472,30,53,.566,12,36,.333,17,23,.739,113,39,79,.494,24,41,.585,15,38,.395,12,12,1.000,105
682,NOP,2024-12-30,113,,LAC,L 113-116,240,42,82,.512,24,45,.533,18,37,.486,11,14,.786,113,41,86,.477,28,49,.571,13,37,.351,21,27,.778,116
683,SAC,2024-12-26,113,,DET,L 113-114,240,39,82,.476,25,43,.581,14,39,.359,21,26,.808,113,38,91,.418,21,47,.447,17,44,.386,21,25,.840,114
684,WAS,2024-12-26,113,,CHO,W 113-110,240,39,91,.429,25,47,.532,14,44,.318,21,28,.750,113,41,94,.436,24,52,.462,17,42,.405,11,14,.786,110
685,GSW,2024-12-25,113,,LAL,L 113-115,240,41,89,.461,23,44,.523,18,45,.400,13,17,.765,113,41,91,.451,26,49,.531,15,42,.357,18,18,1.000,115
686,DAL,2024-12-21,113,,LAC,W 113-97,240,40,88,.455,26,53,.491,14,35,.400,19,22,.864,113,34,81,.420,24,44,.545,10,37,.270,19,22,.864,97
687,BRK,2024-12-08,113,,MIL,L 113-118,240,41,81,.506,25,46,.543,16,35,.457,15,16,.938,113,39,68,.574,24,37,.649,15,31,.484,25,32,.781,118
688,SAS,2024-12-06,113,,SAC,L 113-140,240,39,91,.429,25,50,.500,14,41,.341,21,30,.700,113,51,90,.567,35,56,.625,16,34,.471,22,24,.917,140
689,PHO,2024-11-30,113,,GSW,W 113-105,240,38,79,.481,20,44,.455,18,35,.514,19,22,.864,113,38,92,.413,24,52,.462,14,40,.350,15,18,.833,105
690,PHI,2024-11-22,113,,BRK,W 113-98,240,41,92,.446,25,49,.510,16,43,.372,15,20,.750,113,39,79,.494,26,42,.619,13,37,.351,7,7,1.000,98
691,CHI,2024-11-11,113,,CLE,L 113-119,240,43,87,.494,29,49,.592,14,38,.368,13,16,.813,113,43,97,.443,28,52,.538,15,45,.333,18,24,.750,119
692,ATL,2024-11-09,113,,CHI,L 113-125,240,41,89,.461,32,60,.533,9,29,.310,22,30,.733,113,46,92,.500,33,53,.623,13,39,.333,20,23,.870,125
693,DAL,2024-11-08,113,,PHO,L 113-114,240,41,80,.513,30,47,.638,11,33,.333,20,22,.909,113,43,86,.500,28,47,.596,15,39,.385,13,18,.722,114
694,LAC,2024-11-04,113,,SAS,W 113-104,240,41,90,.456,22,53,.415,19,37,.514,12,17,.706,113,38,86,.442,27,45,.600,11,41,.268,17,19,.895,104
695,MIL,2024-11-02,113,,CLE,L 113-114,240,43,89,.483,25,50,.500,18,39,.462,9,15,.600,113,44,91,.484,29,53,.547,15,38,.395,11,15,.733,114
696,SAS,2024-11-02,113,,MIN,W 113-103,240,43,83,.518,30,41,.732,13,42,.310,14,17,.824,113,39,82,.476,28,45,.622,11,37,.297,14,20,.700,103
697,CLE,2024-10-25,113,,DET,W 113-101,240,42,82,.512,29,48,.604,13,34,.382,16,23,.696,113,38,81,.469,25,49,.510,13,32,.406,12,17,.706,101
698,LAC,2024-10-23,113,,PHO,L 113-116 (OT),265,42,92,.457,34,63,.540,8,29,.276,21,30,.700,113,38,78,.487,23,40,.575,15,38,.395,25,34,.735,116
699,PHO,2025-04-09,112,,OKC,L 112-125,240,42,87,.483,27,45,.600,15,42,.357,13,19,.684,112,45,86,.523,33,56,.589,12,30,.400,23,27,.852,125
700,NYK,2025-04-06,112,,PHO,W 112-98,240,40,74,.541,28,46,.609,12,28,.429,20,24,.833,112,39,92,.424,35,58,.603,4,34,.118,16,19,.842,98
701,WAS,2025-03-29,112,,BRK,L 112-115,240,37,85,.435,28,51,.549,9,34,.265,29,33,.879,112,39,88,.443,21,42,.500,18,46,.391,19,20,.950,115
702,MIA,2025-03-25,112,,GSW,W 112-86,240,43,77,.558,26,52,.500,17,25,.680,9,12,.750,112,33,83,.398,24,45,.533,9,38,.237,11,16,.688,86
703,NOP,2025-03-24,112,,PHI,W 112-99,240,43,87,.494,28,52,.538,15,35,.429,11,13,.846,112,34,87,.391,20,45,.444,14,42,.333,17,19,.895,99
704,POR,2025-03-17,112,,WAS,W 112-97,240,42,99,.424,27,53,.509,15,46,.326,13,19,.684,112,38,92,.413,26,52,.500,12,40,.300,9,12,.750,97
705,BOS,2025-03-12,112,,OKC,L 112-118,240,41,94,.436,21,31,.677,20,63,.317,10,12,.833,112,40,82,.488,27,45,.600,13,37,.351,25,35,.714,118
706,POR,2025-03-09,112,,DET,L 112-119,240,36,93,.387,21,43,.488,15,50,.300,25,32,.781,112,43,87,.494,34,59,.576,9,28,.321,24,32,.750,119
707,CLE,2025-03-05,112,,MIA,W 112-107,240,41,87,.471,27,47,.574,14,40,.350,16,22,.727,112,36,83,.434,23,47,.489,13,36,.361,22,25,.880,107
708,MIA,2025-03-02,112,,NYK,L 112-116 (OT),265,45,84,.536,34,49,.694,11,35,.314,11,16,.688,112,46,95,.484,32,51,.627,14,44,.318,10,15,.667,116
709,UTA,2025-02-24,112,,POR,L 112-114,240,39,98,.398,21,54,.389,18,44,.409,16,19,.842,112,41,98,.418,27,54,.500,14,44,.318,18,24,.750,114
710,PHO,2025-02-11,112,,MEM,L 112-119,240,41,92,.446,29,48,.604,12,44,.273,18,22,.818,112,43,100,.430,31,61,.508,12,39,.308,21,27,.778,119
711,DET,2025-02-09,112,,CHO,W 112-102,240,44,90,.489,33,53,.623,11,37,.297,13,16,.813,112,34,78,.436,19,46,.413,15,32,.469,19,23,.826,102
712,MEM,2025-02-08,112,,OKC,L 112-125,240,36,81,.444,24,53,.453,12,28,.429,28,39,.718,112,45,105,.429,27,63,.429,18,42,.429,17,21,.810,125
713,ORL,2025-02-08,112,,SAS,W 112-111,240,45,88,.511,35,58,.603,10,30,.333,12,20,.600,112,41,77,.532,28,47,.596,13,30,.433,16,20,.800,111
714,DEN,2025-02-06,112,,ORL,W 112-90,240,44,83,.530,32,53,.604,12,30,.400,12,21,.571,112,31,84,.369,26,53,.491,5,31,.161,23,30,.767,90
715,LAC,2025-02-06,112,,IND,L 112-119,240,41,88,.466,24,48,.500,17,40,.425,13,18,.722,112,43,95,.453,30,56,.536,13,39,.333,20,24,.833,119
716,POR,2025-02-04,112,,IND,W 112-89,240,41,92,.446,27,55,.491,14,37,.378,16,17,.941,112,34,81,.420,29,57,.509,5,24,.208,16,21,.762,89
717,NYK,2025-02-01,112,,LAL,L 112-128,240,44,95,.463,34,67,.507,10,28,.357,14,19,.737,112,47,81,.580,28,41,.683,19,40,.475,15,18,.833,128
718,BOS,2025-01-27,112,,HOU,L 112-114,240,39,80,.488,24,41,.585,15,39,.385,19,20,.950,112,41,92,.446,24,51,.471,17,41,.415,15,21,.714,114
719,SAS,2025-01-17,112,,MEM,L 112-140,240,40,84,.476,27,48,.563,13,36,.361,19,23,.826,112,55,97,.567,36,53,.679,19,44,.432,11,15,.733,140
720,UTA,2025-01-15,112,,CHO,L 112-117,240,43,93,.462,27,50,.540,16,43,.372,10,17,.588,112,45,85,.529,33,46,.717,12,39,.308,15,21,.714,117
721,UTA,2025-01-12,112,,BRK,W 112-111 (OT),265,40,90,.444,23,46,.500,17,44,.386,15,20,.750,112,39,92,.424,29,52,.558,10,40,.250,23,35,.657,111
722,NYK,2025-01-08,112,,TOR,W 112-98,240,42,88,.477,30,55,.545,12,33,.364,16,20,.800,112,38,77,.494,28,51,.549,10,26,.385,12,15,.800,98
723,WAS,2025-01-07,112,,HOU,L 112-135,240,41,89,.461,26,49,.531,15,40,.375,15,20,.750,112,50,97,.515,35,59,.593,15,38,.395,20,23,.870,135
724,IND,2024-12-31,112,,MIL,L 112-120,240,40,90,.444,27,53,.509,13,37,.351,19,30,.633,112,45,97,.464,33,64,.516,12,33,.364,18,24,.750,120
725,PHO,2024-12-31,112,,MEM,L 112-117,240,42,92,.457,33,62,.532,9,30,.300,19,25,.760,112,40,94,.426,25,50,.500,15,44,.341,22,33,.667,117
726,MIN,2024-12-29,112,,SAS,W 112-110,240,43,100,.430,32,56,.571,11,44,.250,15,19,.789,112,38,87,.437,27,48,.563,11,39,.282,23,28,.821,110
727,HOU,2024-12-27,112,,MIN,L 112-113,240,45,92,.489,35,62,.565,10,30,.333,12,19,.632,112,42,83,.506,21,40,.525,21,43,.488,8,16,.500,113
728,ATL,2024-12-21,112,,MEM,L 112-128,240,39,80,.488,25,42,.595,14,38,.368,20,24,.833,112,50,97,.515,32,56,.571,18,41,.439,10,13,.769,128
729,MIL,2024-12-21,112,,WAS,W 112-101,240,44,98,.449,24,50,.480,20,48,.417,4,5,.800,112,36,81,.444,18,39,.462,18,42,.429,11,16,.688,101
730,WAS,2024-12-08,112,,MEM,L 112-140,240,43,100,.430,37,68,.544,6,32,.188,20,22,.909,112,50,96,.521,33,53,.623,17,43,.395,23,29,.793,140
731,DET,2024-11-18,112,,CHI,L 112-122,240,42,98,.429,27,54,.500,15,44,.341,13,19,.684,112,44,91,.484,21,45,.467,23,46,.500,11,14,.786,122
732,UTA,2024-11-12,112,,PHO,L 112-120,240,45,92,.489,30,54,.556,15,38,.395,7,9,.778,112,43,86,.500,25,47,.532,18,39,.462,16,22,.727,120
733,BOS,2024-11-06,112,,GSW,L 112-118,240,38,90,.422,19,36,.528,19,54,.352,17,21,.810,112,42,91,.462,28,57,.491,14,34,.412,20,24,.833,118
734,WAS,2024-11-04,112,,GSW,L 112-125,240,42,96,.438,32,53,.604,10,43,.233,18,21,.857,112,44,97,.454,32,60,.533,12,37,.324,25,34,.735,125
735,MIN,2024-10-26,112,,TOR,W 112-101,240,39,83,.470,25,46,.543,14,37,.378,20,26,.769,112,41,90,.456,31,61,.508,10,29,.345,9,13,.692,101
736,HOU,2025-04-13,111,,DEN,L 111-126,240,45,100,.450,33,66,.500,12,34,.353,9,14,.643,111,45,88,.511,35,59,.593,10,29,.345,26,31,.839,126
737,UTA,2025-04-11,111,,OKC,L 111-145,240,39,103,.379,22,40,.550,17,63,.270,16,20,.800,111,56,100,.560,32,47,.681,24,53,.453,9,13,.692,145
738,GSW,2025-04-09,111,,SAS,L 111-114,240,36,86,.419,20,38,.526,16,48,.333,23,28,.821,111,39,81,.481,21,35,.600,18,46,.391,18,21,.857,114
739,IND,2025-03-31,111,,SAC,W 111-109,240,42,90,.467,28,49,.571,14,41,.341,13,13,1.000,111,43,92,.467,31,65,.477,12,27,.444,11,17,.647,109
740,SAS,2025-03-29,111,,BOS,L 111-121,240,38,87,.437,24,47,.511,14,40,.350,21,27,.778,111,45,94,.479,28,43,.651,17,51,.333,14,18,.778,121
741,POR,2025-03-25,111,,CLE,L 111-122,240,40,100,.400,23,48,.479,17,52,.327,14,22,.636,111,48,88,.545,36,61,.590,12,27,.444,14,17,.824,122
742,HOU,2025-03-23,111,,DEN,L 111-116,240,39,89,.438,28,55,.509,11,34,.324,22,34,.647,111,44,87,.506,34,66,.515,10,21,.476,18,26,.692,116
743,HOU,2025-03-12,111,,PHO,W 111-104,240,40,88,.455,28,50,.560,12,38,.316,19,25,.760,111,39,73,.534,29,45,.644,10,28,.357,16,20,.800,104
744,BRK,2025-03-10,111,,LAL,W 111-108,240,37,90,.411,19,45,.422,18,45,.400,19,30,.633,111,37,85,.435,18,45,.400,19,40,.475,15,19,.789,108
745,LAC,2025-03-09,111,,SAC,W 111-110 (OT),265,43,81,.531,33,50,.660,10,31,.323,15,25,.600,111,40,87,.460,31,53,.585,9,34,.265,21,25,.840,110
746,BOS,2025-03-08,111,,LAL,W 111-101,240,40,84,.476,27,46,.587,13,38,.342,18,25,.720,111,39,87,.448,25,47,.532,14,40,.350,9,14,.643,101
747,DAL,2025-03-07,111,,MEM,L 111-122,240,37,96,.385,22,55,.400,15,41,.366,22,24,.917,111,50,106,.472,42,85,.494,8,21,.381,14,16,.875,122
748,LAL,2025-02-27,111,,MIN,W 111-102,240,34,82,.415,23,41,.561,11,41,.268,32,46,.696,111,35,84,.417,23,43,.535,12,41,.293,20,26,.769,102
749,IND,2025-02-26,111,,TOR,W 111-91,240,43,81,.531,28,44,.636,15,37,.405,10,16,.625,111,37,87,.425,31,60,.517,6,27,.222,11,16,.688,91
750,DAL,2025-02-21,111,,NOP,W 111-103,240,37,86,.430,21,42,.500,16,44,.364,21,27,.778,111,38,92,.413,30,65,.462,8,27,.296,19,25,.760,103
751,TOR,2025-02-21,111,,MIA,L 111-120 (OT),265,38,91,.418,21,48,.438,17,43,.395,18,23,.783,111,46,90,.511,33,54,.611,13,36,.361,15,18,.833,120
752,DAL,2025-02-12,111,,GSW,W 111-107,240,42,87,.483,27,51,.529,15,36,.417,12,15,.800,111,41,96,.427,31,61,.508,10,35,.286,15,18,.833,107
753,NOP,2025-02-12,111,,SAC,L 111-119,240,44,94,.468,36,62,.581,8,32,.250,15,18,.833,111,41,87,.471,25,42,.595,16,45,.356,21,29,.724,119
754,MIL,2025-02-10,111,,GSW,L 111-125,240,38,76,.500,28,43,.651,10,33,.303,25,34,.735,111,41,93,.441,28,48,.583,13,45,.289,30,38,.789,125
755,CHI,2025-02-08,111,,GSW,L 111-132,240,35,79,.443,18,40,.450,17,39,.436,24,31,.774,111,45,90,.500,26,42,.619,19,48,.396,23,27,.852,132
756,WAS,2025-02-08,111,,ATL,L 111-125,240,41,93,.441,32,57,.561,9,36,.250,20,21,.952,111,47,97,.485,29,53,.547,18,44,.409,13,17,.765,125
757,SAC,2025-02-05,111,,ORL,L 111-130,240,40,80,.500,30,53,.566,10,27,.370,21,28,.750,111,50,88,.568,34,57,.596,16,31,.516,14,15,.933,130
758,UTA,2025-02-03,111,,IND,L 111-112,240,39,91,.429,26,54,.481,13,37,.351,20,30,.667,111,43,91,.473,33,49,.673,10,42,.238,16,20,.800,112
759,PHO,2025-01-27,111,,LAC,W 111-109,240,40,85,.471,18,38,.474,22,47,.468,9,11,.818,111,41,83,.494,31,51,.608,10,32,.313,17,20,.850,109
760,LAL,2025-01-21,111,,WAS,W 111-88,240,43,90,.478,32,56,.571,11,34,.324,14,18,.778,111,34,95,.358,23,52,.442,11,43,.256,9,13,.692,88
761,SAS,2025-01-04,111,,DEN,L 111-122 (OT),265,41,104,.394,28,56,.500,13,48,.271,16,18,.889,111,47,108,.435,37,75,.493,10,33,.303,18,23,.783,122
762,UTA,2024-12-28,111,,PHI,L 111-114,240,43,89,.483,31,53,.585,12,36,.333,13,15,.867,111,36,83,.434,23,47,.489,13,36,.361,29,37,.784,114
763,NOP,2024-12-26,111,,HOU,L 111-128,240,43,99,.434,31,62,.500,12,37,.324,13,18,.722,111,46,97,.474,28,50,.560,18,47,.383,18,23,.783,128
764,PHI,2024-12-23,111,,SAS,W 111-106,240,39,93,.419,23,49,.469,16,44,.364,17,23,.739,111,37,81,.457,22,36,.611,15,45,.333,17,18,.944,106
765,PHO,2024-12-19,111,,IND,L 111-120,240,40,82,.488,31,52,.596,9,30,.300,22,28,.786,111,39,89,.438,23,48,.479,16,41,.390,26,31,.839,120
766,OKC,2024-12-14,111,,HOU,W 111-96,240,36,80,.450,25,50,.500,11,30,.367,28,32,.875,111,35,96,.365,24,50,.480,11,46,.239,15,25,.600,96
767,ATL,2024-12-08,111,,DEN,L 111-141,240,41,101,.406,32,61,.525,9,40,.225,20,27,.741,111,56,89,.629,44,62,.710,12,27,.444,17,24,.708,141
768,NYK,2024-12-07,111,,DET,L 111-120,240,42,79,.532,31,45,.689,11,34,.324,16,27,.593,111,43,83,.518,25,47,.532,18,36,.500,16,19,.842,120
769,BOS,2024-12-06,111,,MIL,W 111-105,240,40,87,.460,23,34,.676,17,53,.321,14,16,.875,111,40,94,.426,29,65,.446,11,29,.379,14,17,.824,105
770,MIN,2024-11-26,111,,HOU,L 111-117 (OT),265,42,98,.429,33,60,.550,9,38,.237,18,20,.900,111,45,99,.455,30,62,.484,15,37,.405,12,13,.923,117
771,ORL,2024-11-23,111,,DET,W 111-100,240,40,87,.460,28,48,.583,12,39,.308,19,22,.864,111,35,75,.467,22,42,.524,13,33,.394,17,22,.773,100
772,IND,2024-11-15,111,,MIA,L 111-124,240,44,86,.512,30,51,.588,14,35,.400,9,11,.818,111,45,87,.517,30,45,.667,15,42,.357,19,23,.826,124
773,HOU,2024-11-13,111,,LAC,W 111-103,240,42,97,.433,27,57,.474,15,40,.375,12,17,.706,111,38,96,.396,24,58,.414,14,38,.368,13,16,.813,103
774,NOP,2024-11-03,111,,ATL,L 111-126,240,39,90,.433,23,52,.442,16,38,.421,17,20,.850,111,50,88,.568,35,52,.673,15,36,.417,11,12,.917,126
775,SAC,2024-10-28,111,,POR,W 111-98,240,37,81,.457,23,46,.500,14,35,.400,23,25,.920,111,35,83,.422,31,61,.508,4,22,.182,24,30,.800,98
776,PHI,2025-04-11,110,,ATL,L 110-124,240,43,97,.443,31,62,.500,12,35,.343,12,15,.800,110,45,94,.479,29,52,.558,16,42,.381,18,24,.750,124
777,MIL,2025-04-08,110,,MIN,W 110-103,240,40,84,.476,28,48,.583,12,36,.333,18,25,.720,110,41,89,.461,28,49,.571,13,40,.325,8,9,.889,103
778,CHO,2025-03-31,110,,UTA,W 110-106,240,43,80,.538,28,42,.667,15,38,.395,9,14,.643,110,39,96,.406,25,44,.568,14,52,.269,14,15,.933,106
779,NYK,2025-03-30,110,,POR,W 110-93,240,45,84,.536,35,59,.593,10,25,.400,10,13,.769,110,38,87,.437,29,51,.569,9,36,.250,8,14,.571,93
780,UTA,2025-03-27,110,,HOU,L 110-121,240,43,79,.544,32,56,.571,11,23,.478,13,17,.765,110,47,102,.461,35,65,.538,12,37,.324,15,19,.789,121
781,CHO,2025-03-05,110,,MIN,L 110-125,240,42,95,.442,30,53,.566,12,42,.286,14,18,.778,110,44,90,.489,23,41,.561,21,49,.429,16,22,.727,125
782,BOS,2025-03-02,110,,DEN,W 110-103,240,37,78,.474,23,44,.523,14,34,.412,22,27,.815,110,41,86,.477,29,51,.569,12,35,.343,9,13,.692,103
783,NYK,2025-02-26,110,,PHI,W 110-105,240,40,77,.519,33,58,.569,7,19,.368,23,29,.793,110,39,88,.443,28,54,.519,11,34,.324,16,20,.800,105
784,PHI,2025-02-24,110,,CHI,L 110-142,240,37,95,.389,27,55,.491,10,40,.250,26,29,.897,110,45,89,.506,27,49,.551,18,40,.450,34,36,.944,142
785,ORL,2025-02-23,110,,WAS,W 110-90,240,40,90,.444,29,58,.500,11,32,.344,19,22,.864,110,32,78,.410,22,40,.550,10,38,.263,16,22,.727,90
786,SAS,2025-02-21,110,,DET,L 110-125,240,43,84,.512,33,55,.600,10,29,.345,14,22,.636,110,47,94,.500,35,59,.593,12,35,.343,19,22,.864,125
787,CHI,2025-02-12,110,,DET,L 110-128,240,37,86,.430,28,45,.622,9,41,.220,27,30,.900,110,45,88,.511,35,63,.556,10,25,.400,28,35,.800,128
788,PHI,2025-02-02,110,,BOS,L 110-118,240,37,82,.451,22,50,.440,15,32,.469,21,28,.750,110,42,84,.500,21,35,.600,21,49,.429,13,16,.813,118
789,CLE,2025-01-27,110,,DET,W 110-91,240,40,91,.440,28,47,.596,12,44,.273,18,23,.783,110,37,96,.385,27,60,.450,10,36,.278,7,11,.636,91
790,UTA,2025-01-27,110,,MIL,L 110-125,240,41,100,.410,23,46,.500,18,54,.333,10,13,.769,110,52,86,.605,40,52,.769,12,34,.353,9,17,.529,125
791,IND,2025-01-23,110,,SAS,L 110-140,240,44,97,.454,31,54,.574,13,43,.302,9,12,.750,110,58,96,.604,40,60,.667,18,36,.500,6,6,1.000,140
792,LAC,2025-01-23,110,,WAS,W 110-93,240,40,88,.455,27,50,.540,13,38,.342,17,18,.944,110,32,94,.340,21,48,.438,11,46,.239,18,21,.857,93
793,CHO,2025-01-20,110,,DAL,W 110-105,240,40,98,.408,23,59,.390,17,39,.436,13,18,.722,110,38,88,.432,32,56,.571,6,32,.188,23,26,.885,105
794,TOR,2025-01-15,110,,BOS,W 110-97,240,45,89,.506,34,55,.618,11,34,.324,9,15,.600,110,36,91,.396,20,45,.444,16,46,.348,9,18,.500,97
795,DEN,2025-01-03,110,,SAS,L 110-113,240,42,97,.433,27,58,.466,15,39,.385,11,16,.688,110,46,99,.465,33,63,.524,13,36,.361,8,13,.615,113
796,MIL,2025-01-02,110,,BRK,L 110-113,240,40,90,.444,29,53,.547,11,37,.297,19,28,.679,110,38,88,.432,26,49,.531,12,39,.308,25,28,.893,113
797,HOU,2025-01-01,110,,DAL,W 110-99,240,42,89,.472,34,64,.531,8,25,.320,18,23,.783,110,40,75,.533,29,47,.617,11,28,.393,8,16,.500,99
798,LAL,2024-12-31,110,,CLE,L 110-122,240,42,95,.442,33,60,.550,9,35,.257,17,19,.895,110,45,93,.484,27,47,.574,18,46,.391,14,17,.824,122
799,SAC,2024-12-30,110,,DAL,W 110-100,240,42,100,.420,32,68,.471,10,32,.313,16,19,.842,110,32,76,.421,20,45,.444,12,31,.387,24,29,.828,100
800,PHO,2024-12-25,110,,DEN,W 110-100,240,41,88,.466,30,52,.577,11,36,.306,17,20,.850,110,36,78,.462,28,49,.571,8,29,.276,20,28,.714,100
801,MEM,2024-12-23,110,,LAC,L 110-114,240,38,99,.384,22,57,.386,16,42,.381,18,26,.692,110,42,96,.438,33,69,.478,9,27,.333,21,26,.808,114
802,MIA,2024-12-23,110,,BRK,W 110-95,240,36,73,.493,19,32,.594,17,41,.415,21,24,.875,110,33,84,.393,20,50,.400,13,34,.382,16,20,.800,95
803,TOR,2024-12-22,110,,HOU,L 110-114,240,42,92,.457,25,49,.510,17,43,.395,9,13,.692,110,40,89,.449,33,61,.541,7,28,.250,27,33,.818,114
804,MIL,2024-12-14,110,,ATL,W 110-102,240,39,86,.453,25,41,.610,14,45,.311,18,27,.667,110,35,82,.427,25,58,.431,10,24,.417,22,34,.647,102
805,TOR,2024-11-21,110,,MIN,W 110-105,240,37,72,.514,30,49,.612,7,23,.304,29,39,.744,110,33,80,.413,21,45,.467,12,35,.343,27,33,.818,105
806,MEM,2024-11-19,110,,DEN,L 110-122,240,41,103,.398,32,65,.492,9,38,.237,19,31,.613,110,48,100,.480,36,64,.563,12,36,.333,14,22,.636,122
807,SAS,2024-11-19,110,,OKC,W 110-104,240,39,83,.470,20,37,.541,19,46,.413,13,19,.684,110,41,100,.410,25,47,.532,16,53,.302,6,7,.857,104
808,DAL,2024-11-16,110,,SAS,W 110-93,240,44,94,.468,36,63,.571,8,31,.258,14,18,.778,110,28,88,.318,17,48,.354,11,40,.275,26,30,.867,93
809,SAS,2024-11-09,110,,UTA,L 110-111,240,38,85,.447,21,38,.553,17,47,.362,17,19,.895,110,38,82,.463,28,49,.571,10,33,.303,25,35,.714,111
810,LAC,2024-11-06,110,,PHI,W 110-98,240,41,72,.569,29,44,.659,12,28,.429,16,19,.842,110,40,73,.548,33,48,.688,7,25,.280,11,19,.579,98
811,MIA,2024-11-04,110,,SAC,L 110-111,240,37,85,.435,22,49,.449,15,36,.417,21,30,.700,110,44,86,.512,34,59,.576,10,27,.370,13,15,.867,111
812,DAL,2024-10-28,110,,UTA,W 110-102,240,43,95,.453,32,56,.571,11,39,.282,13,17,.765,110,34,92,.370,24,57,.421,10,35,.286,24,29,.828,102
813,LAL,2024-10-22,110,,MIN,W 110-103,240,42,95,.442,37,65,.569,5,30,.167,21,25,.840,110,35,85,.412,22,44,.500,13,41,.317,20,27,.741,103
814,POR,2025-04-13,109,,LAL,W 109-81,240,42,96,.438,27,54,.500,15,42,.357,10,21,.476,109,31,80,.388,22,52,.423,9,28,.321,10,14,.714,81
815,SAC,2025-04-13,109,,PHO,W 109-98,240,46,88,.523,32,54,.593,14,34,.412,3,3,1.000,109,40,84,.476,25,40,.625,15,44,.341,3,6,.500,98
816,BRK,2025-04-10,109,,ATL,L 109-133,240,36,90,.400,14,38,.368,22,52,.423,15,22,.682,109,48,84,.571,33,48,.688,15,36,.417,22,33,.667,133
817,BRK,2025-04-06,109,,TOR,L 109-120,240,39,82,.476,29,47,.617,10,35,.286,21,27,.778,109,47,94,.500,35,58,.603,12,36,.333,14,22,.636,120
818,PHI,2025-04-05,109,,MIN,L 109-114,240,44,91,.484,32,56,.571,12,35,.343,9,15,.600,109,41,81,.506,30,47,.638,11,34,.324,21,29,.724,114
819,DAL,2025-03-31,109,,BRK,L 109-113,240,41,86,.477,31,56,.554,10,30,.333,17,29,.586,109,39,90,.433,19,39,.487,20,51,.392,15,20,.750,113
820,PHI,2025-03-30,109,,TOR,L 109-127,240,42,89,.472,34,60,.567,8,29,.276,17,19,.895,109,49,103,.476,32,65,.492,17,38,.447,12,18,.667,127
821,PHO,2025-03-30,109,,HOU,L 109-148,240,42,87,.483,32,55,.582,10,32,.313,15,17,.882,109,56,98,.571,38,67,.567,18,31,.581,18,25,.720,148
822,WAS,2025-03-27,109,,IND,L 109-162,240,38,85,.447,27,55,.491,11,30,.367,22,26,.846,109,59,92,.641,32,45,.711,27,47,.574,17,19,.895,162
823,CLE,2025-03-11,109,,BRK,W 109-104,240,39,89,.438,29,47,.617,10,42,.238,21,25,.840,109,39,84,.464,23,40,.575,16,44,.364,10,14,.714,104
824,MIA,2025-03-08,109,,CHI,L 109-114,240,41,97,.423,28,54,.519,13,43,.302,14,19,.737,109,40,88,.455,29,46,.630,11,42,.262,23,26,.885,114
825,MIL,2025-03-08,109,,ORL,L 109-111,240,41,75,.547,30,52,.577,11,23,.478,16,23,.696,109,42,82,.512,30,50,.600,12,32,.375,15,19,.789,111
826,NOP,2025-02-25,109,,SAS,W 109-103,240,41,94,.436,34,63,.540,7,31,.226,20,25,.800,109,38,93,.409,25,49,.510,13,44,.295,14,18,.778,103
827,HOU,2025-01-22,109,,CLE,W 109-108,240,40,91,.440,25,57,.439,15,34,.441,14,20,.700,109,41,97,.423,28,56,.500,13,41,.317,13,19,.684,108
828,TOR,2025-01-21,109,,ORL,W 109-93,240,39,73,.534,26,49,.531,13,24,.542,18,28,.643,109,35,85,.412,26,54,.481,9,31,.290,14,19,.737,93
829,LAC,2025-01-13,109,,MIA,W 109-98,240,45,93,.484,32,57,.561,13,36,.361,6,10,.600,109,33,85,.388,16,33,.485,17,52,.327,15,18,.833,98
830,PHI,2025-01-08,109,,WAS,W 109-103,240,40,88,.455,25,44,.568,15,44,.341,14,19,.737,109,42,94,.447,29,64,.453,13,30,.433,6,9,.667,103
831,GSW,2024-12-28,109,,PHO,W 109-105,240,41,98,.418,29,53,.547,12,45,.267,15,19,.789,109,39,92,.424,30,57,.526,9,35,.257,18,22,.818,105
832,CHI,2024-12-13,109,,CHO,W 109-95,240,37,93,.398,23,42,.548,14,51,.275,21,25,.840,109,35,98,.357,27,52,.519,8,46,.174,17,21,.810,95
833,NOP,2024-12-12,109,,SAC,L 109-111,240,39,83,.470,25,46,.543,14,37,.378,17,20,.850,109,37,92,.402,27,59,.458,10,33,.303,27,29,.931,111
834,IND,2024-12-08,109,,CHO,L 109-113,240,42,82,.512,30,46,.652,12,36,.333,13,15,.867,109,40,78,.513,26,49,.531,14,29,.483,19,26,.731,113
835,NOP,2024-12-07,109,,OKC,L 109-119,240,38,79,.481,27,42,.643,11,37,.297,22,27,.815,109,45,85,.529,33,53,.623,12,32,.375,17,21,.810,119
836,MIN,2024-12-02,109,,LAL,W 109-80,240,41,81,.506,26,46,.565,15,35,.429,12,15,.800,109,32,79,.405,26,48,.542,6,31,.194,10,14,.714,80
837,SAC,2024-11-25,109,,OKC,L 109-130,240,42,87,.483,34,55,.618,8,32,.250,17,23,.739,109,48,86,.558,34,55,.618,14,31,.452,20,25,.800,130
838,OKC,2024-11-20,109,,POR,W 109-99,240,40,91,.440,31,60,.517,9,31,.290,20,23,.870,109,32,79,.405,17,41,.415,15,38,.395,20,28,.714,99
839,HOU,2024-11-04,109,,NYK,W 109-97,240,43,88,.489,35,55,.636,8,33,.242,15,18,.833,109,34,88,.386,23,60,.383,11,28,.393,18,21,.857,97
840,CHO,2024-11-01,109,,BOS,L 109-124,240,42,91,.462,23,43,.535,19,48,.396,6,12,.500,109,41,86,.477,28,44,.636,13,42,.310,29,35,.829,124
841,PHO,2024-10-28,109,,LAL,W 109-105,240,40,87,.460,29,51,.569,11,36,.306,18,20,.900,109,39,94,.415,25,62,.403,14,32,.438,13,18,.722,105
842,SAS,2024-10-26,109,,HOU,W 109-106,240,39,79,.494,31,59,.525,8,20,.400,23,28,.821,109,38,92,.413,25,51,.490,13,41,.317,17,21,.810,106
843,DET,2024-10-23,109,,IND,L 109-115,240,38,88,.432,29,55,.527,9,33,.273,24,28,.857,109,42,83,.506,33,52,.635,9,31,.290,22,25,.880,115
844,PHI,2024-10-23,109,,MIL,L 109-124,240,41,98,.418,33,67,.493,8,31,.258,19,27,.704,109,43,80,.538,27,43,.628,16,37,.432,22,31,.710,124
845,MIA,2025-04-03,108,,MEM,L 108-110,240,39,95,.411,25,62,.403,14,33,.424,16,19,.842,108,40,85,.471,24,47,.511,16,38,.421,14,17,.824,110
846,TOR,2025-03-28,108,,CHO,W 108-97,240,42,95,.442,28,51,.549,14,44,.318,10,15,.667,108,39,96,.406,30,65,.462,9,31,.290,10,15,.667,97
847,PHO,2025-03-24,108,,MIL,W 108-106,240,39,82,.476,25,46,.543,14,36,.389,16,18,.889,108,37,83,.446,25,44,.568,12,39,.308,20,29,.690,106
848,IND,2025-03-22,108,,BRK,W 108-103,240,40,84,.476,29,49,.592,11,35,.314,17,21,.810,108,39,90,.433,24,47,.511,15,43,.349,10,17,.588,103
849,SAC,2025-03-22,108,,MIL,L 108-114,240,41,91,.451,32,53,.604,9,38,.237,17,22,.773,108,44,84,.524,31,53,.585,13,31,.419,13,20,.650,114
850,ORL,2025-03-19,108,,HOU,L 108-116,240,41,92,.446,32,57,.561,9,35,.257,17,20,.850,108,38,81,.469,27,46,.587,11,35,.314,29,32,.906,116
851,LAL,2025-03-02,108,,LAC,W 108-102,240,38,77,.494,20,35,.571,18,42,.429,14,20,.700,108,38,88,.432,26,49,.531,12,39,.308,14,17,.824,102
852,SAC,2025-02-21,108,,GSW,L 108-132,240,40,79,.506,29,47,.617,11,32,.344,17,18,.944,108,50,93,.538,30,50,.600,20,43,.465,12,12,1.000,132
853,ATL,2025-02-20,108,,ORL,L 108-114,240,39,100,.390,28,65,.431,11,35,.314,19,28,.679,108,41,85,.482,35,60,.583,6,25,.240,26,38,.684,114
854,TOR,2025-02-12,108,,CLE,L 108-131,240,42,91,.462,32,62,.516,10,29,.345,14,21,.667,108,48,99,.485,30,46,.652,18,53,.340,17,20,.850,131
855,POR,2025-02-06,108,,SAC,W 108-102,240,39,90,.433,23,50,.460,16,40,.400,14,18,.778,108,37,88,.420,27,58,.466,10,30,.333,18,22,.818,102
856,POR,2025-01-26,108,,OKC,L 108-118,240,33,81,.407,15,41,.366,18,40,.450,24,28,.857,108,42,89,.472,32,59,.542,10,30,.333,24,29,.828,118
857,GSW,2025-01-25,108,,LAL,L 108-118,240,41,89,.461,25,43,.581,16,46,.348,10,16,.625,108,47,86,.547,37,57,.649,10,29,.345,14,17,.824,118
858,MEM,2025-01-20,108,,MIN,W 108-106,240,37,86,.430,30,53,.566,7,33,.212,27,34,.794,108,36,93,.387,22,50,.440,14,43,.326,20,27,.741,106
859,DEN,2025-01-15,108,,HOU,L 108-128,240,40,75,.533,26,46,.565,14,29,.483,14,21,.667,108,49,94,.521,32,56,.571,17,38,.447,13,17,.765,128
860,IND,2025-01-10,108,,GSW,W 108-96,240,43,82,.524,34,55,.618,9,27,.333,13,19,.684,108,38,91,.418,28,53,.528,10,38,.263,10,13,.769,96
861,MIN,2025-01-06,108,,LAC,W 108-106,240,41,92,.446,25,53,.472,16,39,.410,10,17,.588,108,37,89,.416,25,54,.463,12,35,.343,20,25,.800,106
862,CHO,2024-12-30,108,,CHI,L 108-115 (OT),265,42,101,.416,32,58,.552,10,43,.233,14,20,.700,108,39,104,.375,21,44,.477,18,60,.300,19,27,.704,115
863,ORL,2024-12-23,108,,BOS,W 108-104,240,37,83,.446,24,50,.480,13,33,.394,21,21,1.000,108,37,84,.440,29,51,.569,8,33,.242,22,27,.815,104
864,PHI,2024-12-20,108,,CHO,W 108-98,240,41,83,.494,29,50,.580,12,33,.364,14,18,.778,108,36,78,.462,26,47,.553,10,31,.323,16,21,.762,98
865,BOS,2024-12-19,108,,CHI,L 108-117,240,38,97,.392,24,41,.585,14,56,.250,18,21,.857,108,42,94,.447,23,42,.548,19,52,.365,14,16,.875,117
866,CHO,2024-12-16,108,,PHI,L 108-121,240,42,83,.506,30,45,.667,12,38,.316,12,21,.571,108,41,80,.513,25,42,.595,16,38,.421,23,30,.767,121
867,TOR,2024-12-09,108,,NYK,L 108-113,240,43,96,.448,30,61,.492,13,35,.371,9,11,.818,108,42,82,.512,25,42,.595,17,40,.425,12,19,.632,113
868,BOS,2024-12-02,108,,MIA,W 108-89,240,39,89,.438,20,34,.588,19,55,.345,11,13,.846,108,31,87,.356,23,52,.442,8,35,.229,19,23,.826,89
869,WAS,2024-11-26,108,,CHI,L 108-127,240,39,91,.429,29,54,.537,10,37,.270,20,31,.645,108,47,94,.500,33,54,.611,14,40,.350,19,22,.864,127
870,NOP,2024-11-22,108,,GSW,L 108-112,240,41,92,.446,29,53,.547,12,39,.308,14,22,.636,108,39,87,.448,27,50,.540,12,37,.324,22,29,.759,112
871,SAC,2024-11-18,108,,ATL,L 108-109,240,37,85,.435,17,39,.436,20,46,.435,14,19,.737,108,39,83,.470,23,45,.511,16,38,.421,15,18,.833,109
872,BOS,2024-11-08,108,,BRK,W 108-104 (OT),265,39,90,.433,25,37,.676,14,53,.264,16,19,.842,108,41,100,.410,31,62,.500,10,38,.263,12,15,.800,104
873,CHO,2024-11-06,108,,DET,W 108-107,240,39,90,.433,25,46,.543,14,44,.318,16,16,1.000,108,46,94,.489,36,62,.581,10,32,.313,5,9,.556,107
874,DAL,2024-11-03,108,,ORL,W 108-85,240,42,85,.494,32,53,.604,10,32,.313,14,23,.609,108,31,93,.333,23,52,.442,8,41,.195,15,19,.789,85
875,NOP,2025-04-06,107,,MIL,L 107-111,240,43,95,.453,31,62,.500,12,33,.364,9,14,.643,107,43,92,.467,32,60,.533,11,32,.344,14,22,.636,111
876,MIL,2025-03-28,107,,NYK,L 107-116,240,41,75,.547,28,42,.667,13,33,.394,12,19,.632,107,45,93,.484,33,60,.550,12,33,.364,14,16,.875,116
877,LAL,2025-03-16,107,,PHO,W 107-96,240,35,81,.432,21,42,.500,14,39,.359,23,32,.719,107,35,89,.393,26,48,.542,9,41,.220,17,21,.810,96
878,DET,2025-03-15,107,,OKC,L 107-113,240,42,88,.477,28,55,.509,14,33,.424,9,13,.692,107,43,89,.483,33,55,.600,10,34,.294,17,22,.773,113
879,OKC,2025-03-07,107,,POR,W 107-89,240,39,84,.464,25,46,.543,14,38,.368,15,17,.882,107,33,95,.347,25,52,.481,8,43,.186,15,18,.833,89
880,LAL,2025-02-25,107,,DAL,W 107-99,240,39,87,.448,28,47,.596,11,40,.275,18,24,.750,107,35,98,.357,18,54,.333,17,44,.386,12,13,.923,99
881,WAS,2025-02-24,107,,BRK,W 107-99,240,35,70,.500,22,39,.564,13,31,.419,24,25,.960,107,33,84,.393,19,48,.396,14,36,.389,19,24,.792,99
882,UTA,2025-02-21,107,,OKC,L 107-130,240,41,90,.456,26,49,.531,15,41,.366,10,18,.556,107,46,97,.474,27,54,.500,19,43,.442,19,20,.950,130
883,TOR,2025-02-05,107,,MEM,L 107-138,240,39,98,.398,27,56,.482,12,42,.286,17,19,.895,107,47,89,.528,31,51,.608,16,38,.421,28,38,.737,138
884,CHO,2025-01-27,107,,LAL,L 107-112,240,39,87,.448,25,51,.490,14,36,.389,15,18,.833,107,44,86,.512,38,58,.655,6,28,.214,18,24,.750,112
885,DAL,2025-01-25,107,,BOS,L 107-122,240,39,88,.443,31,66,.470,8,22,.364,21,28,.750,107,44,103,.427,24,51,.471,20,52,.385,14,19,.737,122
886,MIA,2025-01-21,107,,POR,L 107-116,240,41,93,.441,27,51,.529,14,42,.333,11,12,.917,107,43,87,.494,28,44,.636,15,43,.349,15,23,.652,116
887,TOR,2024-12-29,107,,ATL,L 107-136,240,38,85,.447,31,61,.508,7,24,.292,24,27,.889,107,46,95,.484,28,50,.560,18,45,.400,26,35,.743,136
888,MIN,2024-12-19,107,,NYK,L 107-133,240,41,89,.461,24,47,.511,17,42,.405,8,13,.615,107,50,97,.515,30,52,.577,20,45,.444,13,16,.813,133
889,PHI,2024-12-13,107,,IND,L 107-121,240,37,85,.435,27,60,.450,10,25,.400,23,32,.719,107,47,91,.516,33,53,.623,14,38,.368,13,17,.765,121
890,LAL,2024-12-08,107,,POR,W 107-98,240,38,83,.458,25,49,.510,13,34,.382,18,21,.857,107,35,84,.417,26,48,.542,9,36,.250,19,21,.905,98
891,DET,2024-12-03,107,,MIL,L 107-128,240,40,87,.460,29,54,.537,11,33,.333,16,22,.727,107,45,80,.563,22,39,.564,23,41,.561,15,21,.714,128
892,BOS,2024-11-24,107,,MIN,W 107-105,240,37,87,.425,16,31,.516,21,56,.375,12,15,.800,107,37,88,.420,22,47,.468,15,41,.366,16,21,.762,105
893,CHI,2024-11-17,107,,HOU,L 107-143,240,36,107,.336,22,51,.431,14,56,.250,21,22,.955,107,55,105,.524,45,71,.634,10,34,.294,23,32,.719,143
894,HOU,2024-11-11,107,,WAS,W 107-92,240,40,87,.460,35,64,.547,5,23,.217,22,25,.880,107,36,88,.409,25,57,.439,11,31,.355,9,13,.692,92
895,MIL,2024-11-10,107,,BOS,L 107-113,240,39,81,.481,26,49,.531,13,32,.406,16,21,.762,107,35,86,.407,16,36,.444,19,50,.380,24,27,.889,113
896,PHI,2024-11-10,107,,CHO,W 107-105 (OT),265,39,84,.464,30,51,.588,9,33,.273,20,26,.769,107,36,95,.379,22,41,.537,14,54,.259,19,22,.864,105
897,PHI,2024-11-02,107,,MEM,L 107-124,240,36,89,.404,17,43,.395,19,46,.413,16,20,.800,107,48,87,.552,36,60,.600,12,27,.444,16,21,.762,124
898,MIA,2024-10-30,107,,NYK,L 107-116,240,37,81,.457,20,41,.488,17,40,.425,16,24,.667,107,40,82,.488,22,42,.524,18,40,.450,18,20,.900,116
899,DEN,2025-04-02,106,,SAS,L 106-113,240,38,96,.396,25,52,.481,13,44,.295,17,25,.680,106,43,97,.443,26,51,.510,17,46,.370,10,13,.769,113
900,SAS,2025-03-30,106,,GSW,L 106-148,240,40,84,.476,24,42,.571,16,42,.381,10,16,.625,106,56,97,.577,35,53,.660,21,44,.477,15,19,.789,148
901,MIA,2025-03-03,106,,WAS,W 106-90,240,39,82,.476,26,45,.578,13,37,.351,15,18,.833,106,31,84,.369,21,49,.429,10,35,.286,18,22,.818,90
902,UTA,2025-03-03,106,,DET,L 106-134,240,35,82,.427,25,49,.510,10,33,.303,26,32,.813,106,51,92,.554,40,51,.784,11,41,.268,21,28,.750,134
903,LAL,2025-02-28,106,,LAC,W 106-102,240,39,80,.488,28,47,.596,11,33,.333,17,22,.773,106,39,87,.448,30,50,.600,9,37,.243,15,21,.714,102
904,DET,2025-02-24,106,,LAC,W 106-97,240,36,79,.456,27,50,.540,9,29,.310,25,36,.694,106,37,92,.402,26,51,.510,11,41,.268,12,19,.632,97
905,ORL,2025-02-10,106,,ATL,L 106-112,240,37,78,.474,25,48,.521,12,30,.400,20,24,.833,106,38,77,.494,26,45,.578,12,32,.375,24,28,.857,112
906,TOR,2025-01-31,106,,CHI,L 106-122,240,39,92,.424,29,62,.468,10,30,.333,18,27,.667,106,45,89,.506,27,49,.551,18,40,.450,14,17,.824,122
907,MIA,2025-01-29,106,,CLE,L 106-126,240,39,83,.470,24,40,.600,15,43,.349,13,15,.867,106,54,100,.540,41,58,.707,13,42,.310,5,6,.833,126
908,DAL,2025-01-17,106,,OKC,W 106-98,240,37,75,.493,21,34,.618,16,41,.390,16,22,.727,106,35,91,.385,15,45,.333,20,46,.435,8,12,.667,98
909,WAS,2025-01-13,106,,MIN,L 106-120,240,40,91,.440,23,51,.451,17,40,.425,9,15,.600,106,41,83,.494,27,46,.587,14,37,.378,24,31,.774,120
910,ORL,2025-01-10,106,,MIL,L 106-109,240,37,86,.430,23,46,.500,14,40,.350,18,26,.692,106,43,83,.518,34,58,.586,9,25,.360,14,23,.609,109
911,DEN,2025-01-07,106,,BOS,L 106-118,240,40,87,.460,26,51,.510,14,36,.389,12,15,.800,106,44,88,.500,32,53,.604,12,35,.343,18,20,.900,118
912,WAS,2024-12-30,106,,NYK,L 106-126,240,39,92,.424,27,49,.551,12,43,.279,16,22,.727,106,45,98,.459,30,54,.556,15,44,.341,21,25,.840,126
913,LAC,2024-12-08,106,,HOU,L 106-117,240,41,92,.446,30,58,.517,11,34,.324,13,16,.813,106,40,82,.488,25,41,.610,15,41,.366,22,26,.846,117
914,IND,2024-11-29,106,,DET,L 106-130,240,41,85,.482,29,52,.558,12,33,.364,12,13,.923,106,48,83,.578,30,45,.667,18,38,.474,16,20,.800,130
915,MIA,2024-11-18,106,,PHI,W 106-89,240,36,87,.414,23,43,.535,13,44,.295,21,23,.913,106,35,84,.417,25,43,.581,10,41,.244,9,12,.750,89
916,OKC,2024-11-13,106,,NOP,W 106-88,240,39,88,.443,24,49,.490,15,39,.385,13,16,.813,106,34,86,.395,25,49,.510,9,37,.243,11,17,.647,88
917,PHI,2024-11-13,106,,CLE,L 106-114,240,41,92,.446,27,49,.551,14,43,.326,10,11,.909,106,42,85,.494,26,45,.578,16,40,.400,14,17,.824,114
918,POR,2024-11-13,106,,MIN,W 106-98,240,38,83,.458,29,58,.500,9,25,.360,21,23,.913,106,37,94,.394,30,55,.545,7,39,.179,17,22,.773,98
919,BRK,2024-11-04,106,,MEM,W 106-104,240,40,84,.476,27,48,.563,13,36,.361,13,18,.722,106,43,91,.473,35,61,.574,8,30,.267,10,13,.769,104
920,MEM,2024-10-30,106,,BRK,L 106-119,240,38,81,.469,30,54,.556,8,27,.296,22,29,.759,106,41,80,.513,26,39,.667,15,41,.366,22,25,.880,119
921,MIA,2024-10-28,106,,DET,W 106-98,240,38,88,.432,23,41,.561,15,47,.319,15,20,.750,106,35,91,.385,21,53,.396,14,38,.368,14,17,.824,98
922,CHO,2024-10-26,106,,MIA,L 106-114,240,39,89,.438,26,48,.542,13,41,.317,15,21,.714,106,40,86,.465,26,52,.500,14,34,.412,20,28,.714,114
923,TOR,2024-10-23,106,,CLE,L 106-136,240,36,86,.419,24,55,.436,12,31,.387,22,29,.759,106,51,87,.586,37,57,.649,14,30,.467,20,26,.769,136
924,BRK,2025-04-13,105,,NYK,L 105-113,240,38,74,.514,26,39,.667,12,35,.343,17,25,.680,105,37,86,.430,21,44,.477,16,42,.381,23,26,.885,113
925,ATL,2025-04-05,105,,NYK,L 105-121,240,41,88,.466,27,43,.628,14,45,.311,9,12,.750,105,45,84,.536,30,55,.545,15,29,.517,16,19,.842,121
926,TOR,2025-04-04,105,,DET,L 105-117,240,38,91,.418,25,54,.463,13,37,.351,16,20,.800,105,41,89,.461,29,55,.527,12,34,.353,23,27,.852,117
927,NYK,2025-04-01,105,,PHI,W 105-91,240,36,85,.424,24,54,.444,12,31,.387,21,26,.808,105,34,81,.420,28,50,.560,6,31,.194,17,22,.773,91
928,SAS,2025-04-01,105,,ORL,L 105-116,240,40,81,.494,27,49,.551,13,32,.406,12,17,.706,105,43,90,.478,25,43,.581,18,47,.383,12,12,1.000,116
929,SAC,2025-03-25,105,,OKC,L 105-121,240,37,91,.407,14,44,.318,23,47,.489,8,12,.667,105,43,82,.524,24,50,.480,19,32,.594,16,20,.800,121
930,WAS,2025-03-21,105,,ORL,L 105-120,240,37,87,.425,20,48,.417,17,39,.436,14,19,.737,105,46,96,.479,29,54,.537,17,42,.405,11,13,.846,120
931,IND,2025-03-20,105,,BRK,W 105-99 (OT),265,35,81,.432,27,50,.540,8,31,.258,27,31,.871,105,36,101,.356,22,51,.431,14,50,.280,13,18,.722,99
932,GSW,2025-03-17,105,,DEN,L 105-114,240,41,84,.488,33,51,.647,8,33,.242,15,27,.556,105,43,92,.467,29,53,.547,14,39,.359,14,18,.778,114
933,MIL,2025-03-16,105,,OKC,L 105-121,240,33,83,.398,20,49,.408,13,34,.382,26,33,.788,105,46,89,.517,36,60,.600,10,29,.345,19,25,.760,121
934,POR,2025-03-16,105,,TOR,W 105-102,240,36,88,.409,18,38,.474,18,50,.360,15,18,.833,105,38,94,.404,28,63,.444,10,31,.323,16,20,.800,102
935,CHO,2025-03-08,105,,BRK,W 105-102,240,40,98,.408,29,64,.453,11,34,.324,14,16,.875,105,38,82,.463,24,32,.750,14,50,.280,12,15,.800,102
936,LAC,2025-03-07,105,,NYK,W 105-95,240,37,88,.420,22,50,.440,15,38,.395,16,19,.842,105,35,91,.385,26,57,.456,9,34,.265,16,18,.889,95
937,PHO,2025-02-08,105,,DEN,L 105-122,240,38,98,.388,21,48,.438,17,50,.340,12,15,.800,105,45,92,.489,29,57,.509,16,35,.457,16,17,.941,122
938,CLE,2025-02-04,105,,BOS,L 105-112,240,36,91,.396,25,52,.481,11,39,.282,22,26,.846,105,40,98,.408,23,50,.460,17,48,.354,15,18,.833,112
939,GSW,2025-01-31,105,,PHO,L 105-130,240,36,96,.375,20,52,.385,16,44,.364,17,25,.680,105,50,89,.562,31,50,.620,19,39,.487,11,16,.688,130
940,OKC,2025-01-05,105,,BOS,W 105-92,240,39,87,.448,23,49,.469,16,38,.421,11,13,.846,105,31,85,.365,22,39,.564,9,46,.196,21,24,.875,92
941,DET,2025-01-01,105,,ORL,W 105-96,240,41,79,.519,29,50,.580,12,29,.414,11,17,.647,105,37,91,.407,29,56,.518,8,35,.229,14,20,.700,96
942,MIL,2024-12-26,105,,BRK,L 105-111,240,41,83,.494,26,45,.578,15,38,.395,8,12,.667,105,39,82,.476,23,44,.523,16,38,.421,17,22,.773,111
943,GSW,2024-12-23,105,,IND,L 105-111,240,39,90,.433,27,52,.519,12,38,.316,15,21,.714,105,45,92,.489,34,57,.596,11,35,.314,10,11,.909,111
944,MEM,2024-11-17,105,,DEN,W 105-90,240,41,91,.451,28,52,.538,13,39,.333,10,12,.833,105,35,84,.417,25,53,.472,10,31,.323,10,14,.714,90
945,NOP,2024-11-11,105,,BRK,L 105-107,240,42,94,.447,32,64,.500,10,30,.333,11,12,.917,105,36,84,.429,17,42,.405,19,42,.452,16,19,.842,107
946,CLE,2024-11-09,105,,BRK,W 105-100,240,40,74,.541,30,46,.652,10,28,.357,15,19,.789,105,34,76,.447,19,33,.576,15,43,.349,17,18,.944,100
947,LAC,2024-11-09,105,,TOR,W 105-103,240,35,76,.461,25,50,.500,10,26,.385,25,32,.781,105,40,95,.421,29,58,.500,11,37,.297,12,21,.571,103
948,LAC,2024-10-30,105,,POR,L 105-106,240,41,90,.456,28,54,.519,13,36,.361,10,18,.556,105,41,92,.446,27,59,.458,14,33,.424,10,12,.833,106
949,OKC,2024-10-30,105,,SAS,W 105-93,240,41,89,.461,24,48,.500,17,41,.415,6,8,.750,105,35,85,.412,23,49,.469,12,36,.333,11,13,.846,93
950,HOU,2024-10-23,105,,CHO,L 105-110,240,38,103,.369,25,60,.417,13,43,.302,16,20,.800,105,38,85,.447,23,46,.500,15,39,.385,19,24,.792,110
951,NOP,2025-04-11,104,,MIA,L 104-153,240,38,95,.400,24,58,.414,14,37,.378,14,20,.700,104,58,104,.558,38,59,.644,20,45,.444,17,22,.773,153
952,IND,2025-04-08,104,,WAS,W 104-98,240,33,87,.379,24,52,.462,9,35,.257,29,37,.784,104,38,91,.418,27,52,.519,11,39,.282,11,15,.733,98
953,LAL,2025-03-31,104,,HOU,W 104-98,240,35,89,.393,19,43,.442,16,46,.348,18,20,.900,104,37,89,.416,27,57,.474,10,32,.313,14,17,.824,98
954,CHO,2025-03-25,104,,ORL,L 104-111,240,37,88,.420,23,54,.426,14,34,.412,16,21,.762,104,41,90,.456,28,48,.583,13,42,.310,16,19,.842,111
955,WAS,2025-03-24,104,,TOR,L 104-112,240,35,87,.402,24,50,.480,11,37,.297,23,34,.676,104,41,101,.406,31,65,.477,10,36,.278,20,27,.741,112
956,BOS,2025-03-18,104,,BRK,W 104-96,240,35,79,.443,19,31,.613,16,48,.333,18,22,.818,104,36,88,.409,23,43,.535,13,45,.289,11,17,.647,96
957,GSW,2025-03-18,104,,MIL,W 104-93,240,32,77,.416,15,33,.455,17,44,.386,23,26,.885,104,31,79,.392,19,41,.463,12,38,.316,19,27,.704,93
958,MIA,2025-03-12,104,,LAC,L 104-119,240,40,84,.476,26,47,.553,14,37,.378,10,14,.714,104,45,76,.592,32,49,.653,13,27,.481,16,24,.667,119
959,SAC,2025-03-10,104,,NYK,L 104-133,240,36,86,.419,26,52,.500,10,34,.294,22,26,.846,104,45,84,.536,23,44,.523,22,40,.550,21,26,.808,133
960,NOP,2025-03-09,104,,MEM,L 104-107,240,35,85,.412,22,51,.431,13,34,.382,21,27,.778,104,41,99,.414,28,50,.560,13,49,.265,12,19,.632,107
961,MIA,2025-03-07,104,,MIN,L 104-106,240,41,89,.461,27,55,.491,14,34,.412,8,11,.727,104,40,81,.494,22,36,.611,18,45,.400,8,14,.571,106
962,ORL,2025-02-21,104,,MEM,L 104-105,240,36,88,.409,27,57,.474,9,31,.290,23,33,.697,104,38,92,.413,31,59,.525,7,33,.212,22,29,.759,105
963,PHI,2025-02-20,104,,BOS,L 104-124,240,40,93,.430,32,54,.593,8,39,.205,16,17,.941,104,43,89,.483,19,35,.543,24,54,.444,14,15,.933,124
964,NYK,2025-02-08,104,,BOS,L 104-131,240,35,83,.422,26,59,.441,9,24,.375,25,29,.862,104,46,85,.541,27,46,.587,19,39,.487,20,24,.833,131
965,GSW,2025-02-03,104,,ORL,W 104-99,240,34,78,.436,22,39,.564,12,39,.308,24,34,.706,104,43,99,.434,35,67,.522,8,32,.250,5,10,.500,99
966,CHO,2025-02-01,104,,DEN,L 104-107,240,41,95,.432,32,69,.464,9,26,.346,13,17,.765,104,41,88,.466,34,51,.667,7,37,.189,18,20,.900,107
967,CHO,2025-01-31,104,,LAC,L 104-112,240,42,96,.438,35,66,.530,7,30,.233,13,15,.867,104,44,81,.543,33,53,.623,11,28,.393,13,20,.650,112
968,ATL,2025-01-22,104,,DET,L 104-114,240,39,103,.379,33,65,.508,6,38,.158,20,26,.769,104,42,84,.500,30,50,.600,12,34,.353,18,19,.947,114
969,TOR,2025-01-13,104,,GSW,W 104-101,240,41,86,.477,29,57,.509,12,29,.414,10,15,.667,104,35,88,.398,19,42,.452,16,46,.348,15,22,.682,101
970,ORL,2025-01-12,104,,PHI,W 104-99,240,39,80,.488,32,50,.640,7,30,.233,19,28,.679,104,33,72,.458,21,43,.488,12,29,.414,21,22,.955,99
971,DET,2025-01-09,104,,GSW,L 104-107,240,39,86,.453,25,47,.532,14,39,.359,12,16,.750,104,41,89,.461,26,43,.605,15,46,.326,10,16,.625,107
972,TOR,2025-01-06,104,,MIL,L 104-128,240,41,91,.451,32,56,.571,9,35,.257,13,21,.619,104,47,82,.573,25,38,.658,22,44,.500,12,15,.800,128
973,MIL,2024-12-04,104,,ATL,L 104-119,240,33,78,.423,18,33,.545,15,45,.333,23,35,.657,104,45,102,.441,36,70,.514,9,32,.281,20,22,.909,119
974,CHO,2024-12-03,104,,PHI,L 104-110,240,34,77,.442,21,43,.488,13,34,.382,23,28,.821,104,38,82,.463,22,42,.524,16,40,.400,18,20,.900,110
975,PHO,2024-12-03,104,,SAS,W 104-93,240,38,78,.487,27,46,.587,11,32,.344,17,21,.810,104,35,100,.350,27,56,.482,8,44,.182,15,20,.750,93
976,UTA,2024-12-01,104,,LAL,L 104-105,240,40,79,.506,26,39,.667,14,40,.350,10,16,.625,104,39,88,.443,32,55,.582,7,33,.212,20,25,.800,105
977,CHO,2024-11-30,104,,ATL,L 104-107,240,35,94,.372,17,46,.370,18,48,.375,16,19,.842,104,38,78,.487,28,45,.622,10,33,.303,21,27,.778,107
978,MIN,2024-11-27,104,,SAC,L 104-115,240,33,74,.446,19,35,.543,14,39,.359,24,27,.889,104,46,94,.489,34,57,.596,12,37,.324,11,15,.733,115
979,SAS,2024-11-23,104,,GSW,W 104-94,240,38,85,.447,25,38,.658,13,47,.277,15,19,.789,104,36,95,.379,22,51,.431,14,44,.318,8,13,.615,94
980,LAC,2024-11-22,104,,SAC,W 104-88,240,39,94,.415,29,52,.558,10,42,.238,16,16,1.000,104,32,83,.386,25,48,.521,7,35,.200,17,24,.708,88
981,LAC,2024-11-20,104,,ORL,W 104-93,240,38,77,.494,27,55,.491,11,22,.500,17,21,.810,104,33,75,.440,25,40,.625,8,35,.229,19,24,.792,93
982,WAS,2024-11-17,104,,DET,L 104-124,240,39,83,.470,27,56,.482,12,27,.444,14,20,.700,104,46,97,.474,29,59,.492,17,38,.447,15,19,.789,124
983,GSW,2024-10-30,104,,NOP,W 104-89,240,41,87,.471,28,49,.571,13,38,.342,9,13,.692,104,33,90,.367,22,54,.407,11,36,.306,12,20,.600,89
984,NYK,2024-10-28,104,,CLE,L 104-110,240,40,90,.444,31,62,.500,9,28,.321,15,18,.833,104,39,82,.476,27,46,.587,12,36,.333,20,24,.833,110
985,GSW,2024-10-27,104,,LAC,L 104-112,240,38,88,.432,24,45,.533,14,43,.326,14,22,.636,104,42,90,.467,32,58,.552,10,32,.313,18,23,.783,112
986,DEN,2024-10-26,104,,LAC,L 104-109,240,35,87,.402,21,52,.404,14,35,.400,20,24,.833,104,40,82,.488,28,49,.571,12,33,.364,17,21,.810,109
987,POR,2024-10-23,104,,GSW,L 104-140,240,36,92,.391,28,58,.483,8,34,.235,24,30,.800,104,48,93,.516,28,45,.622,20,48,.417,24,30,.800,140
988,WAS,2025-04-09,103,,PHI,L 103-122,240,34,87,.391,24,54,.444,10,33,.303,25,30,.833,103,39,91,.429,23,41,.561,16,50,.320,28,38,.737,122
989,DET,2025-04-05,103,,MEM,L 103-109,240,37,96,.385,26,54,.481,11,42,.262,18,23,.783,103,39,94,.415,30,62,.484,9,32,.281,22,29,.759,109
990,TOR,2025-04-03,103,,POR,L 103-112,240,44,96,.458,32,62,.516,12,34,.353,3,5,.600,103,42,86,.488,32,52,.615,10,34,.294,18,20,.900,112
991,BOS,2025-04-02,103,,MIA,L 103-124,240,39,87,.448,27,44,.614,12,43,.279,13,16,.813,103,43,83,.518,29,53,.547,14,30,.467,24,27,.889,124
992,MEM,2025-03-31,103,,BOS,L 103-117,240,41,92,.446,30,48,.625,11,44,.250,10,16,.625,103,39,96,.406,18,34,.529,21,62,.339,18,19,.947,117
993,UTA,2025-03-25,103,,MEM,L 103-140,240,34,78,.436,17,36,.472,17,42,.405,18,22,.818,103,52,98,.531,32,53,.604,20,45,.444,16,18,.889,140
994,CLE,2025-03-16,103,,ORL,L 103-108,240,40,96,.417,30,56,.536,10,40,.250,13,20,.650,103,34,81,.420,21,50,.420,13,31,.419,27,34,.794,108
995,MEM,2025-03-05,103,,OKC,L 103-120,240,37,91,.407,28,57,.491,9,34,.265,20,22,.909,103,44,87,.506,29,51,.569,15,36,.417,17,19,.895,120
996,HOU,2025-03-01,103,,SAC,L 103-113,240,37,86,.430,24,51,.471,13,35,.371,16,23,.696,103,44,87,.506,35,59,.593,9,28,.321,16,21,.762,113
997,DAL,2025-02-27,103,,CHO,W 103-96,240,40,97,.412,29,61,.475,11,36,.306,12,16,.750,103,40,98,.408,33,71,.465,7,27,.259,9,13,.692,96
998,PHI,2025-02-22,103,,BRK,L 103-105,240,36,85,.424,26,46,.565,10,39,.256,21,24,.875,103,41,81,.506,34,53,.642,7,28,.250,16,19,.842,105
999,PHI,2025-02-11,103,,TOR,L 103-106,240,37,91,.407,28,53,.528,9,38,.237,20,24,.833,103,38,82,.463,27,49,.551,11,33,.333,19,23,.826,106
1000,MIN,2025-02-01,103,,WAS,L 103-105,240,38,93,.409,26,53,.491,12,40,.300,15,18,.833,103,38,83,.458,23,50,.460,15,33,.455,14,17,.824,105
1001,SAS,2025-02-01,103,,MIA,L 103-105,240,38,91,.418,26,55,.473,12,36,.333,15,21,.714,103,41,89,.461,28,47,.596,13,42,.310,10,17,.588,105
1002,POR,2025-01-18,103,,HOU,L 103-125,240,39,86,.453,27,50,.540,12,36,.333,13,18,.722,103,48,108,.444,34,77,.442,14,31,.452,15,22,.682,125
1003,POR,2024-12-30,103,,PHI,L 103-125,240,37,77,.481,29,41,.707,8,36,.222,21,30,.700,103,43,75,.573,32,51,.627,11,24,.458,28,31,.903,125
1004,MIN,2024-12-21,103,,GSW,L 103-113,240,36,86,.419,22,48,.458,14,38,.368,17,25,.680,103,40,87,.460,24,45,.533,16,42,.381,17,23,.739,113
1005,UTA,2024-11-27,103,,DEN,L 103-122,240,38,90,.422,22,47,.468,16,43,.372,11,18,.611,103,46,84,.548,35,51,.686,11,33,.333,19,23,.826,122
1006,MIA,2024-11-26,103,,MIL,L 103-106,240,35,77,.455,25,48,.521,10,29,.345,23,30,.767,103,36,77,.468,16,35,.457,20,42,.476,14,17,.824,106
1007,SAC,2024-11-24,103,,BRK,L 103-108,240,37,77,.481,28,52,.538,9,25,.360,20,31,.645,103,36,75,.480,17,36,.472,19,39,.487,17,25,.680,108
1008,CHO,2024-11-08,103,,IND,W 103-83,240,38,90,.422,21,40,.525,17,50,.340,10,12,.833,103,33,83,.398,24,54,.444,9,29,.310,8,14,.571,83
1009,CHO,2024-11-02,103,,BOS,L 103-113,240,40,91,.440,23,49,.469,17,42,.405,6,9,.667,103,36,82,.439,20,30,.667,16,52,.308,25,28,.893,113
1010,PHO,2024-11-02,103,,POR,W 103-97,240,35,93,.376,18,41,.439,17,52,.327,16,22,.727,103,37,111,.333,23,68,.338,14,43,.326,9,11,.818,97
1011,POR,2024-10-25,103,,NOP,L 103-105,240,37,90,.411,24,53,.453,13,37,.351,16,20,.800,103,36,86,.419,24,54,.444,12,32,.375,21,31,.677,105
1012,PHI,2025-04-13,102,,CHI,L 102-122,240,36,94,.383,24,50,.480,12,44,.273,18,21,.857,102,47,103,.456,34,63,.540,13,40,.325,15,20,.750,122
1013,NYK,2025-04-11,102,,CLE,L 102-108,240,36,88,.409,20,47,.426,16,41,.390,14,20,.700,102,38,77,.494,27,46,.587,11,31,.355,21,30,.700,108
1014,CHO,2025-04-04,102,,SAC,L 102-125,240,33,83,.398,25,48,.521,8,35,.229,28,34,.824,102,45,91,.495,29,55,.527,16,36,.444,19,23,.826,125
1015,PHO,2025-03-26,102,,BOS,L 102-132,240,36,87,.414,23,46,.500,13,41,.317,17,21,.810,102,45,89,.506,23,37,.622,22,52,.423,20,22,.909,132
1016,CHO,2025-03-18,102,,ATL,L 102-134,240,38,84,.452,28,54,.519,10,30,.333,16,21,.762,102,50,93,.538,28,48,.583,22,45,.489,12,15,.800,134
1017,MIA,2025-03-10,102,,CHO,L 102-105,240,39,85,.459,29,54,.537,10,31,.323,14,20,.700,102,36,86,.419,25,42,.595,11,44,.250,22,23,.957,105
1018,NYK,2025-03-04,102,,GSW,L 102-114,240,41,92,.446,33,59,.559,8,33,.242,12,15,.800,102,43,88,.489,30,51,.588,13,37,.351,15,19,.789,114
1019,PHI,2025-03-03,102,,POR,L 102-119,240,41,95,.432,30,60,.500,11,35,.314,9,13,.692,102,48,99,.485,37,64,.578,11,35,.314,12,19,.632,119
1020,ORL,2025-03-02,102,,TOR,L 102-104,240,30,67,.448,23,46,.500,7,21,.333,35,42,.833,102,37,80,.463,30,58,.517,7,22,.318,23,30,.767,104
1021,BRK,2025-02-28,102,,POR,L 102-121,240,36,87,.414,29,58,.500,7,29,.241,23,27,.852,102,45,78,.577,30,42,.714,15,36,.417,16,27,.593,121
1022,POR,2025-02-20,102,,LAL,L 102-110,240,38,86,.442,26,49,.531,12,37,.324,14,21,.667,102,39,82,.476,30,50,.600,9,32,.281,23,25,.920,110
1023,ORL,2025-02-12,102,,CHO,W 102-86,240,37,90,.411,23,47,.489,14,43,.326,14,19,.737,102,32,81,.395,24,55,.436,8,26,.308,14,15,.933,86
1024,BRK,2025-02-07,102,,MIA,W 102-86,240,39,93,.419,29,56,.518,10,37,.270,14,18,.778,102,32,90,.356,20,50,.400,12,40,.300,10,12,.833,86
1025,CHO,2025-02-05,102,,MIL,L 102-112,240,38,88,.432,27,54,.500,11,34,.324,15,20,.750,102,41,81,.506,23,39,.590,18,42,.429,12,13,.923,112
1026,BRK,2025-02-05,102,,WAS,L 102-119,240,36,83,.434,23,45,.511,13,38,.342,17,23,.739,102,44,81,.543,24,38,.632,20,43,.465,11,14,.786,119
1027,LAL,2025-01-17,102,,BRK,W 102-101,240,38,82,.463,26,48,.542,12,34,.353,14,18,.778,102,37,82,.451,20,44,.455,17,38,.447,10,13,.769,101
1028,PHI,2025-01-14,102,,OKC,L 102-118,240,37,84,.440,24,40,.600,13,44,.295,15,20,.750,102,45,81,.556,33,45,.733,12,36,.333,16,18,.889,118
1029,LAL,2025-01-13,102,,SAS,L 102-126,240,39,87,.448,25,43,.581,14,44,.318,10,16,.625,102,48,90,.533,35,55,.636,13,35,.371,17,20,.850,126
1030,MIL,2025-01-04,102,,POR,L 102-105,240,41,95,.432,28,54,.519,13,41,.317,7,9,.778,102,41,85,.482,28,49,.571,13,36,.361,10,13,.769,105
1031,ORL,2024-12-29,102,,BRK,W 102-101,240,37,83,.446,25,47,.532,12,36,.333,16,25,.640,102,32,73,.438,19,43,.442,13,30,.433,24,28,.857,101
1032,LAC,2024-12-27,102,,GSW,W 102-92,240,40,75,.533,30,43,.698,10,32,.313,12,15,.800,102,35,95,.368,28,57,.491,7,38,.184,15,20,.750,92
1033,CHO,2024-12-07,102,,CLE,L 102-116,240,37,86,.430,26,47,.553,11,39,.282,17,19,.895,102,42,84,.500,28,46,.609,14,38,.368,18,24,.750,116
1034,PHI,2024-12-06,102,,ORL,W 102-94,240,38,79,.481,31,53,.585,7,26,.269,19,29,.655,102,33,78,.423,20,32,.625,13,46,.283,15,17,.882,94
1035,PHI,2024-12-04,102,,ORL,L 102-106,240,40,82,.488,29,52,.558,11,30,.367,11,19,.579,102,41,84,.488,33,55,.600,8,29,.276,16,21,.762,106
1036,DET,2024-11-25,102,,TOR,W 102-100,240,34,76,.447,22,39,.564,12,37,.324,22,31,.710,102,41,104,.394,31,69,.449,10,35,.286,8,10,.800,100
1037,LAL,2024-11-23,102,,DEN,L 102-127,240,39,88,.443,26,52,.500,13,36,.361,11,14,.786,102,50,82,.610,34,50,.680,16,32,.500,11,19,.579,127
1038,LAC,2024-11-18,102,,GSW,W 102-99,240,35,82,.427,19,48,.396,16,34,.471,16,18,.889,102,37,84,.440,21,40,.525,16,44,.364,9,19,.474,99
1039,OKC,2024-11-04,102,,ORL,W 102-86,240,39,85,.459,27,54,.500,12,31,.387,12,16,.750,102,29,82,.354,24,48,.500,5,34,.147,23,27,.852,86
1040,DAL,2024-10-31,102,,HOU,L 102-108,240,39,85,.459,29,55,.527,10,30,.333,14,20,.700,102,40,97,.412,32,63,.508,8,34,.235,20,27,.741,108
1041,CHI,2024-10-30,102,,ORL,W 102-99,240,36,84,.429,23,50,.460,13,34,.382,17,25,.680,102,35,86,.407,24,40,.600,11,46,.239,18,20,.900,99
1042,WAS,2024-10-24,102,,BOS,L 102-122,240,41,95,.432,34,59,.576,7,36,.194,13,18,.722,102,42,90,.467,25,45,.556,17,45,.378,21,27,.778,122
1043,BRK,2025-03-24,101,,DAL,L 101-120,240,40,78,.513,29,45,.644,11,33,.333,10,14,.714,101,49,87,.563,39,56,.696,10,31,.323,12,16,.750,120
1044,LAC,2025-03-23,101,,OKC,L 101-103,240,35,82,.427,27,56,.482,8,26,.308,23,28,.821,101,37,92,.402,25,57,.439,12,35,.343,17,20,.850,103
1045,CHO,2025-03-03,101,,GSW,L 101-119,240,34,86,.395,23,46,.500,11,40,.275,22,33,.667,101,40,95,.421,22,45,.489,18,50,.360,21,24,.875,119
1046,UTA,2025-02-26,101,,SAC,L 101-118,240,38,84,.452,22,40,.550,16,44,.364,9,17,.529,101,46,87,.529,31,51,.608,15,36,.417,11,12,.917,118
1047,TOR,2025-02-25,101,,BOS,L 101-111,240,42,83,.506,37,50,.740,5,33,.152,12,16,.750,101,44,93,.473,29,42,.690,15,51,.294,8,8,1.000,111
1048,WAS,2025-02-21,101,,MIL,L 101-104,240,35,87,.402,23,48,.479,12,39,.308,19,27,.704,101,39,82,.476,30,50,.600,9,32,.281,17,26,.654,104
1049,MIN,2025-02-12,101,,MIL,L 101-103,240,39,103,.379,29,59,.492,10,44,.227,13,15,.867,101,39,88,.443,27,58,.466,12,30,.400,13,16,.813,103
1050,PHI,2025-02-05,101,,MIA,L 101-108,240,37,96,.385,25,56,.446,12,40,.300,15,20,.750,101,39,83,.470,25,49,.510,14,34,.412,16,20,.800,108
1051,DAL,2025-01-12,101,,DEN,L 101-112,240,35,85,.412,23,51,.451,12,34,.353,19,25,.760,101,46,94,.489,39,62,.629,7,32,.219,13,20,.650,112
1052,NYK,2025-01-10,101,,OKC,L 101-126,240,37,96,.385,33,65,.508,4,31,.129,23,23,1.000,101,48,89,.539,34,62,.548,14,27,.519,16,18,.889,126
1053,CHO,2024-12-23,101,,HOU,L 101-114,240,37,89,.416,27,53,.509,10,36,.278,17,24,.708,101,43,99,.434,30,57,.526,13,42,.310,15,19,.789,114
1054,BRK,2024-12-16,101,,CLE,L 101-130,240,34,81,.420,20,47,.426,14,34,.412,19,24,.792,101,43,81,.531,24,34,.706,19,47,.404,25,29,.862,130
1055,WAS,2024-12-05,101,,DAL,L 101-137,240,39,99,.394,26,59,.441,13,40,.325,10,15,.667,101,48,89,.539,28,51,.549,20,38,.526,21,27,.778,137
1056,GSW,2024-11-27,101,,OKC,L 101-105,240,35,98,.357,19,48,.396,16,50,.320,15,21,.714,101,39,85,.459,28,48,.583,11,37,.297,16,26,.615,105
1057,SAS,2024-11-27,101,,LAL,L 101-119,240,36,85,.424,22,45,.489,14,40,.350,15,16,.938,101,48,90,.533,35,56,.625,13,34,.382,10,10,1.000,119
1058,MIL,2024-11-18,101,,HOU,W 101-100,240,38,83,.458,25,50,.500,13,33,.394,12,19,.632,101,40,100,.400,31,68,.456,9,32,.281,11,13,.846,100
1059,NOP,2024-11-15,101,,DEN,W 101-94,240,37,87,.425,26,52,.500,11,35,.314,16,18,.889,101,37,87,.425,27,50,.540,10,37,.270,10,11,.909,94
1060,SAS,2024-10-28,101,,HOU,L 101-106,240,37,87,.425,27,54,.500,10,33,.303,17,21,.810,101,35,85,.412,20,48,.417,15,37,.405,21,24,.875,106
1061,NOP,2025-04-13,100,,OKC,L 100-115,240,35,91,.385,28,53,.528,7,38,.184,23,30,.767,100,41,98,.418,32,51,.627,9,47,.191,24,27,.889,115
1062,SAC,2025-04-11,100,,LAC,L 100-101,240,37,85,.435,27,54,.500,10,31,.323,16,17,.941,100,40,78,.513,33,57,.579,7,21,.333,14,18,.778,101
1063,CHO,2025-04-08,100,,MEM,L 100-124,240,37,81,.457,26,43,.605,11,38,.289,15,23,.652,100,42,93,.452,24,38,.632,18,55,.327,22,26,.846,124
1064,BRK,2025-03-28,100,,LAC,L 100-132,240,33,89,.371,19,42,.452,14,47,.298,20,26,.769,100,44,80,.550,25,43,.581,19,37,.514,25,28,.893,132
1065,PHI,2025-03-14,100,,IND,L 100-112,240,37,82,.451,26,44,.591,11,38,.289,15,22,.682,100,44,89,.494,34,54,.630,10,35,.286,14,18,.778,112
1066,MIL,2025-03-09,100,,CLE,L 100-112,240,39,91,.429,30,60,.500,9,31,.290,13,18,.722,100,39,88,.443,20,41,.488,19,47,.404,15,19,.789,112
1067,CHO,2025-03-01,100,,WAS,L 100-113,240,41,93,.441,27,51,.529,14,42,.333,4,6,.667,100,40,88,.455,23,38,.605,17,50,.340,16,17,.941,113
1068,HOU,2025-02-25,100,,MIL,W 100-97,240,37,91,.407,25,56,.446,12,35,.343,14,18,.778,100,34,85,.400,22,48,.458,12,37,.324,17,23,.739,97
1069,DEN,2025-02-22,100,,LAL,L 100-123,240,34,85,.400,18,44,.409,16,41,.390,16,21,.762,100,43,86,.500,27,45,.600,16,41,.390,21,25,.840,123
1070,BRK,2025-02-12,100,,PHI,W 100-96,240,40,85,.471,32,55,.582,8,30,.267,12,15,.800,100,35,81,.432,27,48,.563,8,33,.242,18,22,.818,96
1071,MIN,2025-01-27,100,,ATL,W 100-92,240,34,86,.395,22,46,.478,12,40,.300,20,29,.690,100,34,86,.395,22,43,.512,12,43,.279,12,18,.667,92
1072,ORL,2025-01-19,100,,DEN,L 100-113,240,38,102,.373,26,61,.426,12,41,.293,12,16,.750,100,40,77,.519,33,52,.635,7,25,.280,26,31,.839,113
1073,DET,2025-01-16,100,,IND,L 100-111,240,36,91,.396,27,55,.491,9,36,.250,19,22,.864,100,41,89,.461,28,59,.475,13,30,.433,16,22,.727,111
1074,NOP,2025-01-08,100,,POR,L 100-119,240,40,90,.444,28,53,.528,12,37,.324,8,11,.727,100,48,88,.545,35,52,.673,13,36,.361,10,13,.769,119
1075,MIA,2025-01-04,100,,UTA,L 100-136,240,35,80,.438,26,45,.578,9,35,.257,21,30,.700,100,52,100,.520,33,54,.611,19,46,.413,13,16,.813,136
1076,HOU,2024-12-29,100,,MIA,L 100-104,240,38,97,.392,25,57,.439,13,40,.325,11,13,.846,100,37,84,.440,27,51,.529,10,33,.303,20,28,.714,104
1077,SAC,2024-12-19,100,,LAL,L 100-113,240,37,82,.451,26,53,.491,11,29,.379,15,22,.682,100,38,94,.404,26,61,.426,12,33,.364,25,30,.833,113
1078,NYK,2024-12-11,100,,ATL,L 100-108,240,40,93,.430,29,51,.569,11,42,.262,9,15,.600,100,43,104,.413,34,73,.466,9,31,.290,13,20,.650,108
1079,CHI,2024-12-08,100,,PHI,L 100-108,240,35,86,.407,16,32,.500,19,54,.352,11,12,.917,100,43,92,.467,34,56,.607,9,36,.250,13,14,.929,108
1080,BRK,2024-11-29,100,,ORL,L 100-123,240,38,77,.494,24,48,.500,14,29,.483,10,14,.714,100,44,83,.530,26,48,.542,18,35,.514,17,22,.773,123
1081,NOP,2024-11-04,100,,POR,L 100-118,240,38,84,.452,28,49,.571,10,35,.286,14,16,.875,100,46,84,.548,36,55,.655,10,29,.345,16,24,.667,118
1082,OKC,2025-04-06,99,,LAL,L 99-126,240,39,90,.433,27,53,.509,12,37,.324,9,12,.750,99,46,84,.548,24,44,.545,22,40,.550,12,17,.706,126
1083,UTA,2025-03-21,99,,BOS,L 99-121,240,38,84,.452,24,49,.490,14,35,.400,9,12,.750,99,45,97,.464,28,46,.609,17,51,.333,14,16,.875,121
1084,BRK,2025-02-04,99,,HOU,W 99-97,240,38,82,.463,28,55,.509,10,27,.370,13,17,.765,99,34,83,.410,23,51,.451,11,32,.344,18,27,.667,97
1085,LAC,2025-01-20,99,,CHI,L 99-112,240,37,94,.394,28,52,.538,9,42,.214,16,17,.941,99,38,94,.404,23,48,.479,15,46,.326,21,26,.808,112
1086,NYK,2025-01-17,99,,MIN,L 99-116,240,35,90,.389,21,56,.375,14,34,.412,15,17,.882,99,42,79,.532,20,39,.513,22,40,.550,10,14,.714,116
1087,DAL,2025-01-14,99,,DEN,L 99-118,240,38,90,.422,29,58,.500,9,32,.281,14,22,.636,99,43,83,.518,30,54,.556,13,29,.448,19,22,.864,118
1088,BRK,2025-01-06,99,,IND,L 99-113,240,41,98,.418,31,65,.477,10,33,.303,7,11,.636,99,40,79,.506,28,48,.583,12,31,.387,21,23,.913,113
1089,PHI,2025-01-06,99,,PHO,L 99-109,240,34,87,.391,19,47,.404,15,40,.375,16,26,.615,99,41,81,.506,27,50,.540,14,31,.452,13,19,.684,109
1090,GSW,2025-01-05,99,,SAC,L 99-129,240,37,81,.457,25,46,.543,12,35,.343,13,18,.722,99,45,87,.517,26,44,.591,19,43,.442,20,22,.909,129
1091,DAL,2024-12-25,99,,MIN,L 99-105,240,36,87,.414,20,44,.455,16,43,.372,11,11,1.000,99,40,86,.465,26,54,.481,14,32,.438,11,13,.846,105
1092,SAC,2024-12-21,99,,LAL,L 99-103,240,39,90,.433,29,53,.547,10,37,.270,11,14,.786,99,40,83,.482,31,48,.646,9,35,.257,14,21,.667,103
1093,ORL,2024-12-19,99,,OKC,L 99-105,240,35,78,.449,24,43,.558,11,35,.314,18,25,.720,99,40,83,.482,30,52,.577,10,31,.323,15,16,.938,105
1094,POR,2024-12-06,99,,UTA,L 99-141,240,37,95,.389,23,48,.479,14,47,.298,11,17,.647,99,53,96,.552,39,64,.609,14,32,.438,21,23,.913,141
1095,GSW,2024-12-05,99,,HOU,W 99-93,240,36,86,.419,27,58,.466,9,28,.321,18,27,.667,99,35,93,.376,25,55,.455,10,38,.263,13,17,.765,93
1096,BRK,2024-12-04,99,,IND,W 99-90,240,35,81,.432,23,45,.511,12,36,.333,17,23,.739,99,32,75,.427,24,42,.571,8,33,.242,18,22,.818,90
1097,PHI,2024-11-24,99,,LAC,L 99-125,240,34,86,.395,25,47,.532,9,39,.231,22,26,.846,99,47,81,.580,35,51,.686,12,30,.400,19,25,.760,125
1098,PHO,2024-11-18,99,,ORL,L 99-109,240,35,83,.422,23,42,.548,12,41,.293,17,25,.680,99,39,76,.513,28,47,.596,11,29,.379,20,25,.800,109
1099,NOP,2024-11-16,99,,LAL,L 99-104,240,35,83,.422,24,54,.444,11,29,.379,18,23,.783,99,39,89,.438,27,49,.551,12,40,.300,14,18,.778,104
1100,OKC,2024-11-15,99,,PHO,W 99-83,240,36,91,.396,26,51,.510,10,40,.250,17,18,.944,99,22,75,.293,13,38,.342,9,37,.243,30,40,.750,83
1101,MIL,2024-11-12,99,,TOR,W 99-85,240,38,94,.404,22,38,.579,16,56,.286,7,12,.583,99,30,86,.349,21,61,.344,9,25,.360,16,20,.800,85
1102,PHI,2024-11-12,99,,NYK,L 99-111,240,31,83,.373,17,41,.415,14,42,.333,23,24,.958,99,44,89,.494,35,58,.603,9,31,.290,14,15,.933,111
1103,DET,2024-11-10,99,,HOU,L 99-101,240,36,84,.429,25,50,.500,11,34,.324,16,23,.696,99,38,93,.409,31,59,.525,7,34,.206,18,24,.750,101
1104,NOP,2025-03-30,98,,CHO,W 98-94,240,38,92,.413,29,61,.475,9,31,.290,13,17,.765,98,32,91,.352,24,58,.414,8,33,.242,22,25,.880,94
1105,MIA,2025-03-21,98,,HOU,L 98-102,240,38,73,.521,28,49,.571,10,24,.417,12,14,.857,98,39,84,.464,25,56,.446,14,28,.500,10,21,.476,102
1106,ATL,2025-03-14,98,,LAC,L 98-121,240,37,88,.420,28,55,.509,9,33,.273,15,17,.882,98,47,86,.547,35,59,.593,12,27,.444,15,20,.750,121
1107,DAL,2025-03-03,98,,SAC,L 98-122,240,35,77,.455,28,51,.549,7,26,.269,21,24,.875,98,47,90,.522,31,56,.554,16,34,.471,12,12,1.000,122
1108,PHO,2025-03-02,98,,MIN,L 98-116,240,35,80,.438,22,38,.579,13,42,.310,15,19,.789,98,39,92,.424,18,40,.450,21,52,.404,17,21,.810,116
1109,ATL,2025-02-24,98,,MIA,W 98-86,240,40,88,.455,31,53,.585,9,35,.257,9,12,.750,98,27,84,.321,20,44,.455,7,40,.175,25,27,.926,86
1110,HOU,2025-02-13,98,,GSW,L 98-105,240,38,93,.409,26,57,.456,12,36,.333,10,18,.556,98,35,89,.393,24,48,.500,11,41,.268,24,27,.889,105
1111,HOU,2025-02-01,98,,BRK,L 98-110,240,38,95,.400,26,56,.464,12,39,.308,10,15,.667,98,43,87,.494,33,60,.550,10,27,.370,14,21,.667,110
1112,SAS,2025-01-25,98,,IND,L 98-136,240,35,85,.412,24,53,.453,11,32,.344,17,25,.680,98,53,102,.520,36,63,.571,17,39,.436,13,14,.929,136
1113,POR,2025-01-11,98,,MIA,L 98-119,240,36,95,.379,23,50,.460,13,45,.289,13,19,.684,98,44,92,.478,25,48,.521,19,44,.432,12,16,.750,119
1114,BRK,2025-01-08,98,,DET,L 98-113,240,33,86,.384,20,47,.426,13,39,.333,19,21,.905,98,45,86,.523,30,49,.612,15,37,.405,8,12,.667,113
1115,GSW,2025-01-07,98,,MIA,L 98-114,240,40,98,.408,26,48,.542,14,50,.280,4,5,.800,98,43,91,.473,27,51,.529,16,40,.400,12,17,.706,114
1116,WAS,2025-01-05,98,,NOP,L 98-110,240,38,89,.427,27,48,.563,11,41,.268,11,14,.786,98,37,90,.411,19,41,.463,18,49,.367,18,20,.900,110
1117,DET,2025-01-03,98,,CHO,W 98-94,240,39,93,.419,27,56,.482,12,37,.324,8,13,.615,98,33,80,.413,24,50,.480,9,30,.300,19,30,.633,94
1118,CHI,2024-12-21,98,,BOS,L 98-123,240,37,98,.378,23,57,.404,14,41,.341,10,11,.909,98,48,100,.480,33,55,.600,15,45,.333,12,14,.857,123
1119,WAS,2024-12-15,98,,BOS,L 98-112,240,40,99,.404,27,59,.458,13,40,.325,5,8,.625,98,40,93,.430,22,47,.468,18,46,.391,14,24,.583,112
1120,CHO,2024-11-29,98,,NYK,L 98-99,240,36,89,.404,21,42,.500,15,47,.319,11,15,.733,98,36,81,.444,24,49,.490,12,32,.375,15,19,.789,99
1121,HOU,2024-11-23,98,,POR,L 98-104,240,32,90,.356,24,58,.414,8,32,.250,26,33,.788,98,34,90,.378,16,46,.348,18,44,.409,18,23,.783,104
1122,ORL,2024-11-15,98,,PHI,W 98-86,240,34,78,.436,23,41,.561,11,37,.297,19,22,.864,98,29,72,.403,19,41,.463,10,31,.323,18,21,.857,86
1123,SAC,2024-11-08,98,,LAC,L 98-107,240,37,78,.474,34,52,.654,3,26,.115,21,24,.875,98,36,81,.444,22,51,.431,14,30,.467,21,23,.913,107
1124,WAS,2024-11-02,98,,MIA,L 98-118,240,38,91,.418,31,56,.554,7,35,.200,15,21,.714,98,43,102,.422,28,65,.431,15,37,.405,17,24,.708,118
1125,DET,2024-11-01,98,,NYK,L 98-128,240,41,81,.506,30,47,.638,11,34,.324,5,7,.714,98,52,101,.515,34,63,.540,18,38,.474,6,10,.600,128
1126,DAL,2025-04-09,97,,LAL,L 97-112,240,36,72,.500,27,46,.587,9,26,.346,16,23,.696,97,42,90,.467,30,54,.556,12,36,.333,16,21,.762,112
1127,WAS,2025-04-03,97,,ORL,L 97-109,240,38,85,.447,26,55,.473,12,30,.400,9,11,.818,97,38,82,.463,27,52,.519,11,30,.367,22,25,.880,109
1128,UTA,2025-03-17,97,,CHI,L 97-111,240,35,86,.407,26,44,.591,9,42,.214,18,22,.818,97,42,97,.433,28,52,.538,14,45,.311,13,16,.813,111
1129,GSW,2025-03-15,97,,NYK,W 97-94,240,33,83,.398,20,42,.476,13,41,.317,18,22,.818,97,37,86,.430,28,62,.452,9,24,.375,11,13,.846,94
1130,HOU,2025-03-10,97,,ORL,W 97-84,240,35,89,.393,19,46,.413,16,43,.372,11,18,.611,97,28,86,.326,20,54,.370,8,32,.250,20,24,.833,84
1131,NOP,2025-03-06,97,,HOU,L 97-109,240,31,83,.373,22,56,.393,9,27,.333,26,33,.788,97,46,81,.568,37,52,.712,9,29,.310,8,18,.444,109
1132,BRK,2025-02-20,97,,CLE,L 97-110,240,38,95,.400,28,57,.491,10,38,.263,11,19,.579,97,40,94,.426,29,55,.527,11,39,.282,19,27,.704,110
1133,LAL,2025-02-19,97,,CHO,L 97-100,240,37,90,.411,22,39,.564,15,51,.294,8,12,.667,97,33,91,.363,15,38,.395,18,53,.340,16,17,.941,100
1134,BRK,2025-02-10,97,,CHO,W 97-89,240,37,93,.398,27,51,.529,10,42,.238,13,14,.929,97,32,78,.410,26,47,.553,6,31,.194,19,28,.679,89
1135,LAC,2025-02-04,97,,LAL,L 97-122,240,34,89,.382,22,48,.458,12,41,.293,17,19,.895,97,45,81,.556,27,44,.614,18,37,.486,14,23,.609,122
1136,CHI,2025-01-25,97,,PHI,L 97-109,240,36,85,.424,24,47,.511,12,38,.316,13,20,.650,97,42,92,.457,29,47,.617,13,45,.289,12,17,.706,109
1137,BRK,2025-01-25,97,,MIA,L 97-106,240,30,80,.375,16,40,.400,14,40,.350,23,26,.885,97,35,79,.443,22,51,.431,13,28,.464,23,24,.958,106
1138,CHO,2025-01-24,97,,POR,L 97-102,240,32,85,.376,23,54,.426,9,31,.290,24,28,.857,97,32,79,.405,21,41,.512,11,38,.289,27,39,.692,102
1139,BOS,2025-01-10,97,,SAC,L 97-114,240,34,84,.405,23,43,.535,11,41,.268,18,22,.818,97,44,102,.431,26,55,.473,18,47,.383,8,9,.889,114
1140,NOP,2025-01-07,97,,MIN,L 97-104,240,35,94,.372,23,53,.434,12,41,.293,15,24,.625,97,38,89,.427,23,45,.511,15,44,.341,13,19,.684,104
1141,TOR,2025-01-03,97,,ORL,L 97-106,240,38,80,.475,28,51,.549,10,29,.345,11,13,.846,97,37,79,.468,18,35,.514,19,44,.432,13,17,.765,106
1142,MIA,2024-12-20,97,,OKC,L 97-104,240,36,83,.434,24,43,.558,12,40,.300,13,20,.650,97,39,86,.453,25,52,.481,14,34,.412,12,17,.706,104
1143,MIN,2024-12-13,97,,LAL,W 97-87,240,35,87,.402,26,55,.473,9,32,.281,18,24,.750,97,33,86,.384,23,51,.451,10,35,.286,11,17,.647,87
1144,MIA,2024-10-23,97,,ORL,L 97-116,240,32,82,.390,21,48,.438,11,34,.324,22,29,.759,97,41,96,.427,23,47,.489,18,49,.367,16,22,.727,116
1145,ORL,2025-04-09,96,,BOS,W 96-76,240,37,91,.407,21,46,.457,16,45,.356,6,8,.750,96,32,82,.390,25,42,.595,7,40,.175,5,6,.833,76
1146,GSW,2025-04-06,96,,HOU,L 96-106,240,37,89,.416,21,46,.457,16,43,.372,6,11,.545,96,45,93,.484,35,63,.556,10,30,.333,6,16,.375,106
1147,WAS,2025-01-30,96,,LAL,L 96-134,240,29,91,.319,19,47,.404,10,44,.227,28,34,.824,96,49,90,.544,34,58,.586,15,32,.469,21,22,.955,134
1148,ATL,2025-01-28,96,,HOU,L 96-100,240,36,89,.404,25,42,.595,11,47,.234,13,16,.813,96,37,79,.468,30,49,.612,7,30,.233,19,20,.950,100
1149,BRK,2025-01-27,96,,SAC,L 96-110,240,30,82,.366,20,46,.435,10,36,.278,26,30,.867,96,45,82,.549,36,54,.667,9,28,.321,11,17,.647,110
1150,HOU,2025-01-20,96,,DET,L 96-107,240,37,94,.394,26,55,.473,11,39,.282,11,16,.688,96,42,88,.477,32,61,.525,10,27,.370,13,15,.867,107
1151,DET,2024-11-30,96,,PHI,L 96-111,240,35,91,.385,24,51,.471,11,40,.275,15,18,.833,96,42,85,.494,31,54,.574,11,31,.355,16,22,.727,111
1152,WAS,2024-11-27,96,,LAC,L 96-121,240,35,85,.412,27,52,.519,8,33,.242,18,22,.818,96,45,89,.506,33,56,.589,12,33,.364,19,25,.760,121
1153,WAS,2024-11-22,96,,BOS,L 96-108,240,39,90,.433,32,62,.516,7,28,.250,11,16,.688,96,36,85,.424,25,39,.641,11,46,.239,25,32,.781,108
1154,UTA,2024-10-29,96,,SAC,L 96-113,240,35,89,.393,21,41,.512,14,48,.292,12,14,.857,96,48,92,.522,40,61,.656,8,31,.258,9,14,.643,113
1155,PHO,2025-04-08,95,,GSW,L 95-133,240,35,88,.398,23,45,.511,12,43,.279,13,15,.867,95,45,93,.484,30,53,.566,15,40,.375,28,34,.824,133
1156,PHI,2025-03-29,95,,MIA,L 95-118,240,38,76,.500,25,44,.568,13,32,.406,6,14,.429,95,44,93,.473,24,50,.480,20,43,.465,10,13,.769,118
1157,NOP,2025-03-28,95,,GSW,L 95-111,240,33,81,.407,26,58,.448,7,23,.304,22,28,.786,95,38,92,.413,25,37,.676,13,55,.236,22,29,.759,111
1158,SAC,2025-03-24,95,,BOS,L 95-113,240,39,86,.453,31,62,.500,8,24,.333,9,11,.818,95,41,90,.456,22,40,.550,19,50,.380,12,20,.600,113
1159,DEN,2025-03-12,95,,MIN,L 95-115,240,36,89,.404,29,59,.492,7,30,.233,16,22,.727,95,43,90,.478,26,50,.520,17,40,.425,12,16,.750,115
1160,BRK,2025-01-21,95,,NYK,L 95-99,240,32,86,.372,20,46,.435,12,40,.300,19,25,.760,95,40,87,.460,32,59,.542,8,28,.286,11,14,.786,99
1161,WAS,2025-01-12,95,,OKC,L 95-136,240,28,83,.337,19,37,.514,9,46,.196,30,33,.909,95,45,95,.474,32,60,.533,13,35,.371,33,35,.943,136
1162,GSW,2024-12-30,95,,CLE,L 95-113,240,33,99,.333,24,61,.393,9,38,.237,20,26,.769,95,44,96,.458,26,49,.531,18,47,.383,7,10,.700,113
1163,SAC,2024-12-22,95,,IND,L 95-122,240,35,96,.365,23,58,.397,12,38,.316,13,17,.765,95,50,86,.581,33,47,.702,17,39,.436,5,8,.625,122
1164,DAL,2024-12-19,95,,LAC,L 95-118,240,34,86,.395,27,56,.482,7,30,.233,20,28,.714,95,44,85,.518,30,52,.577,14,33,.424,16,17,.941,118
1165,TOR,2024-11-15,95,,DET,L 95-99,240,35,97,.361,27,66,.409,8,31,.258,17,22,.773,95,39,95,.411,31,57,.544,8,38,.211,13,20,.650,99
1166,PHI,2024-10-30,95,,DET,L 95-105,240,33,79,.418,25,51,.490,8,28,.286,21,28,.750,95,36,78,.462,21,42,.500,15,36,.417,18,22,.818,105
1167,CHI,2024-10-26,95,,OKC,L 95-114,240,32,92,.348,17,39,.436,15,53,.283,16,22,.727,95,45,107,.421,37,67,.552,8,40,.200,16,20,.800,114
1168,WAS,2025-03-31,94,,MIA,L 94-120,240,34,86,.395,21,43,.488,13,43,.302,13,18,.722,94,47,93,.505,38,61,.623,9,32,.281,17,24,.708,120
1169,HOU,2025-02-09,94,,TOR,W 94-87,240,31,86,.360,21,48,.438,10,38,.263,22,28,.786,94,33,90,.367,25,48,.521,8,42,.190,13,17,.765,87
1170,ATL,2025-01-25,94,,TOR,L 94-117,240,33,84,.393,22,47,.468,11,37,.297,17,25,.680,94,42,90,.467,31,60,.517,11,30,.367,22,25,.880,117
1171,CHI,2025-01-15,94,,ATL,L 94-110,240,39,88,.443,33,61,.541,6,27,.222,10,10,1.000,94,41,100,.410,28,57,.491,13,43,.302,15,22,.682,110
1172,NYK,2025-01-06,94,,ORL,L 94-103,240,36,81,.444,32,59,.542,4,22,.182,18,22,.818,94,39,78,.500,28,47,.596,11,31,.355,14,18,.778,103
1173,BRK,2025-01-04,94,,PHI,L 94-123,240,34,82,.415,20,41,.488,14,41,.341,12,19,.632,94,42,82,.512,27,42,.643,15,40,.375,24,30,.800,123
1174,CHO,2024-12-28,94,,OKC,L 94-106,240,29,80,.363,18,46,.391,11,34,.324,25,28,.893,94,42,88,.477,32,50,.640,10,38,.263,12,14,.857,106
1175,BRK,2024-12-21,94,,UTA,L 94-105,240,38,94,.404,31,54,.574,7,40,.175,11,12,.917,94,41,86,.477,27,45,.600,14,41,.341,9,17,.529,105
1176,TOR,2024-12-19,94,,BRK,L 94-101,240,34,86,.395,19,42,.452,15,44,.341,11,14,.786,94,33,82,.402,24,43,.558,9,39,.231,26,31,.839,101
1177,UTA,2024-11-30,94,,DAL,L 94-106,240,34,95,.358,25,56,.446,9,39,.231,17,21,.810,94,41,90,.456,26,51,.510,15,39,.385,9,15,.600,106
1178,CHO,2024-11-27,94,,MIA,L 94-98,240,37,98,.378,20,47,.426,17,51,.333,3,8,.375,94,33,73,.452,19,36,.528,14,37,.378,18,22,.818,98
1179,ORL,2024-11-13,94,,IND,W 94-90,240,34,84,.405,21,46,.457,13,38,.342,13,15,.867,94,32,84,.381,22,54,.407,10,30,.333,16,18,.889,90
1180,MIN,2024-11-10,94,,MIA,L 94-95,240,35,88,.398,22,43,.512,13,45,.289,11,13,.846,94,34,77,.442,23,46,.500,11,31,.355,16,22,.727,95
1181,BOS,2025-04-13,93,,CHO,W 93-86,240,35,90,.389,21,45,.467,14,45,.311,9,13,.692,93,32,85,.376,21,46,.457,11,39,.282,11,18,.611,86
1182,NOP,2025-03-13,93,,ORL,L 93-113,240,35,79,.443,28,54,.519,7,25,.280,16,21,.762,93,43,83,.518,30,50,.600,13,33,.394,14,18,.778,113
1183,CLE,2025-01-12,93,,IND,L 93-108,240,33,83,.398,22,42,.524,11,41,.268,16,18,.889,93,43,92,.467,32,57,.561,11,35,.314,11,18,.611,108
1184,NOP,2024-12-21,93,,NYK,L 93-104,240,34,83,.410,22,49,.449,12,34,.353,13,19,.684,93,38,87,.437,23,50,.460,15,37,.405,13,15,.867,104
1185,LAL,2024-11-29,93,,OKC,L 93-101,240,33,73,.452,22,35,.629,11,38,.289,16,21,.762,93,38,93,.409,25,53,.472,13,40,.325,12,16,.750,101
1186,MIN,2024-11-29,93,,LAC,W 93-92,240,31,75,.413,16,36,.444,15,39,.385,16,20,.800,93,36,84,.429,26,53,.491,10,31,.323,10,13,.769,92
1187,NOP,2024-11-27,93,,TOR,L 93-119,240,36,93,.387,25,58,.431,11,35,.314,10,16,.625,93,47,95,.495,26,43,.605,21,52,.404,4,12,.333,119
1188,ATL,2024-11-04,93,,BOS,L 93-123,240,37,89,.416,31,58,.534,6,31,.194,13,16,.813,93,48,99,.485,30,44,.682,18,55,.327,9,13,.692,123
1189,ORL,2025-03-27,92,,DAL,L 92-101,240,34,80,.425,29,50,.580,5,30,.167,19,24,.792,92,37,78,.474,26,56,.464,11,22,.500,16,22,.727,101
1190,CHI,2025-02-11,92,,DET,L 92-132,240,35,100,.350,25,53,.472,10,47,.213,12,19,.632,92,51,96,.531,33,55,.600,18,41,.439,12,13,.923,132
1191,UTA,2025-01-09,92,,MIA,L 92-97,240,33,83,.398,22,47,.468,11,36,.306,15,17,.882,92,36,91,.396,22,41,.537,14,50,.280,11,15,.733,97
1192,ORL,2025-01-05,92,,UTA,L 92-105,240,35,98,.357,21,51,.412,14,47,.298,8,13,.615,92,39,81,.481,28,49,.571,11,32,.344,16,18,.889,105
1193,SAS,2024-12-15,92,,MIN,L 92-106,240,37,91,.407,26,46,.565,11,45,.244,7,9,.778,92,40,100,.400,28,65,.431,12,35,.343,14,16,.875,106
1194,TOR,2024-12-05,92,,OKC,L 92-129,240,32,90,.356,21,45,.467,11,45,.244,17,20,.850,92,49,102,.480,32,55,.582,17,47,.362,14,17,.824,129
1195,BRK,2024-12-01,92,,ORL,L 92-100,240,30,79,.380,22,48,.458,8,31,.258,24,31,.774,92,34,74,.459,27,46,.587,7,28,.250,25,32,.781,100
1196,BRK,2024-11-03,92,,DET,L 92-106,240,32,71,.451,23,40,.575,9,31,.290,19,31,.613,92,37,77,.481,26,41,.634,11,36,.306,21,26,.808,106
1197,LAC,2024-11-02,92,,OKC,L 92-105,240,32,79,.405,21,44,.477,11,35,.314,17,26,.654,92,36,84,.429,20,45,.444,16,39,.410,17,19,.895,105
1198,UTA,2025-03-23,91,,CLE,L 91-120,240,32,89,.360,16,39,.410,16,50,.320,11,18,.611,91,44,96,.458,33,48,.688,11,48,.229,21,31,.677,120
1199,MIA,2025-03-14,91,,BOS,L 91-103,240,34,75,.453,21,41,.512,13,34,.382,10,17,.588,91,36,83,.434,17,33,.515,19,50,.380,12,13,.923,103
1200,CHI,2024-12-23,91,,MIL,L 91-112,240,36,90,.400,26,42,.619,10,48,.208,9,12,.750,91,40,87,.460,22,44,.500,18,43,.419,14,17,.824,112
1201,ORL,2024-12-15,91,,NYK,L 91-100,240,36,86,.419,27,56,.482,9,30,.300,10,13,.769,91,33,71,.465,23,47,.489,10,24,.417,24,30,.800,100
1202,HOU,2024-12-11,91,,GSW,W 91-90,240,38,83,.458,32,56,.571,6,27,.222,9,10,.900,91,37,84,.440,25,46,.543,12,38,.316,4,9,.444,90
1203,BRK,2025-04-03,90,,MIN,L 90-105,240,38,89,.427,27,53,.509,11,36,.306,3,4,.750,90,39,78,.500,26,36,.722,13,42,.310,14,21,.667,105
1204,GSW,2024-12-06,90,,MIN,L 90-107,240,32,82,.390,21,43,.488,11,39,.282,15,17,.882,90,40,88,.455,26,46,.565,14,42,.333,13,14,.929,107
1205,TOR,2025-03-23,89,,SAS,L 89-123,240,35,92,.380,25,53,.472,10,39,.256,9,13,.692,89,41,86,.477,27,43,.628,14,43,.326,27,32,.844,123
1206,LAL,2025-03-20,89,,MIL,L 89-118,240,34,82,.415,23,50,.460,11,32,.344,10,16,.625,89,40,84,.476,29,49,.592,11,35,.314,27,34,.794,118
1207,POR,2025-01-16,89,,LAC,L 89-118,240,34,91,.374,25,57,.439,9,34,.265,12,13,.923,89,44,78,.564,34,55,.618,10,23,.435,20,27,.741,118
1208,ORL,2025-01-09,89,,MIN,L 89-104,240,33,87,.379,23,47,.489,10,40,.250,13,19,.684,89,34,85,.400,22,51,.431,12,34,.353,24,31,.774,104
1209,PHO,2024-12-27,89,,DAL,L 89-98,240,32,83,.386,19,48,.396,13,35,.371,12,18,.667,89,35,80,.438,23,46,.500,12,34,.353,16,17,.941,98
1210,POR,2024-11-10,89,,MEM,L 89-134,240,34,100,.340,30,58,.517,4,42,.095,17,21,.810,89,47,85,.553,31,42,.738,16,43,.372,24,28,.857,134
1211,ORL,2024-12-26,88,,MIA,L 88-89,240,34,77,.442,29,48,.604,5,29,.172,15,18,.833,88,31,76,.408,16,46,.348,15,30,.500,12,14,.857,89
1212,UTA,2024-10-31,88,,SAS,L 88-106,240,32,82,.390,25,50,.500,7,32,.219,17,19,.895,88,38,92,.413,26,49,.531,12,43,.279,18,23,.783,106
1213,ORL,2025-03-31,87,,LAC,L 87-96,240,30,76,.395,23,50,.460,7,26,.269,20,22,.909,87,36,82,.439,28,51,.549,8,31,.258,16,19,.842,96
1214,BRK,2024-12-27,87,,SAS,L 87-96,240,35,90,.389,23,49,.469,12,41,.293,5,8,.625,87,32,78,.410,20,50,.400,12,28,.429,20,27,.741,96
1215,DEN,2024-10-24,87,,OKC,L 87-102,240,35,98,.357,28,60,.467,7,38,.184,10,14,.714,87,43,101,.426,35,65,.538,8,36,.222,8,12,.667,102
1216,POR,2025-04-11,86,,GSW,L 86-103,240,32,85,.376,26,55,.473,6,30,.200,16,22,.727,86,33,83,.398,19,39,.487,14,44,.318,23,28,.821,103
1217,BRK,2025-03-26,86,,TOR,L 86-116,240,31,87,.356,23,46,.500,8,41,.195,16,19,.842,86,43,102,.422,33,69,.478,10,33,.303,20,23,.870,116
1218,HOU,2025-01-03,86,,BOS,L 86-109,240,32,88,.364,22,52,.423,10,36,.278,12,12,1.000,86,39,77,.506,20,38,.526,19,39,.487,12,18,.667,109
1219,UTA,2024-10-25,86,,GSW,L 86-127,240,29,92,.315,20,50,.400,9,42,.214,19,26,.731,86,51,106,.481,31,56,.554,20,50,.400,5,6,.833,127
1220,MIA,2025-02-10,85,,BOS,L 85-103,240,31,92,.337,20,47,.426,11,45,.244,12,13,.923,85,39,85,.459,22,32,.688,17,53,.321,8,8,1.000,103
1221,GSW,2025-01-20,85,,BOS,L 85-125,240,32,92,.348,18,39,.462,14,53,.264,7,11,.636,85,49,92,.533,29,44,.659,20,48,.417,7,8,.875,125
1222,ORL,2024-12-27,85,,NYK,L 85-108,240,32,87,.368,22,54,.407,10,33,.303,11,12,.917,85,40,75,.533,36,60,.600,4,15,.267,24,34,.706,108
1223,BRK,2025-01-22,84,,PHO,L 84-108,240,34,91,.374,27,55,.491,7,36,.194,9,14,.643,84,42,88,.477,28,47,.596,14,41,.341,10,13,.769,108
1224,CHO,2024-11-25,84,,ORL,L 84-95,240,31,75,.413,24,43,.558,7,32,.219,15,19,.789,84,37,94,.394,25,48,.521,12,46,.261,9,17,.529,95
1225,CHO,2025-01-29,83,,BRK,L 83-104,240,28,83,.337,18,48,.375,10,35,.286,17,25,.680,83,39,80,.488,29,48,.604,10,32,.313,16,20,.800,104
1226,ORL,2025-02-25,82,,CLE,L 82-122,240,33,90,.367,28,62,.452,5,28,.179,11,14,.786,82,45,80,.563,26,48,.542,19,32,.594,13,16,.813,122
1227,WAS,2025-01-29,82,,TOR,L 82-106,240,28,72,.389,23,42,.548,5,30,.167,21,29,.724,82,42,88,.477,31,57,.544,11,31,.355,11,15,.733,106
1228,NOP,2025-03-17,81,,DET,L 81-127,240,28,86,.326,23,54,.426,5,32,.156,20,30,.667,81,46,84,.548,33,49,.673,13,35,.371,22,29,.759,127
1229,LAC,2024-12-04,80,,MIN,L 80-108,240,29,83,.349,18,43,.419,11,40,.275,11,13,.846,80,41,85,.482,25,41,.610,16,44,.364,10,18,.556,108
1230,ORL,2025-01-23,79,,POR,L 79-101,240,26,76,.342,20,51,.392,6,25,.240,21,31,.677,79,40,82,.488,31,54,.574,9,28,.321,12,19,.632,101
