Rk,Team,Date,PTS,,Opp,Result,MP,FG,FGA,FG%,2P,2PA,2P%,3P,3PA,3P%,FT,FTA,FT%,PTS,FG,FGA,FG%,2P,2PA,2P%,3P,3PA,3P%,FT,FTA,FT%,PTS
1,DEN,2015-04-10,143,,DAL,L 143-144 (2OT),290,53,125,.424,38,82,.463,15,43,.349,22,25,.880,143,57,109,.523,46,80,.575,11,29,.379,19,24,.792,144
2,DAL,2014-11-21,140,,LAL,W 140-106,240,51,82,.622,33,47,.702,18,35,.514,20,28,.714,140,44,85,.518,39,72,.542,5,13,.385,13,21,.619,106
3,NOP,2014-11-14,139,,MIN,W 139-91,240,56,84,.667,41,64,.641,15,20,.750,12,16,.750,139,29,72,.403,26,58,.448,3,14,.214,30,41,.732,91
4,OKC,2014-12-31,137,,PHO,W 137-134 (OT),265,41,99,.414,30,64,.469,11,35,.314,44,49,.898,137,46,90,.511,33,63,.524,13,27,.481,29,35,.829,134
5,SAC,2014-12-27,135,,NYK,W 135-129 (OT),265,49,89,.551,41,73,.562,8,16,.500,29,33,.879,135,48,97,.495,42,77,.545,6,20,.300,27,32,.844,129
6,GSW,2015-04-15,133,,DEN,W 133-126,240,47,90,.522,34,62,.548,13,28,.464,26,34,.765,133,45,83,.542,39,65,.600,6,18,.333,30,36,.833,126
7,WAS,2014-12-08,133,,BOS,W 133-132 (2OT),290,49,94,.521,42,78,.538,7,16,.438,28,34,.824,133,47,102,.461,38,80,.475,9,22,.409,29,32,.906,132
8,ATL,2015-04-04,131,,BRK,W 131-99,240,49,82,.598,32,49,.653,17,33,.515,16,19,.842,131,39,80,.488,29,57,.509,10,23,.435,11,17,.647,99
9,OKC,2015-04-01,131,,DAL,L 131-135,240,45,93,.484,31,62,.500,14,31,.452,27,33,.818,131,56,91,.615,52,76,.684,4,15,.267,19,24,.792,135
10,OKC,2015-02-08,131,,LAC,W 131-108,240,46,88,.523,38,68,.559,8,20,.400,31,38,.816,131,42,90,.467,30,58,.517,12,32,.375,12,17,.706,108
11,DAL,2014-11-15,131,,MIN,W 131-117,240,52,94,.553,44,68,.647,8,26,.308,19,23,.826,131,43,86,.500,36,69,.522,7,17,.412,24,29,.828,117
12,SAC,2014-11-05,131,,DEN,W 131-109,240,42,76,.553,34,56,.607,8,20,.400,39,50,.780,131,37,82,.451,28,54,.519,9,28,.321,26,31,.839,109
13,SAS,2015-03-25,130,,OKC,W 130-91,240,51,88,.580,38,67,.567,13,21,.619,15,19,.789,130,36,90,.400,30,72,.417,6,18,.333,13,14,.929,91
14,ATL,2015-03-09,130,,SAC,W 130-105,240,53,88,.602,33,52,.635,20,36,.556,4,7,.571,130,39,81,.481,31,61,.508,8,20,.400,19,20,.950,105
15,BRK,2015-03-20,129,,MIL,W 129-127 (3OT),315,46,107,.430,35,82,.427,11,25,.440,26,34,.765,129,49,129,.380,41,113,.363,8,16,.500,21,29,.724,127
16,DAL,2015-03-13,129,,LAC,W 129-99,240,51,84,.607,35,56,.625,16,28,.571,11,16,.688,129,41,82,.500,29,50,.580,12,32,.375,5,12,.417,99
17,CLE,2015-01-23,129,,CHO,W 129-90,240,46,89,.517,31,61,.508,15,28,.536,22,28,.786,129,36,89,.404,34,73,.466,2,16,.125,16,24,.667,90
18,CHI,2014-12-22,129,,TOR,W 129-120,240,40,74,.541,34,62,.548,6,12,.500,43,47,.915,129,44,100,.440,35,70,.500,9,30,.300,23,32,.719,120
19,CHI,2014-12-02,129,,DAL,L 129-132 (2OT),290,47,103,.456,39,77,.506,8,26,.308,27,34,.794,129,47,102,.461,32,72,.444,15,30,.500,23,27,.852,132
20,LAL,2014-11-30,129,,TOR,W 129-122 (OT),265,47,96,.490,37,72,.514,10,24,.417,25,34,.735,129,45,104,.433,36,70,.514,9,34,.265,23,31,.742,122
21,GSW,2015-02-04,128,,DAL,W 128-114,240,45,86,.523,26,48,.542,19,38,.500,19,25,.760,128,41,98,.418,31,68,.456,10,30,.333,22,28,.786,114
22,DET,2015-01-21,128,,ORL,W 128-118,240,49,94,.521,39,70,.557,10,24,.417,20,24,.833,128,48,97,.495,42,82,.512,6,15,.400,16,16,1.000,118
23,GSW,2014-12-22,128,,SAC,W 128-108,240,49,91,.538,40,66,.606,9,25,.360,21,24,.875,128,43,90,.478,35,73,.479,8,17,.471,14,21,.667,108
24,OKC,2015-03-24,127,,LAL,W 127-117,240,48,86,.558,37,65,.569,11,21,.524,20,23,.870,127,44,85,.518,35,66,.530,9,19,.474,20,27,.741,117
25,OKC,2015-01-16,127,,GSW,W 127-115,240,51,97,.526,41,75,.547,10,22,.455,15,19,.789,127,42,92,.457,33,68,.485,9,24,.375,22,28,.786,115
26,LAC,2015-01-03,127,,PHI,W 127-91,240,46,85,.541,31,48,.646,15,37,.405,20,26,.769,127,32,79,.405,23,54,.426,9,25,.360,18,26,.692,91
27,LAC,2014-12-01,127,,MIN,W 127-101,240,41,80,.513,26,46,.565,15,34,.441,30,36,.833,127,35,82,.427,33,70,.471,2,12,.167,29,40,.725,101
28,CLE,2014-11-15,127,,ATL,W 127-94,240,49,90,.544,30,59,.508,19,31,.613,10,13,.769,127,40,90,.444,37,68,.544,3,22,.136,11,13,.846,94
29,GSW,2014-11-01,127,,LAL,W 127-104,240,46,83,.554,35,60,.583,11,23,.478,24,28,.857,127,41,88,.466,37,74,.500,4,14,.286,18,25,.720,104
30,LAC,2015-02-21,126,,SAC,W 126-99,240,46,95,.484,32,60,.533,14,35,.400,20,28,.714,126,30,88,.341,26,72,.361,4,16,.250,35,46,.761,99
31,GSW,2015-01-23,126,,SAC,W 126-101,240,45,94,.479,28,54,.519,17,40,.425,19,22,.864,126,34,82,.415,30,65,.462,4,17,.235,29,34,.853,101
32,GSW,2015-01-21,126,,HOU,W 126-113,240,49,98,.500,36,69,.522,13,29,.448,15,18,.833,126,37,87,.425,24,55,.436,13,32,.406,26,31,.839,113
33,GSW,2015-01-02,126,,TOR,W 126-105,240,49,92,.533,37,64,.578,12,28,.429,16,20,.800,126,40,86,.465,30,61,.492,10,25,.400,15,20,.750,105
34,GSW,2014-12-30,126,,PHI,W 126-86,240,46,82,.561,34,54,.630,12,28,.429,22,27,.815,126,33,86,.384,27,66,.409,6,20,.300,14,23,.609,86
35,GSW,2015-03-14,125,,NYK,W 125-94,240,45,90,.500,26,56,.464,19,34,.559,16,17,.941,125,38,96,.396,29,71,.408,9,25,.360,9,16,.563,94
36,SAS,2015-03-12,125,,CLE,L 125-128 (OT),265,49,87,.563,41,61,.672,8,26,.308,19,27,.704,125,44,91,.484,30,65,.462,14,26,.538,26,30,.867,128
37,PHO,2015-01-04,125,,TOR,W 125-109,240,48,89,.539,40,66,.606,8,23,.348,21,28,.750,125,38,83,.458,29,57,.509,9,26,.346,24,29,.828,109
38,CLE,2014-12-23,125,,MIN,W 125-104,240,44,84,.524,32,60,.533,12,24,.500,25,31,.806,125,39,88,.443,35,75,.467,4,13,.308,22,29,.759,104
39,SAS,2014-12-22,125,,LAC,W 125-118,240,49,77,.636,36,54,.667,13,23,.565,14,22,.636,125,43,86,.500,33,62,.532,10,24,.417,22,29,.759,118
40,DAL,2014-12-07,125,,MIL,W 125-102,240,49,84,.583,37,53,.698,12,31,.387,15,19,.789,125,42,84,.500,38,69,.551,4,15,.267,14,17,.824,102
41,ATL,2015-02-06,124,,GSW,W 124-116,240,38,77,.494,23,50,.460,15,27,.556,33,37,.892,124,47,103,.456,35,70,.500,12,33,.364,10,15,.667,116
42,PHO,2014-12-23,124,,DAL,W 124-115,240,44,97,.454,31,64,.484,13,33,.394,23,32,.719,124,41,88,.466,32,63,.508,9,25,.360,24,29,.828,115
43,TOR,2014-11-21,124,,MIL,W 124-82,240,45,86,.523,30,61,.492,15,25,.600,19,24,.792,124,27,74,.365,21,54,.389,6,20,.300,22,32,.688,82
44,SAS,2015-04-03,123,,DEN,W 123-93,240,47,85,.553,33,51,.647,14,34,.412,15,17,.882,123,40,87,.460,34,70,.486,6,17,.353,7,11,.636,93
45,OKC,2015-03-20,123,,ATL,W 123-115,240,43,84,.512,30,54,.556,13,30,.433,24,26,.923,123,41,82,.500,28,53,.528,13,29,.448,20,25,.800,115
46,SAS,2015-03-15,123,,MIN,W 123-97,240,49,84,.583,37,62,.597,12,22,.545,13,15,.867,123,38,86,.442,31,71,.437,7,15,.467,14,18,.778,97
47,OKC,2015-03-04,123,,PHI,W 123-118 (OT),265,44,96,.458,37,75,.493,7,21,.333,28,34,.824,123,34,96,.354,19,61,.311,15,35,.429,35,44,.795,118
48,TOR,2015-02-06,123,,LAC,W 123-107,240,40,75,.533,27,45,.600,13,30,.433,30,37,.811,123,38,78,.487,32,55,.582,6,23,.261,25,31,.806,107
49,LAL,2015-01-29,123,,CHI,W 123-118 (2OT),290,50,106,.472,47,97,.485,3,9,.333,20,25,.800,123,43,104,.413,37,79,.468,6,25,.240,26,32,.813,118
50,LAC,2015-01-22,123,,BRK,W 123-84,240,49,83,.590,38,58,.655,11,25,.440,14,21,.667,123,33,88,.375,29,67,.433,4,21,.190,14,25,.560,84
51,SAS,2014-12-06,123,,MIN,W 123-101,240,47,82,.573,40,64,.625,7,18,.389,22,25,.880,123,35,83,.422,29,67,.433,6,16,.375,25,32,.781,101
52,DAL,2014-11-13,123,,PHI,W 123-70,240,41,80,.513,30,48,.625,11,32,.344,30,36,.833,123,23,77,.299,16,50,.320,7,27,.259,17,33,.515,70
53,DEN,2015-04-12,122,,SAC,W 122-111,240,45,82,.549,36,56,.643,9,26,.346,23,30,.767,122,38,74,.514,33,56,.589,5,18,.278,30,42,.714,111
54,POR,2015-04-01,122,,LAC,L 122-126,240,45,89,.506,32,64,.500,13,25,.520,19,25,.760,122,46,86,.535,31,58,.534,15,28,.536,19,24,.792,126
55,OKC,2015-03-18,122,,BOS,W 122-118,240,42,88,.477,37,69,.536,5,19,.263,33,39,.846,122,44,84,.524,31,50,.620,13,34,.382,17,28,.607,118
56,BRK,2015-01-30,122,,TOR,L 122-127 (OT),265,49,101,.485,45,82,.549,4,19,.211,20,26,.769,122,47,92,.511,40,66,.606,7,26,.269,26,30,.867,127
57,GSW,2015-01-19,122,,DEN,W 122-79,240,44,81,.543,31,54,.574,13,27,.481,21,27,.778,122,30,87,.345,23,63,.365,7,24,.292,12,19,.632,79
58,MEM,2015-01-11,122,,PHO,W 122-110 (2OT),290,48,100,.480,39,79,.494,9,21,.429,17,24,.708,122,42,100,.420,34,65,.523,8,35,.229,18,23,.783,110
59,NOP,2014-12-14,122,,GSW,L 122-128 (OT),265,47,101,.465,39,74,.527,8,27,.296,20,25,.800,122,44,86,.512,33,62,.532,11,24,.458,29,35,.829,128
60,DEN,2014-11-28,122,,PHO,W 122-97,240,41,88,.466,33,67,.493,8,21,.381,32,36,.889,122,33,85,.388,25,62,.403,8,23,.348,23,29,.793,97
61,CHO,2014-11-07,122,,ATL,W 122-119 (2OT),290,48,97,.495,42,76,.553,6,21,.286,20,27,.741,122,43,93,.462,30,60,.500,13,33,.394,20,26,.769,119
62,HOU,2015-04-12,121,,NOP,W 121-114,240,39,73,.534,30,49,.612,9,24,.375,34,48,.708,121,44,91,.484,33,64,.516,11,27,.407,15,22,.682,114
63,MIN,2015-03-07,121,,POR,W 121-113,240,46,85,.541,42,78,.538,4,7,.571,25,31,.806,121,43,88,.489,29,61,.475,14,27,.519,13,17,.765,113
64,LAC,2015-01-16,121,,CLE,L 121-126,240,43,91,.473,33,62,.532,10,29,.345,25,36,.694,121,46,83,.554,36,60,.600,10,23,.435,24,31,.774,126
65,LAC,2014-12-08,121,,PHO,W 121-120 (OT),265,44,96,.458,35,65,.538,9,31,.290,24,30,.800,121,44,91,.484,28,54,.519,16,37,.432,16,20,.800,120
66,BOS,2014-11-14,121,,CLE,L 121-122,240,48,88,.545,42,68,.618,6,20,.300,19,23,.826,121,43,85,.506,35,62,.565,8,23,.348,28,37,.757,122
67,GSW,2014-11-05,121,,LAC,W 121-104,240,43,74,.581,28,49,.571,15,25,.600,20,20,1.000,121,38,82,.463,31,63,.492,7,19,.368,21,27,.778,104
68,BOS,2014-10-29,121,,BRK,W 121-105,240,49,88,.557,41,66,.621,8,22,.364,15,23,.652,121,39,80,.488,32,61,.525,7,19,.368,20,26,.769,105
69,POR,2015-03-28,120,,DEN,W 120-114,240,48,85,.565,40,67,.597,8,18,.444,16,18,.889,120,43,92,.467,34,68,.500,9,24,.375,19,22,.864,114
70,HOU,2015-03-27,120,,MIN,W 120-110,240,44,83,.530,24,39,.615,20,44,.455,12,17,.706,120,37,76,.487,31,62,.500,6,14,.429,30,34,.882,110
71,SAS,2015-03-06,120,,DEN,W 120-111,240,43,79,.544,34,55,.618,9,24,.375,25,33,.758,120,45,86,.523,39,69,.565,6,17,.353,15,23,.652,111
72,CLE,2015-02-08,120,,LAL,W 120-105,240,45,82,.549,27,49,.551,18,33,.545,12,20,.600,120,41,100,.410,34,77,.442,7,23,.304,16,19,.842,105
73,ORL,2015-01-14,120,,HOU,W 120-113,240,44,90,.489,35,64,.547,9,26,.346,23,26,.885,120,42,83,.506,33,57,.579,9,26,.346,20,23,.870,113
74,ATL,2015-01-11,120,,WAS,W 120-89,240,42,89,.472,26,58,.448,16,31,.516,20,24,.833,120,36,76,.474,31,56,.554,5,20,.250,12,15,.800,89
75,LAC,2015-01-10,120,,DAL,W 120-100,240,46,88,.523,33,57,.579,13,31,.419,15,21,.714,120,38,86,.442,26,56,.464,12,30,.400,12,17,.706,100
76,LAC,2014-12-06,120,,NOP,W 120-100,240,43,78,.551,26,46,.565,17,32,.531,17,24,.708,120,38,80,.475,30,57,.526,8,23,.348,16,25,.640,100
77,PHO,2014-11-26,120,,DEN,W 120-112,240,45,88,.511,32,63,.508,13,25,.520,17,21,.810,120,39,90,.433,31,65,.477,8,25,.320,26,34,.765,112
78,LAC,2014-11-15,120,,PHO,W 120-107,240,36,68,.529,22,39,.564,14,29,.483,34,43,.791,120,38,99,.384,27,69,.391,11,30,.367,20,23,.870,107
79,TOR,2014-11-09,120,,PHI,W 120-88,240,43,76,.566,36,59,.610,7,17,.412,27,30,.900,120,33,87,.379,23,53,.434,10,34,.294,12,18,.667,88
80,DAL,2014-10-30,120,,UTA,W 120-102,240,47,85,.553,39,64,.609,8,21,.381,18,23,.783,120,36,83,.434,22,48,.458,14,35,.400,16,18,.889,102
81,DEN,2015-04-08,119,,LAL,W 119-101,240,44,88,.500,31,58,.534,13,30,.433,18,24,.750,119,36,75,.480,31,59,.525,5,16,.313,24,35,.686,101
82,DAL,2015-03-16,119,,OKC,W 119-115,240,42,89,.472,32,64,.500,10,25,.400,25,35,.714,119,40,90,.444,33,64,.516,7,26,.269,28,35,.800,115
83,ORL,2015-03-06,119,,SAC,W 119-114,240,48,85,.565,35,61,.574,13,24,.542,10,12,.833,119,38,85,.447,28,58,.483,10,27,.370,28,38,.737,114
84,MIA,2015-02-23,119,,PHI,W 119-108,240,46,83,.554,35,62,.565,11,21,.524,16,22,.727,119,40,84,.476,27,53,.509,13,31,.419,15,28,.536,108
85,OKC,2015-02-22,119,,DEN,W 119-94,240,48,92,.522,40,72,.556,8,20,.400,15,23,.652,119,35,97,.361,28,70,.400,7,27,.259,17,20,.850,94
86,LAC,2015-02-19,119,,SAS,W 119-115,240,42,77,.545,34,58,.586,8,19,.421,27,52,.519,119,43,84,.512,33,56,.589,10,28,.357,19,23,.826,115
87,TOR,2015-01-28,119,,SAC,W 119-102,240,43,84,.512,26,50,.520,17,34,.500,16,19,.842,119,35,73,.479,28,56,.500,7,17,.412,25,29,.862,102
88,DET,2014-12-26,119,,IND,W 119-109,240,47,86,.547,37,60,.617,10,26,.385,15,29,.517,119,42,83,.506,33,63,.524,9,20,.450,16,22,.727,109
89,SAS,2014-12-19,119,,POR,L 119-129 (3OT),315,45,109,.413,37,89,.416,8,20,.400,21,26,.808,119,47,110,.427,34,75,.453,13,35,.371,22,23,.957,129
90,NOP,2014-12-16,119,,UTA,W 119-111,240,47,79,.595,39,63,.619,8,16,.500,17,18,.944,119,45,90,.500,40,75,.533,5,15,.333,16,19,.842,111
91,NOP,2014-12-12,119,,CLE,W 119-114,240,44,79,.557,32,51,.627,12,28,.429,19,25,.760,119,44,89,.494,36,67,.537,8,22,.364,18,23,.783,114
92,WAS,2014-12-05,119,,DEN,W 119-89,240,45,85,.529,38,65,.585,7,20,.350,22,27,.815,119,31,82,.378,26,60,.433,5,22,.227,22,30,.733,89
93,LAL,2014-11-28,119,,MIN,L 119-120,240,48,89,.539,40,68,.588,8,21,.381,15,22,.682,119,45,79,.570,35,61,.574,10,18,.556,20,24,.833,120
94,MEM,2014-11-17,119,,HOU,W 119-93,240,46,86,.535,39,69,.565,7,17,.412,20,22,.909,119,34,78,.436,26,44,.591,8,34,.235,17,21,.810,93
95,PHO,2014-10-29,119,,LAL,W 119-99,240,45,82,.549,29,50,.580,16,32,.500,13,18,.722,119,37,86,.430,33,73,.452,4,13,.308,21,25,.840,99
96,HOU,2015-03-19,118,,DEN,W 118-108,240,37,83,.446,25,53,.472,12,30,.400,32,40,.800,118,42,93,.452,29,57,.509,13,36,.361,11,19,.579,108
97,POR,2015-03-13,118,,DET,W 118-99,240,46,80,.575,35,59,.593,11,21,.524,15,17,.882,118,41,91,.451,34,66,.515,7,25,.280,10,12,.833,99
98,IND,2015-03-10,118,,ORL,W 118-86,240,45,85,.529,28,51,.549,17,34,.500,11,12,.917,118,34,92,.370,30,75,.400,4,17,.235,14,20,.700,86
99,LAL,2015-02-22,118,,BOS,W 118-111 (OT),265,43,84,.512,36,66,.545,7,18,.389,25,38,.658,118,42,98,.429,34,65,.523,8,33,.242,19,27,.704,111
100,PHO,2015-02-10,118,,HOU,L 118-127,240,41,87,.471,29,61,.475,12,26,.462,24,30,.800,118,48,95,.505,33,58,.569,15,37,.405,16,23,.696,127
101,PHO,2015-01-21,118,,POR,W 118-113,240,47,92,.511,38,65,.585,9,27,.333,15,24,.625,118,39,87,.448,26,55,.473,13,32,.406,22,28,.786,113
102,TOR,2014-12-21,118,,NYK,W 118-108,240,42,86,.488,28,53,.528,14,33,.424,20,27,.741,118,40,82,.488,35,68,.515,5,14,.357,23,26,.885,108
103,BRK,2014-11-19,118,,MIL,L 118-122 (3OT),315,44,92,.478,35,61,.574,9,31,.290,21,29,.724,118,48,108,.444,43,84,.512,5,24,.208,21,28,.750,122
104,CLE,2014-11-10,118,,NOP,W 118-111,240,40,81,.494,27,54,.500,13,27,.481,25,30,.833,118,41,93,.441,29,66,.439,12,27,.444,17,20,.850,111
105,DAL,2014-11-03,118,,BOS,W 118-113,240,44,82,.537,30,57,.526,14,25,.560,16,20,.800,118,45,102,.441,34,71,.479,11,31,.355,12,16,.750,113
106,UTA,2014-11-01,118,,PHO,W 118-91,240,42,88,.477,35,62,.565,7,26,.269,27,33,.818,118,36,87,.414,29,56,.518,7,31,.226,12,15,.800,91
107,HOU,2015-04-15,117,,UTA,W 117-91,240,41,76,.539,29,48,.604,12,28,.429,23,34,.676,117,38,101,.376,33,74,.446,5,27,.185,10,18,.556,91
108,BOS,2015-04-12,117,,CLE,W 117-78,240,46,84,.548,36,60,.600,10,24,.417,15,22,.682,117,31,79,.392,28,57,.491,3,22,.136,13,19,.684,78
109,BRK,2015-04-10,117,,WAS,W 117-80,240,45,89,.506,33,69,.478,12,20,.600,15,23,.652,117,32,82,.390,27,67,.403,5,15,.333,11,17,.647,80
110,CLE,2015-03-18,117,,BRK,W 117-92,240,45,82,.549,30,53,.566,15,29,.517,12,20,.600,117,36,80,.450,31,60,.517,5,20,.250,15,21,.714,92
111,SAS,2015-03-10,117,,TOR,W 117-107,240,41,85,.482,30,67,.448,11,18,.611,24,30,.800,117,43,97,.443,35,71,.493,8,26,.308,13,18,.722,107
112,PHO,2015-02-26,117,,OKC,W 117-113 (OT),265,48,97,.495,39,71,.549,9,26,.346,12,21,.571,117,39,101,.386,31,77,.403,8,24,.333,27,30,.900,113
113,HOU,2015-02-06,117,,MIL,W 117-111,240,41,81,.506,26,49,.531,15,32,.469,20,29,.690,117,48,95,.505,44,78,.564,4,17,.235,11,15,.733,111
114,GSW,2015-01-07,117,,IND,W 117-102,240,45,91,.495,33,63,.524,12,28,.429,15,20,.750,117,37,81,.457,31,55,.564,6,26,.231,22,23,.957,102
115,GSW,2015-01-05,117,,OKC,W 117-91,240,41,88,.466,26,60,.433,15,28,.536,20,32,.625,117,30,98,.306,25,70,.357,5,28,.179,26,34,.765,91
116,DEN,2014-11-21,117,,NOP,W 117-97,240,43,82,.524,32,58,.552,11,24,.458,20,25,.800,117,31,78,.397,26,62,.419,5,16,.313,30,34,.882,97
117,MEM,2014-11-21,117,,BOS,W 117-100,240,48,91,.527,40,75,.533,8,16,.500,13,14,.929,117,38,88,.432,29,61,.475,9,27,.333,15,21,.714,100
118,MIL,2014-11-18,117,,NYK,W 117-113,240,43,78,.551,34,61,.557,9,17,.529,22,27,.815,117,44,80,.550,33,55,.600,11,25,.440,14,19,.737,113
119,IND,2015-04-12,116,,OKC,W 116-104,240,42,79,.532,32,59,.542,10,20,.500,22,35,.629,116,41,95,.432,30,67,.448,11,28,.393,11,28,.393,104
120,DET,2015-04-12,116,,CHO,W 116-77,240,41,81,.506,25,53,.472,16,28,.571,18,23,.783,116,27,79,.342,23,64,.359,4,15,.267,19,29,.655,77
121,OKC,2015-04-10,116,,SAC,W 116-103,240,44,97,.454,34,66,.515,10,31,.323,18,24,.750,116,37,81,.457,28,57,.491,9,24,.375,20,28,.714,103
122,GSW,2015-04-09,116,,POR,W 116-105,240,48,90,.533,36,64,.563,12,26,.462,8,9,.889,116,46,98,.469,39,74,.527,7,24,.292,6,8,.750,105
123,POR,2015-04-08,116,,MIN,W 116-91,240,42,85,.494,30,52,.577,12,33,.364,20,23,.870,116,32,85,.376,29,74,.392,3,11,.273,24,29,.828,91
124,SAC,2015-04-07,116,,MIN,W 116-111,240,42,80,.525,33,56,.589,9,24,.375,23,34,.676,116,45,93,.484,39,74,.527,6,19,.316,15,21,.714,111
125,TOR,2015-04-04,116,,BOS,L 116-117 (OT),265,40,83,.482,34,60,.567,6,23,.261,30,38,.789,116,47,97,.485,39,71,.549,8,26,.308,15,22,.682,117
126,SAS,2015-03-08,116,,CHI,W 116-105,240,44,90,.489,35,68,.515,9,22,.409,19,24,.792,116,37,73,.507,32,58,.552,5,15,.333,26,29,.897,105
127,WAS,2015-01-31,116,,TOR,L 116-120 (OT),265,37,79,.468,27,55,.491,10,24,.417,32,41,.780,116,44,88,.500,33,62,.532,11,26,.423,21,30,.700,120
128,SAS,2014-12-17,116,,MEM,L 116-117 (3OT),315,43,105,.410,26,70,.371,17,35,.486,13,27,.481,116,48,107,.449,38,80,.475,10,27,.370,11,14,.786,117
129,PHO,2014-12-02,116,,IND,W 116-99,240,43,86,.500,31,61,.508,12,25,.480,18,26,.692,116,41,85,.482,37,72,.514,4,13,.308,13,17,.765,99
130,POR,2014-11-09,116,,DEN,W 116-100,240,45,100,.450,29,69,.420,16,31,.516,10,14,.714,116,36,91,.396,31,78,.397,5,13,.385,23,30,.767,100
131,BRK,2014-11-03,116,,OKC,W 116-85,240,44,84,.524,33,61,.541,11,23,.478,17,19,.895,116,32,82,.390,24,59,.407,8,23,.348,13,21,.619,85
132,HOU,2015-04-01,115,,SAC,W 115-111,240,41,89,.461,23,49,.469,18,40,.450,15,25,.600,115,48,96,.500,41,82,.500,7,14,.500,8,16,.500,111
133,CHO,2015-03-28,115,,ATL,W 115-100,240,42,80,.525,30,54,.556,12,26,.462,19,22,.864,115,37,86,.430,22,56,.393,15,30,.500,11,14,.786,100
134,DEN,2015-03-11,115,,ATL,W 115-102,240,42,84,.500,29,53,.547,13,31,.419,18,20,.900,115,34,81,.420,25,54,.463,9,27,.333,25,27,.926,102
135,MIA,2015-03-02,115,,PHO,W 115-98,240,43,82,.524,36,68,.529,7,14,.500,22,30,.733,115,33,78,.423,26,47,.553,7,31,.226,25,38,.658,98
136,POR,2015-02-27,115,,OKC,W 115-112,240,39,89,.438,29,63,.460,10,26,.385,27,31,.871,115,45,94,.479,41,80,.513,4,14,.286,18,22,.818,112
137,DET,2015-02-27,115,,NYK,L 115-121 (2OT),290,39,97,.402,31,66,.470,8,31,.258,29,40,.725,115,45,109,.413,39,91,.429,6,18,.333,25,26,.962,121
138,BOS,2015-02-25,115,,NYK,W 115-94,240,42,83,.506,28,52,.538,14,31,.452,17,20,.850,115,34,82,.415,32,61,.525,2,21,.095,24,31,.774,94
139,NOP,2015-02-02,115,,ATL,W 115-100,240,43,86,.500,34,63,.540,9,23,.391,20,23,.870,115,40,89,.449,33,67,.493,7,22,.318,13,17,.765,100
140,DEN,2015-01-25,115,,WAS,L 115-117 (OT),265,41,101,.406,29,72,.403,12,29,.414,21,28,.750,115,48,90,.533,44,76,.579,4,14,.286,17,23,.739,117
141,PHO,2015-01-19,115,,LAL,W 115-100,240,43,86,.500,30,54,.556,13,32,.406,16,22,.727,115,34,75,.453,26,58,.448,8,17,.471,24,35,.686,100
142,HOU,2015-01-03,115,,MIA,W 115-79,240,41,83,.494,28,52,.538,13,31,.419,20,28,.714,115,30,68,.441,26,51,.510,4,17,.235,15,25,.600,79
143,LAL,2014-12-23,115,,GSW,W 115-105,240,46,89,.517,34,63,.540,12,26,.462,11,17,.647,115,39,84,.464,27,58,.466,12,26,.462,15,17,.882,105
144,PHI,2014-12-13,115,,MEM,L 115-120 (OT),265,40,82,.488,29,54,.537,11,28,.393,24,34,.706,115,45,93,.484,34,67,.507,11,26,.423,19,27,.704,120
145,CHI,2014-12-12,115,,POR,W 115-106,240,44,88,.500,39,73,.534,5,15,.333,22,28,.786,115,43,88,.489,31,64,.484,12,24,.500,8,11,.727,106
146,ATL,2014-11-26,115,,TOR,L 115-126,240,42,82,.512,32,58,.552,10,24,.417,21,24,.875,115,42,82,.512,28,53,.528,14,29,.483,28,33,.848,126
147,MIN,2014-11-19,115,,NYK,W 115-99,240,44,89,.494,33,67,.493,11,22,.500,16,22,.727,115,34,69,.493,25,53,.472,9,16,.563,22,28,.786,99
148,LAL,2014-11-16,115,,GSW,L 115-136,240,39,99,.394,36,83,.434,3,16,.188,34,43,.791,115,46,86,.535,32,58,.552,14,28,.500,30,34,.882,136
149,PHI,2014-11-07,115,,CHI,L 115-118,240,43,91,.473,31,61,.508,12,30,.400,17,25,.680,115,40,78,.513,28,54,.519,12,24,.500,26,34,.765,118
150,DAL,2015-04-15,114,,POR,W 114-98,240,39,86,.453,30,61,.492,9,25,.360,27,34,.794,114,38,91,.418,31,66,.470,7,25,.280,15,18,.833,98
151,CHI,2015-04-11,114,,PHI,W 114-107,240,40,90,.444,31,64,.484,9,26,.346,25,36,.694,114,37,89,.416,24,48,.500,13,41,.317,20,25,.800,107
152,BRK,2015-04-03,114,,TOR,W 114-109,240,46,88,.523,41,72,.569,5,16,.313,17,23,.739,114,42,82,.512,34,56,.607,8,26,.308,17,23,.739,109
153,CLE,2015-04-02,114,,MIA,W 114-88,240,40,80,.500,25,45,.556,15,35,.429,19,25,.760,114,32,75,.427,25,54,.463,7,21,.333,17,21,.810,88
154,GSW,2015-03-18,114,,ATL,W 114-95,240,44,84,.524,30,54,.556,14,30,.467,12,20,.600,114,31,87,.356,23,65,.354,8,22,.364,25,30,.833,95
155,DEN,2015-03-13,114,,GSW,W 114-103,240,41,82,.500,33,65,.508,8,17,.471,24,37,.649,114,39,92,.424,31,73,.425,8,19,.421,17,22,.773,103
156,PHI,2015-03-13,114,,SAC,W 114-107,240,45,95,.474,36,63,.571,9,32,.281,15,23,.652,114,35,87,.402,31,73,.425,4,14,.286,33,40,.825,107
157,MIA,2015-03-07,114,,SAC,W 114-109 (OT),265,41,80,.513,34,56,.607,7,24,.292,25,33,.758,114,40,88,.455,30,63,.476,10,25,.400,19,24,.792,109
158,DEN,2015-02-09,114,,OKC,L 114-124,240,42,87,.483,33,59,.559,9,28,.321,21,29,.724,114,43,80,.538,31,56,.554,12,24,.500,26,35,.743,124
159,WAS,2015-02-07,114,,BRK,W 114-77,240,44,87,.506,35,67,.522,9,20,.450,17,23,.739,114,26,77,.338,22,59,.373,4,18,.222,21,31,.677,77
160,IND,2015-02-04,114,,DET,W 114-109,240,46,77,.597,34,56,.607,12,21,.571,10,18,.556,114,43,87,.494,31,63,.492,12,24,.500,11,15,.733,109
161,DET,2015-01-31,114,,HOU,W 114-101,240,41,82,.500,31,57,.544,10,25,.400,22,35,.629,114,39,87,.448,28,55,.509,11,32,.344,12,19,.632,101
162,GSW,2015-01-25,114,,BOS,W 114-111,240,42,89,.472,34,66,.515,8,23,.348,22,25,.880,114,41,95,.432,31,67,.463,10,28,.357,19,27,.704,111
163,TOR,2015-01-25,114,,DET,W 114-110,240,43,81,.531,38,66,.576,5,15,.333,23,29,.793,114,41,90,.456,29,56,.518,12,34,.353,16,23,.696,110
164,DEN,2015-01-14,114,,DAL,W 114-107,240,41,82,.500,37,63,.587,4,19,.211,28,35,.800,114,41,100,.410,32,63,.508,9,37,.243,16,20,.800,107
165,CHI,2015-01-12,114,,ORL,L 114-121,240,41,84,.488,33,57,.579,8,27,.296,24,33,.727,114,48,81,.593,41,63,.651,7,18,.389,18,29,.621,121
166,LAC,2015-01-07,114,,LAL,W 114-89,240,40,85,.471,28,52,.538,12,33,.364,22,30,.733,114,37,85,.435,32,65,.492,5,20,.250,10,17,.588,89
167,CHI,2015-01-05,114,,HOU,W 114-105,240,41,85,.482,36,68,.529,5,17,.294,27,30,.900,114,47,102,.461,39,77,.506,8,25,.320,3,5,.600,105
168,DET,2015-01-04,114,,SAC,W 114-95,240,45,91,.495,33,60,.550,12,31,.387,12,16,.750,114,32,75,.427,29,60,.483,3,15,.200,28,36,.778,95
169,DEN,2015-01-03,114,,MEM,W 114-85,240,41,79,.519,34,64,.531,7,15,.467,25,31,.806,114,37,86,.430,35,72,.486,2,14,.143,9,13,.692,85
170,DAL,2014-12-30,114,,WAS,W 114-87,240,43,82,.524,35,67,.522,8,15,.533,20,29,.690,114,33,74,.446,29,62,.468,4,12,.333,17,27,.630,87
171,POR,2014-12-26,114,,PHI,W 114-93,240,42,88,.477,24,45,.533,18,43,.419,12,14,.857,114,36,81,.444,33,67,.493,3,14,.214,18,33,.545,93
172,BOS,2014-12-19,114,,MIN,W 114-98,240,48,85,.565,40,62,.645,8,23,.348,10,14,.714,114,42,93,.452,36,81,.444,6,12,.500,8,16,.500,98
173,GSW,2014-12-18,114,,OKC,W 114-109,240,48,94,.511,36,63,.571,12,31,.387,6,10,.600,114,41,86,.477,30,61,.492,11,25,.440,16,24,.667,109
174,MEM,2014-12-09,114,,DAL,W 114-105,240,41,85,.482,34,71,.479,7,14,.500,25,29,.862,114,38,85,.447,20,45,.444,18,40,.450,11,14,.786,105
175,OKC,2014-12-09,114,,MIL,W 114-101,240,41,82,.500,37,61,.607,4,21,.190,28,34,.824,114,34,84,.405,30,63,.476,4,21,.190,29,35,.829,101
176,LAC,2014-12-03,114,,ORL,W 114-86,240,42,78,.538,30,47,.638,12,31,.387,18,25,.720,114,33,79,.418,26,59,.441,7,20,.350,13,25,.520,86
177,DEN,2014-11-25,114,,CHI,W 114-109,240,43,85,.506,35,69,.507,8,16,.500,20,27,.741,114,35,82,.427,28,61,.459,7,21,.333,32,37,.865,109
178,BOS,2014-11-17,114,,PHO,L 114-118,240,45,87,.517,41,77,.532,4,10,.400,20,31,.645,114,48,93,.516,39,72,.542,9,21,.429,13,16,.813,118
179,ATL,2014-11-14,114,,MIA,W 114-103,240,42,75,.560,31,47,.660,11,28,.393,19,23,.826,114,35,74,.473,25,53,.472,10,21,.476,23,25,.920,103
180,CLE,2015-04-15,113,,WAS,W 113-108 (OT),265,43,91,.473,27,61,.443,16,30,.533,11,17,.647,113,42,97,.433,34,75,.453,8,22,.364,16,21,.762,108
181,MIN,2015-04-15,113,,OKC,L 113-138,240,39,84,.464,33,65,.508,6,19,.316,29,35,.829,113,52,95,.547,40,67,.597,12,28,.429,22,31,.710,138
182,LAC,2015-03-20,113,,WAS,W 113-99,240,45,86,.523,33,63,.524,12,23,.522,11,17,.647,113,37,86,.430,31,67,.463,6,19,.316,19,23,.826,99
183,WAS,2015-03-14,113,,SAC,W 113-97,240,43,81,.531,30,55,.545,13,26,.500,14,17,.824,113,35,77,.455,29,58,.500,6,19,.316,21,28,.750,97
184,OKC,2015-03-13,113,,MIN,W 113-99,240,44,101,.436,33,77,.429,11,24,.458,14,14,1.000,113,34,78,.436,31,66,.470,3,12,.250,28,31,.903,99
185,HOU,2015-02-23,113,,MIN,W 113-102,240,39,94,.415,27,56,.482,12,38,.316,23,34,.676,113,31,93,.333,26,75,.347,5,18,.278,35,39,.897,102
186,CHI,2015-02-12,113,,CLE,W 113-98,240,42,92,.457,33,69,.478,9,23,.391,20,26,.769,113,37,85,.435,29,54,.537,8,31,.258,16,22,.727,98
187,CLE,2015-02-11,113,,MIA,W 113-93,240,44,78,.564,34,53,.642,10,25,.400,15,19,.789,113,34,84,.405,25,60,.417,9,24,.375,16,20,.800,93
188,OKC,2015-02-06,113,,NOP,L 113-116,240,40,89,.449,32,65,.492,8,24,.333,25,28,.893,113,40,83,.482,29,63,.460,11,20,.550,25,30,.833,116
189,MIL,2015-02-04,113,,LAL,W 113-105 (OT),265,41,82,.500,30,56,.536,11,26,.423,20,22,.909,113,39,93,.419,30,65,.462,9,28,.321,18,25,.720,105
190,ATL,2015-01-28,113,,BRK,W 113-102,240,38,82,.463,26,49,.531,12,33,.364,25,26,.962,113,39,87,.448,30,63,.476,9,24,.375,15,18,.833,102
191,NYK,2015-01-23,113,,ORL,W 113-106,240,43,91,.473,33,66,.500,10,25,.400,17,21,.810,113,44,87,.506,37,60,.617,7,27,.259,11,19,.579,106
192,CHI,2014-12-25,113,,LAL,W 113-93,240,42,86,.488,32,62,.516,10,24,.417,19,25,.760,113,36,92,.391,31,76,.408,5,16,.313,16,21,.762,93
193,LAC,2014-12-15,113,,DET,W 113-91,240,43,80,.538,31,56,.554,12,24,.500,15,20,.750,113,35,83,.422,27,56,.482,8,27,.296,13,22,.591,91
194,MEM,2014-12-12,113,,CHO,W 113-107 (2OT),290,39,85,.459,33,72,.458,6,13,.462,29,38,.763,113,41,98,.418,35,81,.432,6,17,.353,19,27,.704,107
195,BOS,2014-12-05,113,,LAL,W 113-96,240,46,90,.511,38,70,.543,8,20,.400,13,22,.591,113,38,92,.413,32,76,.421,6,16,.375,14,19,.737,96
196,CLE,2014-11-26,113,,WAS,W 113-87,240,38,74,.514,32,54,.593,6,20,.300,31,38,.816,113,33,71,.465,28,58,.483,5,13,.385,16,22,.727,87
197,DEN,2014-11-12,113,,POR,L 113-130,240,39,90,.433,31,67,.463,8,23,.348,27,33,.818,113,45,88,.511,29,55,.527,16,33,.485,24,29,.828,130
198,IND,2015-04-05,112,,MIA,W 112-89,240,37,85,.435,23,55,.418,14,30,.467,24,36,.667,112,37,82,.451,35,62,.565,2,20,.100,13,19,.684,89
199,OKC,2015-04-05,112,,HOU,L 112-115,240,40,92,.435,26,62,.419,14,30,.467,18,26,.692,112,38,81,.469,30,53,.566,8,28,.286,31,50,.620,115
200,GSW,2015-03-20,112,,NOP,W 112-96,240,44,88,.500,39,69,.565,5,19,.263,19,23,.826,112,33,77,.429,22,55,.400,11,22,.500,19,22,.864,96
201,SAS,2015-03-04,112,,SAC,W 112-85,240,45,85,.529,35,62,.565,10,23,.435,12,16,.750,112,29,78,.372,26,69,.377,3,9,.333,24,34,.706,85
202,TOR,2015-03-04,112,,CLE,L 112-120,240,43,79,.544,33,58,.569,10,21,.476,16,17,.941,112,40,78,.513,25,42,.595,15,36,.417,25,34,.735,120
203,CHI,2015-02-21,112,,PHO,W 112-107,240,43,89,.483,31,65,.477,12,24,.500,14,16,.875,112,47,88,.534,37,63,.587,10,25,.400,3,8,.375,107
204,ATL,2015-01-25,112,,MIN,W 112-100,240,45,80,.563,35,52,.673,10,28,.357,12,18,.667,112,37,71,.521,31,55,.564,6,16,.375,20,25,.800,100
205,HOU,2015-01-15,112,,OKC,W 112-101,240,41,86,.477,25,50,.500,16,36,.444,14,19,.737,112,35,81,.432,24,52,.462,11,29,.379,20,28,.714,101
206,GSW,2015-01-09,112,,CLE,W 112-94,240,43,86,.500,33,56,.589,10,30,.333,16,17,.941,112,35,86,.407,28,63,.444,7,23,.304,17,23,.739,94
207,PHO,2015-01-02,112,,PHI,W 112-96,240,42,84,.500,28,52,.538,14,32,.438,14,16,.875,112,37,87,.425,30,61,.492,7,26,.269,15,25,.600,96
208,DAL,2014-12-28,112,,OKC,W 112-107,240,39,88,.443,29,57,.509,10,31,.323,24,28,.857,112,45,90,.500,40,76,.526,5,14,.357,12,21,.571,107
209,OKC,2014-12-14,112,,PHO,W 112-88,240,39,80,.488,35,62,.565,4,18,.222,30,34,.882,112,34,99,.343,27,68,.397,7,31,.226,13,18,.722,88
210,DAL,2014-12-10,112,,NOP,W 112-107,240,44,83,.530,35,62,.565,9,21,.429,15,17,.882,112,40,88,.455,33,70,.471,7,18,.389,20,24,.833,107
211,TOR,2014-12-08,112,,DEN,W 112-107 (OT),265,41,81,.506,32,48,.667,9,33,.273,21,29,.724,112,43,104,.413,33,74,.446,10,30,.333,11,15,.733,107
212,MIN,2014-12-05,112,,HOU,L 112-114 (OT),265,45,97,.464,42,87,.483,3,10,.300,19,27,.704,112,38,78,.487,26,46,.565,12,32,.375,26,31,.839,114
213,GSW,2014-12-04,112,,NOP,W 112-85,240,47,100,.470,37,78,.474,10,22,.455,8,17,.471,112,37,89,.416,34,74,.459,3,15,.200,8,13,.615,85
214,NOP,2014-12-02,112,,OKC,W 112-104,240,39,88,.443,34,71,.479,5,17,.294,29,45,.644,112,37,84,.440,30,60,.500,7,24,.292,23,27,.852,104
215,SAS,2014-11-28,112,,SAC,W 112-104,240,42,82,.512,30,58,.517,12,24,.500,16,20,.800,112,38,75,.507,32,65,.492,6,10,.600,22,26,.846,104
216,GSW,2014-11-15,112,,CHO,W 112-87,240,45,87,.517,34,61,.557,11,26,.423,11,14,.786,112,32,84,.381,25,67,.373,7,17,.412,16,28,.571,87
217,PHO,2014-11-12,112,,BRK,W 112-104,240,39,81,.481,31,57,.544,8,24,.333,26,29,.897,112,35,74,.473,26,53,.491,9,21,.429,25,32,.781,104
218,PHO,2014-11-07,112,,SAC,L 112-114 (2OT),290,42,98,.429,32,67,.478,10,31,.323,18,25,.720,112,39,91,.429,36,75,.480,3,16,.188,33,39,.846,114
219,ORL,2014-11-07,112,,MIN,W 112-103 (OT),265,46,91,.505,41,81,.506,5,10,.500,15,19,.789,112,40,93,.430,36,75,.480,4,18,.222,19,25,.760,103
220,GSW,2015-04-13,111,,MEM,W 111-107,240,39,74,.527,26,50,.520,13,24,.542,20,27,.741,111,41,98,.418,36,83,.434,5,15,.333,20,25,.800,107
221,BRK,2015-04-08,111,,ATL,L 111-114,240,41,87,.471,34,61,.557,7,26,.269,22,25,.880,111,43,86,.500,32,58,.552,11,28,.393,17,25,.680,114
222,BRK,2015-03-31,111,,IND,W 111-106,240,40,80,.500,31,62,.500,9,18,.500,22,28,.786,111,37,82,.451,25,59,.424,12,23,.522,20,24,.833,106
223,PHI,2015-03-30,111,,LAL,L 111-113 (OT),265,39,96,.406,29,66,.439,10,30,.333,23,38,.605,111,40,82,.488,30,61,.492,10,21,.476,23,30,.767,113
224,CHI,2015-03-28,111,,NYK,W 111-80,240,43,84,.512,37,67,.552,6,17,.353,19,22,.864,111,30,79,.380,26,62,.419,4,17,.235,16,19,.842,80
225,MIL,2015-03-26,111,,IND,W 111-107,240,39,73,.534,30,54,.556,9,19,.474,24,34,.706,111,30,71,.423,16,41,.390,14,30,.467,33,43,.767,107
226,IND,2015-03-21,111,,BRK,L 111-123,240,45,90,.500,37,67,.552,8,23,.348,13,18,.722,111,46,75,.613,40,63,.635,6,12,.500,25,31,.806,123
227,ORL,2015-03-20,111,,POR,W 111-104,240,43,94,.457,38,82,.463,5,12,.417,20,24,.833,111,38,80,.475,31,56,.554,7,24,.292,21,24,.875,104
228,NOP,2015-03-15,111,,DEN,L 111-118 (2OT),290,46,99,.465,40,77,.519,6,22,.273,13,21,.619,111,46,104,.442,36,73,.493,10,31,.323,16,20,.800,118
229,POR,2015-02-25,111,,SAS,W 111-95,240,43,85,.506,30,59,.508,13,26,.500,12,15,.800,111,37,85,.435,29,64,.453,8,21,.381,13,14,.929,95
230,MIN,2015-02-20,111,,PHO,W 111-109,240,40,86,.465,36,71,.507,4,15,.267,27,38,.711,111,40,89,.449,33,72,.458,7,17,.412,22,31,.710,109
231,DAL,2015-02-20,111,,HOU,W 111-100,240,44,93,.473,35,69,.507,9,24,.375,14,18,.778,111,36,87,.414,24,50,.480,12,37,.324,16,26,.615,100
232,MIL,2015-02-11,111,,SAC,W 111-103,240,39,80,.488,32,65,.492,7,15,.467,26,32,.813,111,36,84,.429,28,62,.452,8,22,.364,23,30,.767,103
233,DAL,2015-02-07,111,,POR,W 111-101 (OT),265,43,105,.410,29,69,.420,14,36,.389,11,16,.688,111,37,89,.416,27,57,.474,10,32,.313,17,24,.708,101
234,GSW,2015-01-27,111,,CHI,L 111-113 (OT),265,48,113,.425,39,80,.488,9,33,.273,6,12,.500,111,42,98,.429,34,69,.493,8,29,.276,21,23,.913,113
235,PHO,2015-01-23,111,,HOU,L 111-113,240,42,91,.462,32,61,.525,10,30,.333,17,24,.708,111,44,84,.524,34,57,.596,10,27,.370,15,20,.750,113
236,WAS,2015-01-19,111,,PHI,W 111-76,240,45,81,.556,38,68,.559,7,13,.538,14,18,.778,111,28,85,.329,22,61,.361,6,24,.250,14,23,.609,76
237,TOR,2015-01-12,111,,DET,L 111-114,240,47,87,.540,40,60,.667,7,27,.259,10,14,.714,111,41,96,.427,34,75,.453,7,21,.333,25,31,.806,114
238,MIN,2015-01-07,111,,PHO,L 111-113,240,44,92,.478,37,75,.493,7,17,.412,16,19,.842,111,46,96,.479,41,70,.586,5,26,.192,16,19,.842,113
239,NOP,2015-01-02,111,,HOU,W 111-83,240,44,83,.530,37,68,.544,7,15,.467,16,20,.800,111,35,88,.398,29,59,.492,6,29,.207,7,11,.636,83
240,MEM,2014-12-26,111,,HOU,L 111-117 (OT),265,43,104,.413,36,80,.450,7,24,.292,18,23,.783,111,41,91,.451,27,57,.474,14,34,.412,21,28,.750,117
241,OKC,2014-12-23,111,,POR,L 111-115 (OT),265,46,101,.455,40,82,.488,6,19,.316,13,15,.867,111,38,91,.418,21,60,.350,17,31,.548,22,24,.917,115
242,DEN,2014-12-17,111,,HOU,L 111-115 (OT),265,40,99,.404,27,69,.391,13,30,.433,18,23,.783,111,35,85,.412,27,57,.474,8,28,.286,37,48,.771,115
243,MIL,2014-12-13,111,,LAC,W 111-106,240,43,76,.566,36,65,.554,7,11,.636,18,24,.750,111,39,91,.429,25,62,.403,14,29,.483,14,19,.737,106
244,WAS,2014-12-03,111,,LAL,W 111-95,240,45,93,.484,39,74,.527,6,19,.316,15,19,.789,111,33,85,.388,21,56,.375,12,29,.414,17,21,.810,95
245,CLE,2014-12-02,111,,MIL,W 111-108,240,39,73,.534,33,52,.635,6,21,.286,27,38,.711,111,45,92,.489,38,72,.528,7,20,.350,11,13,.846,108
246,TOR,2014-11-15,111,,UTA,W 111-93,240,43,84,.512,35,63,.556,8,21,.381,17,23,.739,111,33,75,.440,28,59,.475,5,16,.313,22,30,.733,93
247,MEM,2014-11-13,111,,SAC,W 111-110,240,39,77,.506,33,68,.485,6,9,.667,27,34,.794,111,37,77,.481,30,64,.469,7,13,.538,29,34,.853,110
248,LAL,2014-10-31,111,,LAC,L 111-118,240,42,82,.512,35,62,.565,7,20,.350,20,28,.714,111,34,71,.479,22,38,.579,12,33,.364,38,44,.864,118
249,LAC,2015-04-13,110,,DEN,W 110-103,240,37,82,.451,30,61,.492,7,21,.333,29,37,.784,110,38,101,.376,26,68,.382,12,33,.364,15,22,.682,103
250,GSW,2015-04-11,110,,MIN,W 110-101,240,42,93,.452,31,62,.500,11,31,.355,15,21,.714,110,35,79,.443,24,55,.436,11,24,.458,20,26,.769,101
251,SAS,2015-04-08,110,,HOU,W 110-98,240,48,95,.505,41,74,.554,7,21,.333,7,9,.778,110,39,84,.464,29,59,.492,10,25,.400,10,16,.625,98
252,MEM,2015-04-08,110,,NOP,W 110-74,240,45,88,.511,37,71,.521,8,17,.471,12,14,.857,110,28,80,.350,22,59,.373,6,21,.286,12,18,.667,74
253,DAL,2015-04-04,110,,GSW,L 110-123,240,34,80,.425,31,64,.484,3,16,.188,39,54,.722,110,43,95,.453,29,59,.492,14,36,.389,23,32,.719,123
254,NOP,2015-03-29,110,,MIN,W 110-88,240,43,75,.573,37,62,.597,6,13,.462,18,24,.750,110,32,75,.427,30,63,.476,2,12,.167,22,24,.917,88
255,WAS,2015-03-27,110,,CHO,W 110-107 (2OT),290,44,113,.389,35,88,.398,9,25,.360,13,22,.591,110,36,104,.346,28,79,.354,8,25,.320,27,35,.771,107
256,CLE,2015-03-03,110,,BOS,W 110-79,240,43,89,.483,33,61,.541,10,28,.357,14,14,1.000,110,31,88,.352,24,60,.400,7,28,.250,10,13,.769,79
257,BRK,2015-03-02,110,,GSW,W 110-108,240,44,89,.494,34,68,.500,10,21,.476,12,16,.750,110,42,90,.467,31,60,.517,11,30,.367,13,18,.722,108
258,CLE,2015-02-26,110,,GSW,W 110-99,240,36,77,.468,27,49,.551,9,28,.321,29,35,.829,110,39,92,.424,28,63,.444,11,29,.379,10,19,.526,99
259,HOU,2015-02-25,110,,LAC,W 110-105,240,36,88,.409,19,44,.432,17,44,.386,21,30,.700,110,40,91,.440,29,59,.492,11,32,.344,14,19,.737,105
260,PHO,2015-02-23,110,,BOS,L 110-115,240,44,97,.454,35,65,.538,9,32,.281,13,16,.813,110,39,89,.438,25,60,.417,14,29,.483,23,30,.767,115
261,GSW,2015-02-20,110,,SAS,W 110-99,240,41,84,.488,24,51,.471,17,33,.515,11,18,.611,110,39,81,.481,33,62,.532,6,19,.316,15,20,.750,99
262,LAC,2015-02-11,110,,HOU,W 110-95,240,39,81,.481,35,59,.593,4,22,.182,28,45,.622,110,34,87,.391,25,42,.595,9,45,.200,18,22,.818,95
263,SAS,2015-02-04,110,,ORL,W 110-103,240,44,84,.524,30,52,.577,14,32,.438,8,14,.571,110,42,84,.500,32,63,.508,10,21,.476,9,14,.643,103
264,UTA,2015-01-30,110,,GSW,W 110-100,240,42,94,.447,33,69,.478,9,25,.360,17,28,.607,110,37,86,.430,29,59,.492,8,27,.296,18,25,.720,100
265,MIN,2015-01-28,110,,BOS,W 110-98,240,38,77,.494,32,61,.525,6,16,.375,28,32,.875,110,42,91,.462,35,68,.515,7,23,.304,7,9,.778,98
266,ATL,2015-01-21,110,,IND,W 110-91,240,39,78,.500,26,49,.531,13,29,.448,19,26,.731,110,31,78,.397,26,53,.491,5,25,.200,24,26,.923,91
267,HOU,2015-01-19,110,,IND,W 110-98,240,37,72,.514,25,41,.610,12,31,.387,24,33,.727,110,39,85,.459,33,58,.569,6,27,.222,14,18,.778,98
268,SAS,2015-01-16,110,,POR,W 110-96,240,42,94,.447,31,65,.477,11,29,.379,15,17,.882,110,37,74,.500,31,55,.564,6,19,.316,16,20,.800,96
269,PHO,2015-01-16,110,,MIN,W 110-99,240,48,87,.552,43,72,.597,5,15,.333,9,11,.818,110,42,91,.462,34,69,.493,8,22,.364,7,12,.583,99
270,NOP,2014-12-30,110,,PHO,W 110-106,240,42,81,.519,34,63,.540,8,18,.444,18,29,.621,110,41,86,.477,32,65,.492,9,21,.429,15,19,.789,106
271,SAS,2014-12-28,110,,HOU,W 110-106,240,39,83,.470,28,53,.528,11,30,.367,21,24,.875,110,38,77,.494,26,44,.591,12,33,.364,18,31,.581,106
272,GSW,2014-12-27,110,,MIN,W 110-97,240,41,88,.466,30,60,.500,11,28,.393,17,21,.810,110,34,77,.442,26,58,.448,8,19,.421,21,36,.583,97
273,HOU,2014-12-22,110,,POR,W 110-95,240,41,87,.471,28,51,.549,13,36,.361,15,20,.750,110,34,76,.447,24,49,.490,10,27,.370,17,18,.944,95
274,CHO,2014-12-22,110,,DEN,W 110-82,240,43,80,.538,35,61,.574,8,19,.421,16,24,.667,110,31,82,.378,29,64,.453,2,18,.111,18,24,.750,82
275,BRK,2014-12-21,110,,DET,W 110-105,240,40,76,.526,32,56,.571,8,20,.400,22,29,.759,110,40,91,.440,31,64,.484,9,27,.333,16,26,.615,105
276,IND,2014-12-15,110,,LAL,W 110-91,240,40,83,.482,33,66,.500,7,17,.412,23,27,.852,110,29,88,.330,19,62,.306,10,26,.385,23,29,.793,91
277,SAS,2014-12-12,110,,LAL,L 110-112 (OT),265,42,90,.467,30,59,.508,12,31,.387,14,21,.667,110,44,96,.458,32,72,.444,12,24,.500,12,15,.800,112
278,BRK,2014-11-07,110,,NYK,W 110-99,240,38,74,.514,24,50,.480,14,24,.583,20,26,.769,110,37,90,.411,29,71,.408,8,19,.421,17,21,.810,99
279,UTA,2015-04-13,109,,DAL,W 109-92,240,41,82,.500,30,54,.556,11,28,.393,16,26,.615,109,34,82,.415,25,62,.403,9,20,.450,15,23,.652,92
280,CLE,2015-04-13,109,,DET,W 109-97,240,43,85,.506,26,53,.491,17,32,.531,6,12,.500,109,38,83,.458,29,58,.500,9,25,.360,12,20,.600,97
281,POR,2015-03-30,109,,PHO,W 109-86,240,44,86,.512,32,59,.542,12,27,.444,9,10,.900,109,38,87,.437,35,71,.493,3,16,.188,7,10,.700,86
282,MIA,2015-03-29,109,,DET,W 109-102,240,39,82,.476,32,64,.500,7,18,.389,24,29,.828,109,40,83,.482,32,58,.552,8,25,.320,14,22,.636,102
283,SAC,2015-03-22,109,,WAS,W 109-86,240,40,79,.506,32,62,.516,8,17,.471,21,23,.913,109,35,87,.402,32,70,.457,3,17,.176,13,18,.722,86
284,OKC,2015-03-15,109,,CHI,W 109-100,240,40,87,.460,32,66,.485,8,21,.381,21,30,.700,109,37,83,.446,28,54,.519,9,29,.310,17,24,.708,100
285,UTA,2015-03-12,109,,HOU,W 109-91,240,44,92,.478,33,59,.559,11,33,.333,10,17,.588,109,34,79,.430,27,47,.574,7,32,.219,16,24,.667,91
286,IND,2015-03-12,109,,MIL,W 109-103 (OT),265,39,79,.494,30,57,.526,9,22,.409,22,28,.786,109,35,91,.385,31,77,.403,4,14,.286,29,36,.806,103
287,SAC,2015-02-20,109,,BOS,W 109-101,240,40,83,.482,32,61,.525,8,22,.364,21,26,.808,109,40,100,.400,34,78,.436,6,22,.273,15,26,.577,101
288,MIA,2015-02-09,109,,NYK,W 109-95,240,36,74,.486,24,52,.462,12,22,.545,25,29,.862,109,36,84,.429,29,64,.453,7,20,.350,16,19,.842,95
289,NOP,2015-01-25,109,,DAL,W 109-106,240,40,79,.506,32,62,.516,8,17,.471,21,25,.840,109,39,81,.481,30,57,.526,9,24,.375,19,25,.760,106
290,TOR,2015-01-10,109,,BOS,W 109-96,240,41,91,.451,28,61,.459,13,30,.433,14,19,.737,109,39,83,.470,33,65,.508,6,18,.333,12,20,.600,96
291,CHI,2015-01-03,109,,BOS,W 109-104 (OT),265,37,100,.370,31,72,.431,6,28,.214,29,40,.725,109,45,100,.450,40,83,.482,5,17,.294,9,11,.818,104
292,OKC,2015-01-02,109,,WAS,W 109-102,240,44,83,.530,36,64,.563,8,19,.421,13,19,.684,109,39,84,.464,28,63,.444,11,21,.524,13,15,.867,102
293,ATL,2014-12-30,109,,CLE,W 109-101,240,40,79,.506,30,50,.600,10,29,.345,19,26,.731,109,37,84,.440,24,53,.453,13,31,.419,14,21,.667,101
294,DEN,2014-12-19,109,,LAC,W 109-106,240,38,80,.475,27,51,.529,11,29,.379,22,30,.733,109,39,85,.459,36,67,.537,3,18,.167,25,33,.758,106
295,BOS,2014-12-17,109,,ORL,W 109-92,240,44,80,.550,37,61,.607,7,19,.368,14,18,.778,109,37,85,.435,32,66,.485,5,19,.263,13,15,.867,92
296,WAS,2014-12-16,109,,MIN,W 109-95,240,43,86,.500,33,69,.478,10,17,.588,13,18,.722,109,36,81,.444,33,73,.452,3,8,.375,20,35,.571,95
297,SAC,2014-12-11,109,,HOU,L 109-113 (OT),265,39,84,.464,31,66,.470,8,18,.444,23,34,.676,109,38,95,.400,23,51,.451,15,44,.341,22,31,.710,113
298,SAS,2014-12-10,109,,NYK,W 109-95,240,37,73,.507,27,54,.500,10,19,.526,25,30,.833,109,37,76,.487,31,61,.508,6,15,.400,15,17,.882,95
299,MIL,2014-12-05,109,,MIA,W 109-85,240,39,69,.565,30,53,.566,9,16,.563,22,26,.846,109,30,68,.441,23,50,.460,7,18,.389,18,27,.667,85
300,BOS,2014-12-03,109,,DET,W 109-102 (OT),265,37,93,.398,24,63,.381,13,30,.433,22,27,.815,109,37,102,.363,29,75,.387,8,27,.296,20,29,.690,102
301,SAC,2014-12-02,109,,TOR,L 109-117,240,39,75,.520,36,65,.554,3,10,.300,28,37,.757,109,44,88,.500,34,65,.523,10,23,.435,19,21,.905,117
302,ATL,2014-12-02,109,,BOS,W 109-105,240,43,82,.524,32,58,.552,11,24,.458,12,14,.857,109,41,84,.488,29,61,.475,12,23,.522,11,13,.846,105
303,CLE,2014-11-29,109,,IND,W 109-97,240,41,78,.526,34,62,.548,7,16,.438,20,32,.625,109,35,89,.393,28,67,.418,7,22,.318,20,26,.769,97
304,DAL,2014-11-26,109,,NYK,W 109-102 (OT),265,38,95,.400,34,64,.531,4,31,.129,29,38,.763,109,39,92,.424,25,64,.391,14,28,.500,10,16,.625,102
305,ATL,2014-11-18,109,,LAL,L 109-114,240,41,85,.482,32,58,.552,9,27,.333,18,23,.783,109,47,87,.540,41,70,.586,6,17,.353,14,22,.636,114
306,NYK,2014-11-16,109,,DEN,W 109-93,240,41,76,.539,35,62,.565,6,14,.429,21,27,.778,109,32,82,.390,19,48,.396,13,34,.382,16,26,.615,93
307,NOP,2014-11-12,109,,LAL,W 109-102,240,45,82,.549,37,63,.587,8,19,.421,11,18,.611,109,35,84,.417,28,63,.444,7,21,.333,25,32,.781,102
308,TOR,2014-10-29,109,,ATL,W 109-102,240,37,90,.411,29,64,.453,8,26,.308,27,33,.818,109,40,80,.500,27,58,.466,13,22,.591,9,17,.529,102
309,NOP,2015-04-15,108,,SAS,W 108-103,240,43,83,.518,38,73,.521,5,10,.500,17,25,.680,108,45,79,.570,42,69,.609,3,10,.300,10,13,.769,103
310,ATL,2015-04-13,108,,NYK,L 108-112,240,39,88,.443,28,56,.500,11,32,.344,19,23,.826,108,43,77,.558,30,52,.577,13,25,.520,13,19,.684,112
311,WAS,2015-04-12,108,,ATL,W 108-99,240,39,85,.459,30,64,.469,9,21,.429,21,27,.778,108,36,87,.414,27,58,.466,9,29,.310,18,24,.750,99
312,POR,2015-03-24,108,,GSW,L 108-122,240,39,92,.424,24,58,.414,15,34,.441,15,19,.789,108,50,83,.602,38,57,.667,12,26,.462,10,11,.909,122
313,DET,2015-03-24,108,,TOR,W 108-104,240,40,93,.430,28,64,.438,12,29,.414,16,24,.667,108,35,75,.467,28,52,.538,7,23,.304,27,29,.931,104
314,CHI,2015-03-20,108,,TOR,W 108-92,240,42,79,.532,33,51,.647,9,28,.321,15,17,.882,108,30,79,.380,20,54,.370,10,25,.400,22,26,.846,92
315,MIA,2015-03-20,108,,DEN,W 108-91,240,43,81,.531,36,65,.554,7,16,.438,15,19,.789,108,37,79,.468,30,52,.577,7,27,.259,10,19,.526,91
316,MIA,2015-03-18,108,,POR,W 108-104,240,46,87,.529,39,77,.506,7,10,.700,9,14,.643,108,41,81,.506,31,55,.564,10,26,.385,12,21,.571,104
317,GSW,2015-03-16,108,,LAL,W 108-105,240,40,84,.476,33,57,.579,7,27,.259,21,23,.913,108,39,85,.459,31,70,.443,8,15,.533,19,21,.905,105
318,BOS,2015-03-16,108,,PHI,W 108-89,240,44,88,.500,36,68,.529,8,20,.400,12,15,.800,108,34,84,.405,26,60,.433,8,24,.333,13,24,.542,89
319,ORL,2015-03-15,108,,CLE,L 108-123,240,42,88,.477,33,69,.478,9,19,.474,15,27,.556,108,45,76,.592,27,41,.659,18,35,.514,15,19,.789,123
320,OKC,2015-03-11,108,,LAC,L 108-120,240,33,76,.434,21,51,.412,12,25,.480,30,36,.833,108,35,76,.461,20,46,.435,15,30,.500,35,47,.745,120
321,OKC,2015-03-08,108,,TOR,W 108-104,240,42,82,.512,36,61,.590,6,21,.286,18,25,.720,108,42,98,.429,31,71,.437,11,27,.407,9,9,1.000,104
322,CHI,2015-03-05,108,,OKC,W 108-105,240,40,87,.460,33,62,.532,7,25,.280,21,26,.808,108,41,88,.466,33,68,.485,8,20,.400,15,19,.789,105
323,POR,2015-02-05,108,,PHO,W 108-87,240,40,90,.444,32,59,.542,8,31,.258,20,23,.870,108,34,88,.386,28,65,.431,6,23,.261,13,17,.765,87
324,DET,2015-02-03,108,,MIA,W 108-91,240,42,88,.477,33,68,.485,9,20,.450,15,18,.833,108,35,74,.473,29,60,.483,6,14,.429,15,23,.652,91
325,NOP,2015-01-30,108,,LAC,W 108-103,240,36,86,.419,23,61,.377,13,25,.520,23,26,.885,108,42,92,.457,35,64,.547,7,28,.250,12,17,.706,103
326,CLE,2015-01-25,108,,OKC,W 108-98,240,36,82,.439,20,46,.435,16,36,.444,20,29,.690,108,37,94,.394,27,64,.422,10,30,.333,14,18,.778,98
327,UTA,2015-01-24,108,,BRK,W 108-73,240,42,79,.532,29,50,.580,13,29,.448,11,14,.786,108,29,75,.387,24,60,.400,5,15,.333,10,16,.625,73
328,CLE,2015-01-19,108,,CHI,W 108-94,240,41,90,.456,33,72,.458,8,18,.444,18,25,.720,108,30,80,.375,22,64,.344,8,16,.500,26,32,.813,94
329,SAC,2015-01-17,108,,LAC,L 108-117,240,41,89,.461,36,71,.507,5,18,.278,21,26,.808,108,44,92,.478,35,64,.547,9,28,.321,20,31,.645,117
330,BOS,2015-01-12,108,,NOP,W 108-100,240,37,88,.420,29,64,.453,8,24,.333,26,31,.839,108,31,75,.413,25,60,.417,6,15,.400,32,37,.865,100
331,SAC,2015-01-09,108,,DEN,L 108-118,240,42,86,.488,36,67,.537,6,19,.316,18,24,.750,108,47,85,.553,42,68,.618,5,17,.294,19,28,.679,118
332,SAC,2014-12-21,108,,LAL,W 108-101,240,38,79,.481,31,56,.554,7,23,.304,25,36,.694,108,33,87,.379,23,61,.377,10,26,.385,25,30,.833,101
333,POR,2014-12-15,108,,SAS,W 108-95,240,41,89,.461,34,71,.479,7,18,.389,19,22,.864,108,38,78,.487,34,67,.507,4,11,.364,15,22,.682,95
334,HOU,2014-12-13,108,,DEN,W 108-96,240,39,88,.443,29,54,.537,10,34,.294,20,34,.588,108,36,96,.375,29,68,.426,7,28,.250,17,26,.654,96
335,POR,2014-11-06,108,,DAL,W 108-87,240,40,77,.519,28,47,.596,12,30,.400,16,19,.842,108,33,90,.367,28,67,.418,5,23,.217,16,16,1.000,87
336,WAS,2014-11-01,108,,MIL,W 108-97,240,40,73,.548,36,60,.600,4,13,.308,24,33,.727,108,34,80,.425,25,58,.431,9,22,.409,20,24,.833,97
337,CHI,2014-10-31,108,,CLE,L 108-114 (OT),265,41,90,.456,28,59,.475,13,31,.419,13,17,.765,108,41,104,.394,38,89,.427,3,15,.200,29,33,.879,114
338,CHO,2014-10-29,108,,MIL,W 108-106 (OT),265,41,101,.406,35,80,.438,6,21,.286,20,29,.690,108,39,80,.488,32,66,.485,7,14,.500,21,24,.875,106
339,SAS,2015-04-12,107,,PHO,W 107-91,240,35,69,.507,27,50,.540,8,19,.421,29,34,.853,107,35,85,.412,31,69,.449,4,16,.250,17,23,.739,91
340,DAL,2015-04-08,107,,PHO,W 107-104,240,45,94,.479,41,76,.539,4,18,.222,13,16,.813,107,40,82,.488,32,57,.561,8,25,.320,16,19,.842,104
341,SAS,2015-04-05,107,,GSW,W 107-92,240,44,83,.530,37,62,.597,7,21,.333,12,15,.800,107,39,91,.429,30,63,.476,9,28,.321,5,10,.500,92
342,GSW,2015-04-02,107,,PHO,W 107-106,240,43,93,.462,33,67,.493,10,26,.385,11,17,.647,107,42,90,.467,37,71,.521,5,19,.263,17,26,.654,106
343,BRK,2015-03-29,107,,LAL,W 107-99,240,42,87,.483,34,59,.576,8,28,.286,15,21,.714,107,42,91,.462,36,73,.493,6,18,.333,9,11,.818,99
344,DEN,2015-03-27,107,,UTA,W 107-91,240,39,76,.513,26,52,.500,13,24,.542,16,23,.696,107,32,81,.395,27,54,.500,5,27,.185,22,31,.710,91
345,SAC,2015-03-24,107,,PHI,W 107-106,240,35,97,.361,28,77,.364,7,20,.350,30,38,.789,107,40,81,.494,27,53,.509,13,28,.464,13,21,.619,106
346,GSW,2015-03-23,107,,WAS,W 107-76,240,39,95,.411,26,62,.419,13,33,.394,16,21,.762,107,27,81,.333,24,70,.343,3,11,.273,19,26,.731,76
347,LAC,2015-03-22,107,,NOP,W 107-100,240,42,91,.462,35,68,.515,7,23,.304,16,23,.696,107,38,75,.507,26,53,.491,12,22,.545,12,16,.750,100
348,DET,2015-03-21,107,,CHI,W 107-91,240,44,90,.489,33,64,.516,11,26,.423,8,10,.800,107,33,77,.429,27,56,.482,6,21,.286,19,24,.792,91
349,DAL,2015-03-18,107,,ORL,W 107-102,240,39,80,.488,26,49,.531,13,31,.419,16,24,.667,107,40,87,.460,31,59,.525,9,28,.321,13,14,.929,102
350,HOU,2015-03-17,107,,ORL,W 107-94,240,39,78,.500,28,51,.549,11,27,.407,18,27,.667,107,38,89,.427,32,67,.478,6,22,.273,12,17,.706,94
351,WAS,2015-03-12,107,,MEM,W 107-87,240,40,80,.500,35,63,.556,5,17,.294,22,31,.710,107,31,80,.388,28,61,.459,3,19,.158,22,30,.733,87
352,WAS,2015-02-24,107,,GSW,L 107-114,240,42,79,.532,37,61,.607,5,18,.278,18,21,.857,107,45,90,.500,33,67,.493,12,23,.522,12,17,.706,114
353,BOS,2015-02-06,107,,PHI,W 107-96,240,39,86,.453,29,59,.492,10,27,.370,19,25,.760,107,35,79,.443,24,54,.444,11,25,.440,15,31,.484,96
354,DET,2015-01-17,107,,PHI,W 107-89,240,38,88,.432,23,53,.434,15,35,.429,16,19,.842,107,38,82,.463,31,54,.574,7,28,.250,6,7,.857,89
355,PHO,2015-01-13,107,,CLE,W 107-100,240,40,76,.526,33,56,.589,7,20,.350,20,27,.741,107,36,82,.439,23,47,.489,13,35,.371,15,20,.750,100
356,IND,2015-01-09,107,,BOS,W 107-103 (OT),265,34,92,.370,25,69,.362,9,23,.391,30,34,.882,107,41,103,.398,31,69,.449,10,34,.294,11,16,.688,103
357,POR,2015-01-03,107,,ATL,L 107-115,240,42,93,.452,29,60,.483,13,33,.394,10,12,.833,107,43,84,.512,37,67,.552,6,17,.353,23,31,.742,115
358,MIN,2015-01-01,107,,SAC,L 107-110,240,42,91,.462,35,67,.522,7,24,.292,16,22,.727,107,40,74,.541,35,62,.565,5,12,.417,25,29,.862,110
359,BRK,2014-12-29,107,,SAC,W 107-99,240,36,80,.450,28,59,.475,8,21,.381,27,39,.692,107,37,76,.487,28,56,.500,9,20,.450,16,20,.800,99
360,LAL,2014-12-28,107,,PHO,L 107-116,240,42,81,.519,30,61,.492,12,20,.600,11,20,.550,107,44,87,.506,35,65,.538,9,22,.409,19,24,.792,116
361,CHI,2014-12-27,107,,NOP,W 107-100,240,41,89,.461,35,69,.507,6,20,.300,19,22,.864,107,41,88,.466,37,74,.500,4,14,.286,14,16,.875,100
362,BOS,2014-12-26,107,,BRK,L 107-109,240,45,87,.517,36,63,.571,9,24,.375,8,11,.727,107,41,83,.494,34,62,.548,7,21,.333,20,28,.714,109
363,ATL,2014-12-23,107,,LAC,W 107-104,240,34,76,.447,22,53,.415,12,23,.522,27,35,.771,107,37,92,.402,26,63,.413,11,29,.379,19,28,.679,104
364,SAC,2014-12-18,107,,MIL,L 107-108,240,38,67,.567,32,53,.604,6,14,.429,25,33,.758,107,37,75,.493,24,52,.462,13,23,.565,21,27,.778,108
365,WAS,2014-12-01,107,,MIA,W 107-86,240,39,72,.542,29,53,.547,10,19,.526,19,24,.792,107,33,72,.458,31,50,.620,2,22,.091,18,30,.600,86
366,POR,2014-11-30,107,,MIN,W 107-93,240,39,86,.453,27,53,.509,12,33,.364,17,25,.680,107,39,90,.433,37,81,.457,2,9,.222,13,20,.650,93
367,MEM,2014-11-23,107,,LAC,W 107-91,240,42,85,.494,35,64,.547,7,21,.333,16,23,.696,107,32,77,.416,25,52,.481,7,25,.280,20,28,.714,91
368,DEN,2014-11-19,107,,OKC,W 107-100,240,40,82,.488,30,53,.566,10,29,.345,17,22,.773,107,36,79,.456,26,56,.464,10,23,.435,18,25,.720,100
369,GSW,2014-11-13,107,,BRK,W 107-99,240,41,90,.456,30,56,.536,11,34,.324,14,21,.667,107,39,89,.438,36,73,.493,3,16,.188,18,20,.900,99
370,WAS,2014-11-12,107,,DET,W 107-103,240,40,83,.482,37,72,.514,3,11,.273,24,33,.727,107,38,81,.469,29,59,.492,9,22,.409,18,22,.818,103
371,MEM,2014-11-11,107,,LAL,W 107-102,240,41,78,.526,37,67,.552,4,11,.364,21,26,.808,107,41,87,.471,34,65,.523,7,22,.318,13,17,.765,102
372,LAL,2014-11-09,107,,CHO,W 107-92,240,42,82,.512,36,65,.554,6,17,.353,17,22,.773,107,35,79,.443,32,65,.492,3,14,.214,19,27,.704,92
373,PHO,2014-11-09,107,,GSW,W 107-95,240,34,79,.430,22,49,.449,12,30,.400,27,33,.818,107,33,69,.478,22,45,.489,11,24,.458,18,21,.857,95
374,BOS,2014-11-05,107,,TOR,L 107-110,240,40,78,.513,30,52,.577,10,26,.385,17,18,.944,107,42,87,.483,35,71,.493,7,16,.438,19,23,.826,110
375,LAC,2014-11-03,107,,UTA,W 107-101,240,41,81,.506,31,58,.534,10,23,.435,15,17,.882,107,36,77,.468,26,50,.520,10,27,.370,19,24,.792,101
376,MIA,2014-11-02,107,,TOR,W 107-102,240,35,70,.500,26,46,.565,9,24,.375,28,38,.737,107,37,79,.468,33,63,.524,4,16,.250,24,39,.615,102
377,MIA,2014-10-29,107,,WAS,W 107-95,240,39,81,.481,30,53,.566,9,28,.321,20,23,.870,107,36,75,.480,30,56,.536,6,19,.316,17,24,.708,95
378,LAL,2015-04-12,106,,DAL,L 106-120,240,34,78,.436,25,54,.463,9,24,.375,29,36,.806,106,45,83,.542,35,62,.565,10,21,.476,20,26,.769,120
379,LAL,2015-04-10,106,,MIN,W 106-98,240,41,83,.494,32,60,.533,9,23,.391,15,24,.625,106,32,74,.432,29,59,.492,3,15,.200,31,34,.912,98
380,BRK,2015-04-06,106,,POR,W 106-96,240,41,91,.451,35,77,.455,6,14,.429,18,23,.783,106,39,87,.448,28,61,.459,11,26,.423,7,9,.778,96
381,WAS,2015-04-01,106,,PHI,W 106-93,240,44,76,.579,40,64,.625,4,12,.333,14,22,.636,106,36,91,.396,26,57,.456,10,34,.294,11,17,.647,93
382,LAC,2015-03-31,106,,GSW,L 106-110,240,36,82,.439,30,60,.500,6,22,.273,28,33,.848,106,38,85,.447,30,64,.469,8,21,.381,26,34,.765,110
383,BOS,2015-03-29,106,,LAC,L 106-119,240,39,93,.419,31,62,.500,8,31,.258,20,23,.870,106,41,84,.488,28,52,.538,13,32,.406,24,40,.600,119
384,BRK,2015-03-27,106,,CLE,W 106-98,240,40,86,.465,31,63,.492,9,23,.391,17,19,.895,106,37,81,.457,29,51,.569,8,30,.267,16,20,.800,98
385,TOR,2015-03-22,106,,NYK,W 106-89,240,39,75,.520,35,64,.547,4,11,.364,24,29,.828,106,35,84,.417,27,65,.415,8,19,.421,11,16,.688,89
386,GSW,2015-03-21,106,,UTA,W 106-91,240,38,78,.487,30,60,.500,8,18,.444,22,26,.846,106,32,73,.438,22,51,.431,10,22,.455,17,21,.810,91
387,MIN,2015-03-16,106,,BRK,L 106-122,240,41,88,.466,32,73,.438,9,15,.600,15,17,.882,106,52,90,.578,47,77,.610,5,13,.385,13,17,.765,122
388,MIA,2015-03-16,106,,CLE,W 106-92,240,42,76,.553,38,61,.623,4,15,.267,18,22,.818,106,30,79,.380,19,46,.413,11,33,.333,21,27,.778,92
389,PHO,2015-03-11,106,,MIN,W 106-97,240,45,90,.500,39,66,.591,6,24,.250,10,13,.769,106,36,81,.444,35,68,.515,1,13,.077,24,26,.923,97
390,CHO,2015-03-11,106,,SAC,L 106-113,240,42,93,.452,36,75,.480,6,18,.333,16,26,.615,106,40,85,.471,32,65,.492,8,20,.400,25,30,.833,113
391,DEN,2015-03-09,106,,NYK,W 106-78,240,38,87,.437,30,63,.476,8,24,.333,22,29,.759,106,29,75,.387,24,62,.387,5,13,.385,15,25,.600,78
392,GSW,2015-03-08,106,,LAC,W 106-98,240,40,80,.500,30,58,.517,10,22,.455,16,23,.696,106,40,83,.482,32,58,.552,8,25,.320,10,14,.714,98
393,ATL,2015-03-06,106,,CLE,W 106-97,240,43,84,.512,37,63,.587,6,21,.286,14,17,.824,106,29,69,.420,16,31,.516,13,38,.342,26,33,.788,97
394,DEN,2015-03-03,106,,MIL,W 106-95,240,39,86,.453,27,52,.519,12,34,.353,16,20,.800,106,35,86,.407,25,62,.403,10,24,.417,15,22,.682,95
395,BOS,2015-02-27,106,,CHO,W 106-98,240,40,96,.417,26,61,.426,14,35,.400,12,15,.800,106,37,82,.451,27,61,.443,10,21,.476,14,17,.824,98
396,DET,2015-02-22,106,,WAS,W 106-89,240,37,89,.416,24,57,.421,13,32,.406,19,25,.760,106,37,85,.435,31,68,.456,6,17,.353,9,14,.643,89
397,GSW,2015-01-31,106,,PHO,W 106-87,240,40,87,.460,28,55,.509,12,32,.375,14,18,.778,106,33,91,.363,24,65,.369,9,26,.346,12,17,.706,87
398,PHO,2015-01-28,106,,WAS,W 106-98,240,40,88,.455,29,59,.492,11,29,.379,15,18,.833,106,37,88,.420,29,70,.414,8,18,.444,16,23,.696,98
399,CLE,2015-01-21,106,,UTA,W 106-92,240,42,81,.519,37,57,.649,5,24,.208,17,25,.680,106,35,84,.417,27,62,.435,8,22,.364,14,18,.778,92
400,HOU,2015-01-17,106,,GSW,L 106-131,240,37,88,.420,30,65,.462,7,23,.304,25,34,.735,106,50,91,.549,41,69,.594,9,22,.409,22,33,.667,131
401,NOP,2015-01-09,106,,MEM,W 106-95,240,37,81,.457,27,61,.443,10,20,.500,22,26,.846,106,36,82,.439,30,65,.462,6,17,.353,17,22,.773,95
402,LAL,2015-01-02,106,,MEM,L 106-109,240,43,81,.531,37,62,.597,6,19,.316,14,19,.737,106,41,84,.488,35,70,.500,6,14,.429,21,31,.677,109
403,CHI,2015-01-01,106,,DEN,W 106-101,240,38,91,.418,30,76,.395,8,15,.533,22,25,.880,106,37,92,.402,32,78,.410,5,14,.357,22,27,.815,101
404,IND,2014-12-31,106,,MIA,W 106-95,240,35,79,.443,25,61,.410,10,18,.556,26,30,.867,106,38,77,.494,33,61,.541,5,16,.313,14,18,.778,95
405,BOS,2014-12-31,106,,SAC,W 106-84,240,44,94,.468,39,73,.534,5,21,.238,13,15,.867,106,32,87,.368,30,72,.417,2,15,.133,18,28,.643,84
406,SAC,2014-12-26,106,,PHO,L 106-115,240,41,93,.441,34,73,.466,7,20,.350,17,24,.708,106,46,94,.489,32,61,.525,14,33,.424,9,12,.750,115
407,DEN,2014-12-26,106,,MIN,W 106-102,240,39,95,.411,36,76,.474,3,19,.158,25,32,.781,106,41,103,.398,38,88,.432,3,15,.200,17,24,.708,102
408,SAS,2014-12-25,106,,OKC,L 106-114,240,42,81,.519,35,58,.603,7,23,.304,15,21,.714,106,42,81,.519,33,66,.500,9,15,.600,21,38,.553,114
409,LAC,2014-12-20,106,,MIL,W 106-102,240,37,81,.457,25,55,.455,12,26,.462,20,27,.741,106,43,81,.531,35,57,.614,8,24,.333,8,15,.533,102
410,DET,2014-12-17,106,,DAL,L 106-117,240,40,89,.449,27,56,.482,13,33,.394,13,19,.684,106,40,79,.506,30,57,.526,10,22,.455,27,35,.771,117
411,CHO,2014-12-17,106,,PHO,L 106-111,240,40,86,.465,30,62,.484,10,24,.417,16,22,.727,106,43,82,.524,34,57,.596,9,25,.360,16,21,.762,111
412,TOR,2014-12-12,106,,IND,W 106-94,240,38,91,.418,28,65,.431,10,26,.385,20,22,.909,106,33,80,.413,25,58,.431,8,22,.364,20,23,.870,94
413,DAL,2014-12-05,106,,PHO,L 106-118,240,40,88,.455,36,69,.522,4,19,.211,22,30,.733,106,45,80,.563,32,54,.593,13,26,.500,15,17,.882,118
414,SAS,2014-11-26,106,,IND,W 106-100,240,41,74,.554,36,59,.610,5,15,.333,19,29,.655,106,40,87,.460,30,66,.455,10,21,.476,10,18,.556,100
415,CLE,2014-11-24,106,,ORL,W 106-74,240,42,81,.519,36,65,.554,6,16,.375,16,22,.727,106,29,80,.363,24,63,.381,5,17,.294,11,15,.733,74
416,DAL,2014-11-11,106,,SAC,W 106-98,240,38,80,.475,28,53,.528,10,27,.370,20,24,.833,106,32,72,.444,23,53,.434,9,19,.474,25,32,.781,98
417,LAC,2014-11-08,106,,POR,W 106-102,240,40,81,.494,35,69,.507,5,12,.417,21,30,.700,106,36,80,.450,26,55,.473,10,25,.400,20,25,.800,102
418,LAL,2014-11-04,106,,PHO,L 106-112,240,35,88,.398,29,72,.403,6,16,.375,30,41,.732,106,41,91,.451,35,73,.479,6,18,.333,24,31,.774,112
419,POR,2014-10-29,106,,OKC,W 106-89,240,39,87,.448,28,58,.483,11,29,.379,17,22,.773,106,33,81,.407,31,65,.477,2,16,.125,21,26,.808,89
420,POR,2015-04-11,105,,UTA,L 105-111,240,41,87,.471,35,57,.614,6,30,.200,17,22,.773,105,36,79,.456,30,62,.484,6,17,.353,33,42,.786,111
421,ORL,2015-04-08,105,,CHI,W 105-103,240,38,82,.463,30,59,.508,8,23,.348,21,24,.875,105,34,79,.430,22,53,.415,12,26,.462,23,31,.742,103
422,LAC,2015-04-07,105,,LAL,W 105-100,240,39,81,.481,32,57,.561,7,24,.292,20,30,.667,105,35,84,.417,26,59,.441,9,25,.360,21,27,.778,100
423,MIA,2015-04-07,105,,CHO,W 105-100,240,40,81,.494,37,66,.561,3,15,.200,22,28,.786,105,39,91,.429,34,73,.466,5,18,.278,17,21,.810,100
424,DET,2015-03-31,105,,ATL,W 105-95,240,41,83,.494,30,54,.556,11,29,.379,12,17,.706,105,40,84,.476,32,59,.542,8,25,.320,7,10,.700,95
425,SAC,2015-03-18,105,,LAC,L 105-116,240,38,79,.481,35,62,.565,3,17,.176,26,32,.813,105,45,88,.511,28,51,.549,17,37,.459,9,13,.692,116
426,TOR,2015-03-18,105,,MIN,W 105-100,240,35,79,.443,23,50,.460,12,29,.414,23,27,.852,105,42,87,.483,36,70,.514,6,17,.353,10,15,.667,100
427,DET,2015-03-17,105,,MEM,W 105-95,240,39,83,.470,27,50,.540,12,33,.364,15,22,.682,105,35,80,.438,25,62,.403,10,18,.556,15,17,.882,95
428,WAS,2015-03-16,105,,POR,W 105-97,240,41,82,.500,34,70,.486,7,12,.583,16,26,.615,105,36,89,.404,28,61,.459,8,28,.286,17,20,.850,97
429,GSW,2015-03-11,105,,DET,W 105-98,240,44,84,.524,37,64,.578,7,20,.350,10,13,.769,105,42,98,.429,38,86,.442,4,12,.333,10,12,.833,98
430,POR,2015-03-11,105,,HOU,W 105-100,240,42,92,.457,32,59,.542,10,33,.303,11,14,.786,105,38,91,.418,27,60,.450,11,31,.355,13,23,.565,100
431,IND,2015-03-04,105,,NYK,W 105-82,240,38,80,.475,28,58,.483,10,22,.455,19,24,.792,105,30,76,.395,24,60,.400,6,16,.375,16,23,.696,82
432,MIN,2015-03-02,105,,LAC,L 105-110,240,36,82,.439,32,67,.478,4,15,.267,29,35,.829,105,44,92,.478,32,59,.542,12,33,.364,10,19,.526,110
433,HOU,2015-03-01,105,,CLE,W 105-103 (OT),265,34,74,.459,23,44,.523,11,30,.367,26,33,.788,105,40,98,.408,28,58,.483,12,40,.300,11,21,.524,103
434,OKC,2015-02-24,105,,IND,W 105-92,240,40,96,.417,31,72,.431,9,24,.375,16,18,.889,105,38,88,.432,29,62,.468,9,26,.346,7,11,.636,92
435,LAL,2015-02-20,105,,BRK,L 105-114,240,41,89,.461,37,66,.561,4,23,.174,19,29,.655,105,42,89,.472,32,68,.471,10,21,.476,20,24,.833,114
436,OKC,2015-02-11,105,,MEM,W 105-89,240,37,83,.446,30,63,.476,7,20,.350,24,25,.960,105,32,86,.372,30,74,.405,2,12,.167,23,30,.767,89
437,MIN,2015-02-09,105,,ATL,L 105-117,240,42,93,.452,37,77,.481,5,16,.313,16,22,.727,105,44,86,.512,34,65,.523,10,21,.476,19,20,.950,117
438,CLE,2015-02-05,105,,LAC,W 105-94,240,31,72,.431,23,42,.548,8,30,.267,35,44,.795,105,38,91,.418,33,69,.478,5,22,.227,13,20,.650,94
439,ATL,2015-02-04,105,,WAS,W 105-96,240,38,80,.475,27,55,.491,11,25,.440,18,27,.667,105,34,77,.442,30,61,.492,4,16,.250,24,30,.800,96
440,PHI,2015-02-03,105,,DEN,W 105-98,240,31,70,.443,20,43,.465,11,27,.407,32,42,.762,105,33,85,.388,21,54,.389,12,31,.387,20,28,.714,98
441,ATL,2015-01-30,105,,POR,W 105-99,240,40,84,.476,29,61,.475,11,23,.478,14,22,.636,105,39,87,.448,28,57,.491,11,30,.367,10,11,.909,99
442,CHO,2015-01-19,105,,MIN,W 105-80,240,40,89,.449,28,67,.418,12,22,.545,13,19,.684,105,29,80,.363,23,61,.377,6,19,.316,16,20,.800,80
443,DEN,2015-01-17,105,,MIN,L 105-113,240,38,92,.413,28,61,.459,10,31,.323,19,22,.864,105,43,80,.538,35,61,.574,8,19,.421,19,21,.905,113
444,UTA,2015-01-13,105,,GSW,L 105-116,240,39,81,.481,32,60,.533,7,21,.333,20,24,.833,105,46,91,.505,33,66,.500,13,25,.520,11,13,.846,116
445,MEM,2015-01-05,105,,NYK,W 105-83,240,43,82,.524,36,67,.537,7,15,.467,12,19,.632,105,33,76,.434,25,50,.500,8,26,.308,9,13,.692,83
446,CLE,2014-12-21,105,,MEM,W 105-91,240,46,76,.605,39,62,.629,7,14,.500,6,10,.600,105,39,86,.453,38,70,.543,1,16,.063,12,15,.800,91
447,TOR,2014-12-17,105,,BRK,W 105-89,240,41,80,.513,31,60,.517,10,20,.500,13,19,.684,105,35,81,.432,26,54,.481,9,27,.333,10,22,.455,89
448,MEM,2014-12-16,105,,GSW,W 105-98,240,42,92,.457,37,78,.474,5,14,.357,16,19,.842,105,39,95,.411,30,64,.469,9,31,.290,11,12,.917,98
449,GSW,2014-12-10,105,,HOU,W 105-93,240,40,81,.494,32,58,.552,8,23,.348,17,20,.850,105,37,90,.411,28,55,.509,9,35,.257,10,15,.667,93
450,CHI,2014-12-10,105,,BRK,W 105-80,240,37,79,.468,29,57,.509,8,22,.364,23,32,.719,105,29,88,.330,26,74,.351,3,14,.214,19,24,.792,80
451,CLE,2014-12-09,105,,TOR,W 105-101,240,39,79,.494,30,53,.566,9,26,.346,18,21,.857,105,42,82,.512,35,59,.593,7,23,.304,10,10,1.000,101
452,MIL,2014-12-03,105,,DAL,L 105-107,240,38,73,.521,31,62,.500,7,11,.636,22,32,.688,105,42,92,.457,34,65,.523,8,27,.296,15,22,.682,107
453,HOU,2014-12-03,105,,MEM,W 105-96,240,41,93,.441,31,65,.477,10,28,.357,13,20,.650,105,39,76,.513,37,63,.587,2,13,.154,16,27,.593,96
454,ATL,2014-11-29,105,,CHO,W 105-75,240,40,75,.533,28,52,.538,12,23,.522,13,16,.813,105,29,88,.330,24,65,.369,5,23,.217,12,16,.750,75
455,OKC,2014-11-28,105,,NYK,W 105-78,240,38,86,.442,28,62,.452,10,24,.417,19,23,.826,105,29,75,.387,27,56,.482,2,19,.105,18,24,.750,78
456,POR,2014-11-21,105,,CHI,W 105-87,240,39,79,.494,30,63,.476,9,16,.563,18,22,.818,105,30,83,.361,22,61,.361,8,22,.364,19,28,.679,87
457,DEN,2014-11-03,105,,SAC,L 105-110,240,36,93,.387,31,69,.449,5,24,.208,28,33,.848,105,34,81,.420,32,72,.444,2,9,.222,40,47,.851,110
458,MIN,2014-11-01,105,,CHI,L 105-106,240,38,85,.447,34,73,.466,4,12,.333,25,31,.806,105,33,69,.478,24,46,.522,9,23,.391,31,40,.775,106
459,MEM,2014-10-29,105,,MIN,W 105-101,240,43,82,.524,39,67,.582,4,15,.267,15,20,.750,105,39,86,.453,33,74,.446,6,12,.500,17,23,.739,101
460,MIA,2015-04-11,104,,TOR,L 104-107,240,37,81,.457,31,61,.508,6,20,.300,24,44,.545,104,35,83,.422,26,57,.456,9,26,.346,28,37,.757,107
461,ATL,2015-04-10,104,,CHO,W 104-80,240,41,82,.500,31,54,.574,10,28,.357,12,16,.750,104,30,83,.361,22,53,.415,8,30,.267,12,18,.667,80
462,CHO,2015-03-30,104,,BOS,L 104-116,240,40,85,.471,33,59,.559,7,26,.269,17,19,.895,104,45,89,.506,36,63,.571,9,26,.346,17,23,.739,116
463,IND,2015-03-29,104,,DAL,W 104-99,240,38,76,.500,28,59,.475,10,17,.588,18,26,.692,104,40,90,.444,34,75,.453,6,15,.400,13,19,.684,99
464,UTA,2015-03-23,104,,MIN,L 104-106 (OT),265,38,87,.437,29,59,.492,9,28,.321,19,31,.613,104,37,78,.474,25,59,.424,12,19,.632,20,25,.800,106
465,NYK,2015-03-17,104,,SAS,W 104-100 (OT),265,41,91,.451,38,77,.494,3,14,.214,19,27,.704,104,36,94,.383,33,80,.413,3,14,.214,25,30,.833,100
466,MIA,2015-03-11,104,,BRK,W 104-98,240,37,81,.457,31,60,.517,6,21,.286,24,38,.632,104,32,73,.438,26,56,.464,6,17,.353,28,39,.718,98
467,GSW,2015-03-06,104,,DAL,W 104-89,240,38,81,.469,27,58,.466,11,23,.478,17,19,.895,104,32,87,.368,26,67,.388,6,20,.300,19,26,.731,89
468,ATL,2015-03-03,104,,HOU,W 104-96,240,39,86,.453,31,57,.544,8,29,.276,18,21,.857,104,39,90,.433,25,49,.510,14,41,.341,4,9,.444,96
469,CHO,2015-03-03,104,,LAL,W 104-103,240,39,79,.494,34,66,.515,5,13,.385,21,31,.677,104,39,86,.453,33,69,.478,6,17,.353,19,21,.905,103
470,NOP,2015-02-27,104,,MIA,W 104-102,240,39,76,.513,33,60,.550,6,16,.375,20,27,.741,104,41,84,.488,33,63,.524,8,21,.381,12,16,.750,102
471,MIL,2015-02-25,104,,PHI,W 104-88,240,44,82,.537,39,67,.582,5,15,.333,11,16,.688,104,31,75,.413,20,50,.400,11,25,.440,15,19,.789,88
472,ATL,2015-02-25,104,,DAL,W 104-87,240,39,85,.459,26,50,.520,13,35,.371,13,16,.813,104,34,80,.425,29,49,.592,5,31,.161,14,18,.778,87
473,IND,2015-02-22,104,,GSW,W 104-98,240,39,81,.481,31,62,.500,8,19,.421,18,23,.783,104,34,89,.382,25,63,.397,9,26,.346,21,22,.955,98
474,OKC,2015-02-19,104,,DAL,W 104-89,240,38,91,.418,31,69,.449,7,22,.318,21,26,.808,104,33,91,.363,24,64,.375,9,27,.333,14,17,.824,89
475,CHI,2015-02-10,104,,SAC,W 104-86,240,42,80,.525,35,60,.583,7,20,.350,13,15,.867,104,35,75,.467,33,63,.524,2,12,.167,14,27,.519,86
476,BOS,2015-02-04,104,,DEN,W 104-100,240,40,99,.404,28,71,.394,12,28,.429,12,17,.706,104,33,80,.413,29,56,.518,4,24,.167,30,33,.909,100
477,OKC,2015-02-02,104,,ORL,W 104-97,240,37,75,.493,29,55,.527,8,20,.400,22,26,.846,104,38,90,.422,32,67,.478,6,23,.261,15,18,.833,97
478,CHI,2015-01-22,104,,SAS,W 104-81,240,36,76,.474,30,57,.526,6,19,.316,26,32,.813,104,30,81,.370,24,60,.400,6,21,.286,15,18,.833,81
479,GSW,2015-01-14,104,,MIA,W 104-89,240,38,81,.469,25,52,.481,13,29,.448,15,19,.789,104,30,71,.423,24,53,.453,6,18,.333,23,27,.852,89
480,SAC,2015-01-13,104,,DAL,L 104-108 (OT),265,38,86,.442,37,68,.544,1,18,.056,27,34,.794,104,43,100,.430,37,76,.487,6,24,.250,16,23,.696,108
481,SAC,2015-01-07,104,,OKC,W 104-83,240,36,92,.391,26,73,.356,10,19,.526,22,28,.786,104,29,89,.326,20,59,.339,9,30,.300,16,23,.696,83
482,SAS,2015-01-06,104,,DET,L 104-105,240,36,79,.456,27,58,.466,9,21,.429,23,34,.676,104,41,87,.471,38,68,.559,3,19,.158,20,28,.714,105
483,CHO,2014-12-20,104,,UTA,W 104-86,240,42,87,.483,33,65,.508,9,22,.409,11,16,.688,104,33,85,.388,25,54,.463,8,31,.258,12,15,.800,86
484,POR,2014-12-17,104,,MIL,W 104-97,240,41,87,.471,34,64,.531,7,23,.304,15,29,.517,104,37,77,.481,30,58,.517,7,19,.368,16,22,.727,97
485,WAS,2014-12-12,104,,LAC,W 104-96,240,39,80,.488,30,64,.469,9,16,.563,17,21,.810,104,32,75,.427,26,55,.473,6,20,.300,26,31,.839,96
486,NOP,2014-12-09,104,,NYK,W 104-93,240,40,80,.500,36,65,.554,4,15,.267,20,26,.769,104,37,78,.474,28,59,.475,9,19,.474,10,13,.769,93
487,UTA,2014-12-03,104,,TOR,L 104-123,240,42,87,.483,34,59,.576,8,28,.286,12,15,.800,104,45,79,.570,33,58,.569,12,21,.571,21,24,.875,123
488,PHI,2014-11-24,104,,POR,L 104-114,240,42,84,.500,42,76,.553,0,8,.000,20,24,.833,104,44,89,.494,37,62,.597,7,27,.259,19,23,.826,114
489,TOR,2014-11-24,104,,PHO,W 104-100,240,37,82,.451,33,65,.508,4,17,.235,26,32,.813,104,39,84,.464,25,51,.490,14,33,.424,8,11,.727,100
490,TOR,2014-11-11,104,,ORL,W 104-100,240,35,77,.455,26,56,.464,9,21,.429,25,30,.833,104,39,81,.481,27,56,.482,12,25,.480,10,16,.625,100
491,BRK,2014-11-09,104,,ORL,W 104-96,240,40,83,.482,36,69,.522,4,14,.286,20,23,.870,104,39,75,.520,31,60,.517,8,15,.533,10,16,.625,96
492,NOP,2014-11-01,104,,DAL,L 104-109,240,38,89,.427,31,70,.443,7,19,.368,21,28,.750,104,46,89,.517,40,64,.625,6,25,.240,11,19,.579,109
493,HOU,2014-11-01,104,,BOS,W 104-90,240,32,76,.421,20,42,.476,12,34,.353,28,40,.700,104,37,98,.378,36,73,.493,1,25,.040,15,18,.833,90
494,DET,2015-04-10,103,,IND,L 103-107,240,40,89,.449,29,66,.439,11,23,.478,12,23,.522,103,38,79,.481,27,60,.450,11,19,.579,20,22,.909,107
495,HOU,2015-04-10,103,,SAS,L 103-104,240,31,66,.470,22,45,.489,9,21,.429,32,53,.604,103,41,85,.482,37,68,.544,4,17,.235,18,24,.750,104
496,UTA,2015-04-08,103,,SAC,W 103-91,240,36,74,.486,23,43,.535,13,31,.419,18,25,.720,103,33,75,.440,26,59,.441,7,16,.438,18,28,.643,91
497,DET,2015-04-08,103,,BOS,L 103-113,240,45,84,.536,38,66,.576,7,18,.389,6,10,.600,103,36,80,.450,28,52,.538,8,28,.286,33,34,.971,113
498,NOP,2015-04-07,103,,GSW,W 103-100,240,36,83,.434,27,64,.422,9,19,.474,22,30,.733,103,42,95,.442,33,73,.452,9,22,.409,7,10,.700,100
499,SAS,2015-03-29,103,,MEM,W 103-89,240,42,83,.506,38,66,.576,4,17,.235,15,18,.833,103,36,82,.439,30,68,.441,6,14,.429,11,12,.917,89
500,TOR,2015-03-25,103,,CHI,L 103-116,240,39,83,.470,30,62,.484,9,21,.429,16,19,.842,103,45,74,.608,33,51,.647,12,23,.522,14,17,.824,116
501,CHI,2015-03-18,103,,IND,W 103-86,240,34,82,.415,24,58,.414,10,24,.417,25,28,.893,103,32,81,.395,26,62,.419,6,19,.316,16,21,.762,86
502,MIL,2015-03-18,103,,SAS,L 103-114,240,39,80,.488,32,66,.485,7,14,.500,18,24,.750,103,38,76,.500,30,56,.536,8,20,.400,30,38,.789,114
503,SAC,2015-03-16,103,,ATL,L 103-110,240,38,81,.469,31,61,.508,7,20,.350,20,25,.800,103,38,84,.452,26,53,.491,12,31,.387,22,30,.733,110
504,MIL,2015-03-09,103,,NOP,L 103-114,240,37,71,.521,33,56,.589,4,15,.267,25,31,.806,103,44,75,.587,35,60,.583,9,15,.600,17,21,.810,114
505,ORL,2015-03-08,103,,BOS,W 103-98,240,38,87,.437,31,65,.477,7,22,.318,20,30,.667,103,35,89,.393,20,55,.364,15,34,.441,13,16,.813,98
506,CHO,2015-03-06,103,,TOR,W 103-94,240,40,85,.471,35,65,.538,5,20,.250,18,20,.900,103,37,91,.407,30,69,.435,7,22,.318,13,15,.867,94
507,HOU,2015-03-06,103,,DET,W 103-93,240,38,91,.418,32,63,.508,6,28,.214,21,25,.840,103,37,102,.363,31,73,.425,6,29,.207,13,17,.765,93
508,PHI,2015-03-02,103,,TOR,L 103-114,240,41,78,.526,33,58,.569,8,20,.400,13,19,.684,103,41,80,.513,30,53,.566,11,27,.407,21,24,.875,114
509,NYK,2015-02-28,103,,TOR,W 103-98,240,33,75,.440,26,56,.464,7,19,.368,30,38,.789,103,34,81,.420,26,52,.500,8,29,.276,22,28,.786,98
510,ORL,2015-02-22,103,,PHI,W 103-98,240,39,82,.476,33,59,.559,6,23,.261,19,26,.731,103,36,78,.462,23,44,.523,13,34,.382,13,17,.765,98
511,CHO,2015-02-21,103,,OKC,L 103-110,240,40,93,.430,33,69,.478,7,24,.292,16,20,.800,103,42,95,.442,37,77,.481,5,18,.278,21,26,.808,110
512,MIL,2015-02-09,103,,BRK,W 103-97,240,37,89,.416,30,71,.423,7,18,.389,22,25,.880,103,38,76,.500,29,51,.569,9,25,.360,12,19,.632,97
513,IND,2015-02-06,103,,CLE,W 103-99,240,37,79,.468,29,58,.500,8,21,.381,21,26,.808,103,40,89,.449,29,54,.537,11,35,.314,8,12,.667,99
514,ORL,2015-02-06,103,,LAL,W 103-97 (OT),265,43,83,.518,38,68,.559,5,15,.333,12,14,.857,103,39,97,.402,28,71,.394,11,26,.423,8,13,.615,97
515,POR,2015-02-03,103,,UTA,W 103-102,240,36,76,.474,29,53,.547,7,23,.304,24,34,.706,103,39,85,.459,33,72,.458,6,13,.462,18,26,.692,102
516,PHI,2015-01-30,103,,MIN,W 103-94,240,37,74,.500,29,51,.569,8,23,.348,21,25,.840,103,34,76,.447,29,62,.468,5,14,.357,21,25,.840,94
517,IND,2015-01-29,103,,NYK,W 103-82,240,42,79,.532,36,61,.590,6,18,.333,13,18,.722,103,34,81,.420,29,65,.446,5,16,.313,9,13,.692,82
518,MEM,2015-01-26,103,,ORL,W 103-94,240,36,76,.474,29,58,.500,7,18,.389,24,26,.923,103,37,78,.474,33,66,.500,4,12,.333,16,25,.640,94
519,POR,2015-01-24,103,,WAS,W 103-96,240,35,87,.402,22,56,.393,13,31,.419,20,20,1.000,103,40,82,.488,35,67,.522,5,15,.333,11,14,.786,96
520,ATL,2015-01-23,103,,OKC,W 103-93,240,40,83,.482,30,58,.517,10,25,.400,13,13,1.000,103,36,87,.414,26,61,.426,10,26,.385,11,18,.611,93
521,WAS,2015-01-21,103,,OKC,L 103-105 (OT),265,38,100,.380,31,70,.443,7,30,.233,20,26,.769,103,40,102,.392,34,73,.466,6,29,.207,19,23,.826,105
522,BOS,2015-01-16,103,,CHI,L 103-119,240,42,85,.494,37,69,.536,5,16,.313,14,16,.875,103,48,89,.539,35,64,.547,13,25,.520,10,12,.833,119
523,SAC,2015-01-11,103,,CLE,W 103-84,240,42,86,.488,36,69,.522,6,17,.353,13,17,.765,103,33,78,.423,22,46,.478,11,32,.344,7,12,.583,84
524,POR,2015-01-10,103,,ORL,W 103-92,240,36,76,.474,26,50,.520,10,26,.385,21,26,.808,103,37,92,.402,34,71,.479,3,21,.143,15,20,.750,92
525,DET,2015-01-09,103,,ATL,L 103-106,240,38,96,.396,25,53,.472,13,43,.302,14,18,.778,103,40,82,.488,30,59,.508,10,23,.435,16,24,.667,106
526,DEN,2014-12-30,103,,LAL,L 103-111,240,39,87,.448,31,61,.508,8,26,.308,17,27,.630,103,40,76,.526,26,51,.510,14,25,.560,17,26,.654,111
527,HOU,2014-12-29,103,,WAS,L 103-104,240,40,86,.465,31,57,.544,9,29,.310,14,23,.609,103,35,73,.479,27,55,.491,8,18,.444,26,28,.929,104
528,LAL,2014-12-19,103,,OKC,L 103-104,240,41,85,.482,31,60,.517,10,25,.400,11,15,.733,103,37,86,.430,29,65,.446,8,21,.381,22,29,.759,104
529,MIA,2014-12-19,103,,WAS,L 103-105,240,40,75,.533,31,56,.554,9,19,.474,14,19,.737,103,39,79,.494,36,65,.554,3,14,.214,24,33,.727,105
530,CHI,2014-12-18,103,,NYK,W 103-97,240,34,75,.453,22,52,.423,12,23,.522,23,30,.767,103,38,82,.463,32,73,.438,6,9,.667,15,19,.789,97
531,PHO,2014-12-12,103,,DET,L 103-105,240,39,83,.470,29,52,.558,10,31,.323,15,19,.789,103,40,84,.476,36,69,.522,4,15,.267,21,27,.778,105
532,OKC,2014-12-11,103,,CLE,W 103-94,240,38,87,.437,31,61,.508,7,26,.269,20,22,.909,103,31,85,.365,22,57,.386,9,28,.321,23,30,.767,94
533,MEM,2014-12-07,103,,MIA,W 103-87,240,43,73,.589,35,60,.583,8,13,.615,9,11,.818,103,39,80,.488,34,64,.531,5,16,.313,4,8,.500,87
534,CHO,2014-12-05,103,,NYK,W 103-102,240,42,88,.477,38,70,.543,4,18,.222,15,18,.833,103,37,79,.468,27,57,.474,10,22,.455,18,22,.818,102
535,DEN,2014-12-02,103,,POR,L 103-105,240,41,81,.506,34,61,.557,7,20,.350,14,19,.737,103,43,86,.500,38,64,.594,5,22,.227,14,17,.824,105
536,PHI,2014-12-01,103,,SAS,L 103-109,240,38,89,.427,26,60,.433,12,29,.414,15,25,.600,103,36,83,.434,27,57,.474,9,26,.346,28,35,.800,109
537,MIL,2014-11-29,103,,HOU,L 103-117,240,33,74,.446,27,55,.491,6,19,.316,31,35,.886,103,44,87,.506,29,49,.592,15,38,.395,14,16,.875,117
538,PHI,2014-11-29,103,,DAL,L 103-110,240,36,85,.424,30,64,.469,6,21,.286,25,31,.806,103,40,89,.449,32,59,.542,8,30,.267,22,30,.733,110
539,SAC,2014-11-20,103,,CHI,W 103-88,240,38,74,.514,34,68,.500,4,6,.667,23,27,.852,103,36,84,.429,31,65,.477,5,19,.263,11,16,.688,88
540,ATL,2014-11-08,103,,NYK,W 103-96,240,33,81,.407,24,59,.407,9,22,.409,28,36,.778,103,40,84,.476,32,63,.508,8,21,.381,8,11,.727,96
541,TOR,2014-11-07,103,,WAS,W 103-84,240,35,80,.438,26,58,.448,9,22,.409,24,31,.774,103,30,83,.361,27,64,.422,3,19,.158,21,32,.656,84
542,SAC,2014-10-31,103,,POR,W 103-94,240,34,81,.420,30,71,.423,4,10,.400,31,35,.886,103,34,83,.410,25,57,.439,9,26,.346,17,19,.895,94
543,IND,2014-10-29,103,,PHI,W 103-91,240,38,81,.469,30,56,.536,8,25,.320,19,28,.679,103,34,89,.382,28,68,.412,6,21,.286,17,30,.567,91
544,SAC,2015-04-13,102,,LAL,W 102-92,240,35,72,.486,31,56,.554,4,16,.250,28,36,.778,102,40,96,.417,36,81,.444,4,15,.267,8,13,.615,92
545,CHO,2015-04-01,102,,DET,W 102-78,240,38,90,.422,29,68,.426,9,22,.409,17,24,.708,102,31,88,.352,26,66,.394,5,22,.227,11,18,.611,78
546,NOP,2015-03-27,102,,SAC,W 102-88,240,43,84,.512,34,64,.531,9,20,.450,7,12,.583,102,35,79,.443,28,64,.438,7,15,.467,11,18,.611,88
547,HOU,2015-03-21,102,,PHO,L 102-117,240,41,87,.471,31,53,.585,10,34,.294,10,12,.833,102,46,92,.500,38,77,.494,8,15,.533,17,24,.708,117
548,PHO,2015-03-15,102,,NYK,W 102-89,240,41,83,.494,35,65,.538,6,18,.333,14,23,.609,102,32,73,.438,27,59,.458,5,14,.357,20,30,.667,89
549,TOR,2015-03-13,102,,MIA,W 102-92,240,34,79,.430,22,46,.478,12,33,.364,22,31,.710,102,35,79,.443,30,56,.536,5,23,.217,17,24,.708,92
550,GSW,2015-03-04,102,,MIL,W 102-93,240,37,73,.507,23,39,.590,14,34,.412,14,25,.560,102,34,80,.425,29,66,.439,5,14,.357,20,25,.800,93
551,DAL,2015-03-02,102,,NOP,W 102-93,240,38,79,.481,32,63,.508,6,16,.375,20,22,.909,102,35,74,.473,25,53,.472,10,21,.476,13,16,.813,93
552,HOU,2015-02-27,102,,BRK,W 102-98,240,39,84,.464,30,52,.577,9,32,.281,15,17,.882,102,38,85,.447,34,68,.500,4,17,.235,18,20,.900,98
553,NOP,2015-02-25,102,,BRK,W 102-96,240,38,74,.514,27,49,.551,11,25,.440,15,19,.789,102,39,92,.424,32,71,.451,7,21,.333,11,15,.733,96
554,SAC,2015-02-25,102,,MEM,W 102-90,240,39,80,.488,33,64,.516,6,16,.375,18,25,.720,102,34,84,.405,30,68,.441,4,16,.250,18,23,.783,90
555,POR,2015-02-11,102,,LAL,W 102-86,240,35,86,.407,25,56,.446,10,30,.333,22,23,.957,102,34,93,.366,27,77,.351,7,16,.438,11,11,1.000,86
556,CHO,2015-02-08,102,,IND,L 102-103,240,36,77,.468,28,63,.444,8,14,.571,22,28,.786,102,37,84,.440,30,65,.462,7,19,.368,22,25,.880,103
557,UTA,2015-02-07,102,,SAC,W 102-90,240,43,86,.500,38,67,.567,5,19,.263,11,17,.647,102,32,82,.390,29,69,.420,3,13,.231,23,33,.697,90
558,MIN,2015-02-04,102,,MIA,W 102-101,240,37,72,.514,31,61,.508,6,11,.545,22,27,.815,102,39,80,.488,32,64,.500,7,16,.438,16,24,.667,101
559,BRK,2015-02-02,102,,LAC,W 102-100,240,41,83,.494,29,56,.518,12,27,.444,8,18,.444,102,42,89,.472,34,66,.515,8,23,.348,8,25,.320,100
560,MIA,2015-01-27,102,,MIL,L 102-109,240,38,75,.507,31,55,.564,7,20,.350,19,26,.731,102,39,71,.549,30,55,.545,9,16,.563,22,30,.733,109
561,LAC,2015-01-26,102,,DEN,W 102-98,240,38,80,.475,31,61,.508,7,19,.368,19,22,.864,102,40,83,.482,32,62,.516,8,21,.381,10,15,.667,98
562,LAC,2015-01-19,102,,BOS,W 102-93,240,39,82,.476,30,61,.492,9,21,.429,15,19,.789,102,33,84,.393,21,55,.382,12,29,.414,15,21,.714,93
563,MEM,2015-01-17,102,,POR,W 102-98,240,39,77,.506,31,62,.500,8,15,.533,16,24,.667,102,36,93,.387,23,57,.404,13,36,.361,13,15,.867,98
564,LAL,2015-01-15,102,,CLE,L 102-109,240,39,76,.513,31,52,.596,8,24,.333,16,23,.696,102,37,78,.474,28,48,.583,9,30,.300,26,36,.722,109
565,WAS,2015-01-09,102,,CHI,W 102-86,240,41,86,.477,33,71,.465,8,15,.533,12,19,.632,102,32,83,.386,22,57,.386,10,26,.385,12,19,.632,86
566,HOU,2014-12-31,102,,CHO,W 102-83,240,38,88,.432,21,45,.467,17,43,.395,9,14,.643,102,29,76,.382,26,58,.448,3,18,.167,22,26,.846,83
567,POR,2014-12-30,102,,TOR,W 102-97 (OT),265,38,95,.400,26,59,.441,12,36,.333,14,18,.778,102,40,99,.404,36,77,.468,4,22,.182,13,15,.867,97
568,DEN,2014-12-28,102,,TOR,L 102-116,240,37,87,.425,33,70,.471,4,17,.235,24,34,.706,102,43,88,.489,33,65,.508,10,23,.435,20,32,.625,116
569,DAL,2014-12-26,102,,LAL,W 102-98,240,42,83,.506,37,65,.569,5,18,.278,13,24,.542,102,36,99,.364,25,70,.357,11,29,.379,15,20,.750,98
570,BRK,2014-12-23,102,,DEN,W 102-96,240,43,91,.473,37,68,.544,6,23,.261,10,14,.714,102,36,82,.439,29,57,.509,7,25,.280,17,22,.773,96
571,DAL,2014-12-22,102,,ATL,L 102-105,240,39,90,.433,28,62,.452,11,28,.393,13,20,.650,102,40,81,.494,33,62,.532,7,19,.368,18,27,.667,105
572,LAC,2014-12-17,102,,IND,W 102-100,240,34,78,.436,28,60,.467,6,18,.333,28,45,.622,102,40,90,.444,36,71,.507,4,19,.211,16,23,.696,100
573,DEN,2014-12-10,102,,MIA,W 102-82,240,38,85,.447,30,62,.484,8,23,.348,18,27,.667,102,30,82,.366,23,60,.383,7,22,.318,15,21,.714,82
574,CHI,2014-12-06,102,,GSW,L 102-112,240,36,83,.434,29,62,.468,7,21,.333,23,27,.852,102,40,89,.449,28,59,.475,12,30,.400,20,25,.800,112
575,SAC,2014-12-05,102,,IND,W 102-101 (OT),265,36,83,.434,34,73,.466,2,10,.200,28,40,.700,102,36,96,.375,30,70,.429,6,26,.231,23,29,.793,101
576,MIA,2014-12-03,102,,ATL,L 102-112,240,36,64,.563,30,48,.625,6,16,.375,24,32,.750,102,40,74,.541,28,49,.571,12,25,.480,20,23,.870,112
577,TOR,2014-11-28,102,,DAL,L 102-106,240,38,91,.418,24,58,.414,14,33,.424,12,16,.750,102,40,86,.465,29,60,.483,11,26,.423,15,22,.682,106
578,BOS,2014-11-28,102,,CHI,L 102-109,240,37,92,.402,31,70,.443,6,22,.273,22,29,.759,102,37,90,.411,32,73,.438,5,17,.294,30,37,.811,109
579,HOU,2014-11-26,102,,SAC,W 102-89,240,42,94,.447,30,59,.508,12,35,.343,6,15,.400,102,31,71,.437,26,55,.473,5,16,.313,22,28,.786,89
580,WAS,2014-11-25,102,,ATL,L 102-106,240,36,84,.429,27,64,.422,9,20,.450,21,29,.724,102,36,85,.424,29,60,.483,7,25,.280,27,34,.794,106
581,WAS,2014-11-19,102,,DAL,L 102-105,240,37,84,.440,27,62,.435,10,22,.455,18,21,.857,102,34,82,.415,22,54,.407,12,28,.429,25,29,.862,105
582,POR,2014-11-17,102,,NOP,W 102-93,240,38,76,.500,31,57,.544,7,19,.368,19,23,.826,102,38,85,.447,33,66,.500,5,19,.263,12,19,.632,93
583,POR,2014-11-11,102,,CHO,W 102-100,240,40,93,.430,32,68,.471,8,25,.320,14,16,.875,102,35,75,.467,28,59,.475,7,16,.438,23,27,.852,100
584,CHI,2014-11-10,102,,DET,W 102-91,240,39,88,.443,32,68,.471,7,20,.350,17,20,.850,102,34,80,.425,27,66,.409,7,14,.500,16,25,.640,91
585,MIA,2014-11-08,102,,MIN,W 102-92,240,41,78,.526,36,65,.554,5,13,.385,15,17,.882,102,35,87,.402,31,71,.437,4,16,.250,18,23,.783,92
586,UTA,2014-11-05,102,,CLE,W 102-100,240,39,77,.506,32,56,.571,7,21,.333,17,22,.773,102,30,72,.417,24,56,.429,6,16,.375,34,40,.850,100
587,OKC,2014-11-01,102,,DEN,W 102-91,240,37,80,.463,31,60,.517,6,20,.300,22,31,.710,102,35,80,.438,28,54,.519,7,26,.269,14,20,.700,91
588,ATL,2014-11-01,102,,IND,W 102-92,240,35,69,.507,28,49,.571,7,20,.350,25,33,.758,102,31,81,.383,19,49,.388,12,32,.375,18,21,.857,92
589,BRK,2015-04-15,101,,ORL,W 101-88,240,39,80,.488,30,56,.536,9,24,.375,14,23,.609,101,38,79,.481,31,59,.525,7,20,.350,5,13,.385,88
590,PHI,2015-04-15,101,,MIA,L 101-105,240,38,83,.458,33,54,.611,5,29,.172,20,25,.800,101,39,89,.438,27,58,.466,12,31,.387,15,20,.750,105
591,PHO,2015-04-14,101,,LAC,L 101-112,240,39,80,.488,28,54,.519,11,26,.423,12,20,.600,101,42,87,.483,27,49,.551,15,38,.395,13,18,.722,112
592,OKC,2015-04-13,101,,POR,W 101-90,240,39,96,.406,35,75,.467,4,21,.190,19,27,.704,101,38,83,.458,30,60,.500,8,23,.348,6,9,.667,90
593,NYK,2015-04-05,101,,PHI,W 101-91,240,37,72,.514,34,59,.576,3,13,.231,24,29,.828,101,38,99,.384,28,67,.418,10,32,.313,5,8,.625,91
594,WAS,2015-04-03,101,,NYK,W 101-87,240,43,93,.462,36,77,.468,7,16,.438,8,12,.667,101,31,84,.369,24,63,.381,7,21,.333,18,20,.900,87
595,BOS,2015-04-03,101,,MIL,L 101-110,240,39,88,.443,31,64,.484,8,24,.333,15,16,.938,101,45,85,.529,36,61,.590,9,24,.375,11,18,.611,110
596,DAL,2015-04-02,101,,HOU,L 101-108,240,37,84,.440,29,58,.500,8,26,.308,19,27,.704,101,34,77,.442,23,46,.500,11,31,.355,29,40,.725,108
597,ATL,2015-03-30,101,,MIL,W 101-88,240,36,79,.456,27,50,.540,9,29,.310,20,24,.833,101,34,75,.453,30,58,.517,4,17,.235,16,23,.696,88
598,WAS,2015-03-25,101,,IND,L 101-103,240,33,75,.440,28,61,.459,5,14,.357,30,38,.789,101,38,85,.447,29,59,.492,9,26,.346,18,28,.643,103
599,DAL,2015-03-24,101,,SAS,W 101-94,240,42,87,.483,35,65,.538,7,22,.318,10,13,.769,101,36,85,.424,28,57,.491,8,28,.286,14,18,.778,94
600,LAL,2015-03-22,101,,PHI,W 101-87,240,39,81,.481,34,67,.507,5,14,.357,18,22,.818,101,32,89,.360,23,62,.371,9,27,.333,14,21,.667,87
601,SAS,2015-03-20,101,,BOS,W 101-89,240,38,81,.469,33,58,.569,5,23,.217,20,23,.870,101,35,88,.398,30,68,.441,5,20,.250,14,20,.700,89
602,DAL,2015-03-20,101,,MEM,L 101-112,240,34,76,.447,26,54,.481,8,22,.364,25,36,.694,101,41,77,.532,33,59,.559,8,18,.444,22,32,.688,112
603,SAC,2015-03-20,101,,CHO,W 101-91,240,37,78,.474,28,57,.491,9,21,.429,18,25,.720,101,36,91,.396,30,73,.411,6,18,.333,13,16,.813,91
604,CHO,2015-03-13,101,,CHI,W 101-91,240,33,89,.371,26,70,.371,7,19,.368,28,33,.848,101,31,82,.378,16,50,.320,15,32,.469,14,19,.737,91
605,DET,2015-03-08,101,,CHO,L 101-108,240,39,89,.438,36,75,.480,3,14,.214,20,25,.800,101,41,79,.519,35,62,.565,6,17,.353,20,23,.870,108
606,LAL,2015-03-01,101,,OKC,L 101-108,240,40,90,.444,31,65,.477,9,25,.360,12,18,.667,101,40,97,.412,29,65,.446,11,32,.344,17,23,.739,108
607,BOS,2015-03-01,101,,GSW,L 101-106,240,40,109,.367,32,78,.410,8,31,.258,13,17,.765,101,40,95,.421,28,61,.459,12,34,.353,14,17,.824,106
608,LAL,2015-02-27,101,,MIL,W 101-93,240,40,85,.471,34,67,.507,6,18,.333,15,22,.682,101,34,87,.391,30,70,.429,4,17,.235,21,29,.724,93
609,DET,2015-02-08,101,,MIN,L 101-112,240,37,79,.468,27,48,.563,10,31,.323,17,22,.773,101,39,76,.513,34,64,.531,5,12,.417,29,34,.853,112
610,HOU,2015-02-04,101,,CHI,W 101-90,240,38,92,.413,30,65,.462,8,27,.296,17,23,.739,101,31,89,.348,23,64,.359,8,25,.320,20,26,.769,90
611,PHO,2015-02-02,101,,MEM,L 101-102,240,42,84,.500,36,68,.529,6,16,.375,11,18,.611,101,36,83,.434,33,72,.458,3,11,.273,27,34,.794,102
612,CLE,2015-01-30,101,,SAC,W 101-90,240,38,80,.475,27,49,.551,11,31,.355,14,22,.636,101,30,84,.357,27,66,.409,3,18,.167,27,32,.844,90
613,SAS,2015-01-25,101,,MIL,W 101-95,240,35,83,.422,30,61,.492,5,22,.227,26,30,.867,101,39,82,.476,31,65,.477,8,17,.471,9,13,.692,95
614,MIL,2015-01-24,101,,DET,W 101-86,240,41,81,.506,30,64,.469,11,17,.647,8,10,.800,101,31,86,.360,25,61,.410,6,25,.240,18,25,.720,86
615,MEM,2015-01-24,101,,PHI,W 101-83,240,37,79,.468,31,65,.477,6,14,.429,21,25,.840,101,31,81,.383,22,57,.386,9,24,.375,12,22,.545,83
616,IND,2015-01-13,101,,MIN,L 101-110,240,39,80,.488,34,62,.548,5,18,.278,18,30,.600,101,41,87,.471,31,67,.463,10,20,.500,18,19,.947,110
617,WAS,2015-01-13,101,,SAS,W 101-93,240,37,75,.493,31,63,.492,6,12,.500,21,24,.875,101,38,96,.396,29,67,.433,9,29,.310,8,12,.667,93
618,LAL,2015-01-09,101,,ORL,W 101-84,240,36,90,.400,29,69,.420,7,21,.333,22,31,.710,101,30,76,.395,24,62,.387,6,14,.429,18,23,.783,84
619,WAS,2015-01-07,101,,NYK,W 101-91,240,39,76,.513,31,60,.517,8,16,.500,15,21,.714,101,34,82,.415,23,56,.411,11,26,.423,12,16,.750,91
620,UTA,2015-01-05,101,,IND,L 101-105,240,35,81,.432,31,58,.534,4,23,.174,27,34,.794,101,35,74,.473,28,61,.459,7,13,.538,28,30,.933,105
621,MIN,2015-01-05,101,,DEN,L 101-110,240,38,89,.427,28,65,.431,10,24,.417,15,18,.833,101,46,84,.548,39,65,.600,7,19,.368,11,16,.688,110
622,SAS,2015-01-03,101,,WAS,W 101-92,240,43,78,.551,39,62,.629,4,16,.250,11,18,.611,101,40,82,.488,36,68,.529,4,14,.286,8,13,.615,92
623,BOS,2015-01-02,101,,DAL,L 101-119,240,38,89,.427,26,55,.473,12,34,.353,13,19,.684,101,45,96,.469,32,69,.464,13,27,.481,16,17,.941,119
624,MIA,2014-12-29,101,,ORL,L 101-102,240,33,63,.524,26,49,.531,7,14,.500,28,40,.700,101,41,77,.532,30,52,.577,11,25,.440,9,13,.692,102
625,LAC,2014-12-29,101,,UTA,W 101-97,240,37,81,.457,27,58,.466,10,23,.435,17,22,.773,101,38,92,.413,30,73,.411,8,19,.421,13,22,.591,97
626,POR,2014-12-28,101,,NYK,W 101-79,240,38,81,.469,22,45,.489,16,36,.444,9,12,.750,101,31,93,.333,24,66,.364,7,27,.259,10,15,.667,79
627,WAS,2014-12-27,101,,BOS,W 101-88,240,45,90,.500,40,77,.519,5,13,.385,6,10,.600,101,32,79,.405,26,55,.473,6,24,.250,18,24,.750,88
628,MIA,2014-12-25,101,,CLE,W 101-91,240,40,84,.476,33,63,.524,7,21,.333,14,17,.824,101,32,72,.444,26,46,.565,6,26,.231,21,33,.636,91
629,MIL,2014-12-23,101,,CHO,L 101-108,240,39,82,.476,31,61,.508,8,21,.381,15,20,.750,101,36,82,.439,28,61,.459,8,21,.381,28,36,.778,108
630,SAC,2014-12-08,101,,UTA,W 101-92,240,35,74,.473,32,66,.485,3,8,.375,28,36,.778,101,32,79,.405,29,62,.468,3,17,.176,25,37,.676,92
631,BOS,2014-12-07,101,,WAS,W 101-93,240,36,88,.409,28,71,.394,8,17,.471,21,26,.808,101,34,93,.366,23,66,.348,11,27,.407,14,21,.667,93
632,DET,2014-12-06,101,,PHI,L 101-108 (OT),265,34,87,.391,28,64,.438,6,23,.261,27,35,.771,101,40,87,.460,33,64,.516,7,23,.304,21,30,.700,108
633,MEM,2014-12-05,101,,SAS,L 101-107,240,37,80,.463,32,68,.471,5,12,.417,22,26,.846,101,40,84,.476,26,59,.441,14,25,.560,13,16,.813,107
634,UTA,2014-12-01,101,,DEN,L 101-103,240,36,84,.429,29,66,.439,7,18,.389,22,30,.733,101,41,87,.471,32,61,.525,9,26,.346,12,17,.706,103
635,CHO,2014-11-28,101,,GSW,L 101-106,240,38,87,.437,32,68,.471,6,19,.316,19,23,.826,101,42,99,.424,35,73,.479,7,26,.269,15,16,.938,106
636,MIN,2014-11-22,101,,SAC,L 101-113,240,37,90,.411,31,73,.425,6,17,.353,21,27,.778,101,40,81,.494,32,55,.582,8,26,.308,25,30,.833,113
637,GSW,2014-11-21,101,,UTA,W 101-88,240,41,82,.500,35,59,.593,6,23,.261,13,19,.684,101,35,82,.427,29,65,.446,6,17,.353,12,19,.632,88
638,ORL,2014-11-14,101,,MIL,W 101-85,240,35,80,.438,25,56,.446,10,24,.417,21,27,.778,101,36,80,.450,34,61,.557,2,19,.105,11,14,.786,85
639,MIN,2014-11-12,101,,HOU,L 101-113,240,36,81,.444,30,69,.435,6,12,.500,23,30,.767,101,43,89,.483,30,61,.492,13,28,.464,14,19,.737,113
640,OKC,2014-11-09,101,,SAC,W 101-93,240,36,78,.462,30,60,.500,6,18,.333,23,27,.852,101,36,80,.450,30,56,.536,6,24,.250,15,22,.682,93
641,CHI,2014-11-08,101,,BOS,L 101-106,240,42,92,.457,34,74,.459,8,18,.444,9,15,.600,101,42,81,.519,35,62,.565,7,19,.368,15,20,.750,106
642,DEN,2014-11-07,101,,CLE,L 101-110,240,40,85,.471,29,56,.518,11,29,.379,10,15,.667,101,40,84,.476,34,61,.557,6,23,.261,24,33,.727,110
643,BOS,2014-11-07,101,,IND,W 101-98,240,39,85,.459,30,58,.517,9,27,.333,14,16,.875,101,40,88,.455,35,69,.507,5,19,.263,13,13,1.000,98
644,POR,2014-11-04,101,,CLE,W 101-82,240,37,75,.493,29,50,.580,8,25,.320,19,25,.760,101,31,85,.365,22,64,.344,9,21,.429,11,14,.786,82
645,SAS,2014-10-28,101,,DAL,W 101-100,240,37,70,.529,23,42,.548,14,28,.500,13,16,.813,101,38,78,.487,30,57,.526,8,21,.381,16,19,.842,100
646,NOP,2014-10-28,101,,ORL,W 101-84,240,41,101,.406,37,84,.440,4,17,.235,15,31,.484,101,32,84,.381,28,73,.384,4,11,.364,16,21,.762,84
647,MIL,2015-04-15,100,,BOS,L 100-105,240,41,89,.461,34,68,.500,7,21,.333,11,16,.688,100,42,85,.494,29,55,.527,13,30,.433,8,14,.571,105
648,MIA,2015-04-13,100,,ORL,W 100-93,240,39,83,.470,36,73,.493,3,10,.300,19,23,.826,100,35,85,.412,29,64,.453,6,21,.286,17,28,.607,93
649,MEM,2015-04-03,100,,OKC,W 100-92,240,38,80,.475,34,59,.576,4,21,.190,20,28,.714,100,36,88,.409,32,71,.451,4,17,.235,16,26,.615,92
650,BOS,2015-04-01,100,,IND,W 100-87,240,39,86,.453,33,59,.559,6,27,.222,16,18,.889,100,34,81,.420,28,66,.424,6,15,.400,13,23,.565,87
651,IND,2015-03-23,100,,HOU,L 100-110,240,40,90,.444,32,66,.485,8,24,.333,12,19,.632,100,31,65,.477,18,41,.439,13,24,.542,35,37,.946,110
652,ORL,2015-03-22,100,,DEN,L 100-119,240,41,85,.482,37,68,.544,4,17,.235,14,17,.824,100,42,90,.467,30,62,.484,12,28,.429,23,30,.767,119
653,DEN,2015-03-07,100,,HOU,L 100-114,240,38,92,.413,29,62,.468,9,30,.300,15,19,.789,100,40,86,.465,30,58,.517,10,28,.357,24,32,.750,114
654,BRK,2015-03-06,100,,PHO,L 100-108 (OT),265,34,97,.351,26,75,.347,8,22,.364,24,29,.828,100,39,91,.429,36,65,.554,3,26,.115,27,35,.771,108
655,MIA,2015-03-04,100,,LAL,W 100-94,240,32,79,.405,29,63,.460,3,16,.188,33,43,.767,100,38,88,.432,31,70,.443,7,18,.389,11,17,.647,94
656,HOU,2015-03-04,100,,MEM,L 100-102,240,42,86,.488,31,58,.534,11,28,.393,5,5,1.000,100,42,83,.506,38,67,.567,4,16,.250,14,17,.824,102
657,ORL,2015-03-04,100,,PHO,L 100-105,240,41,87,.471,36,67,.537,5,20,.250,13,15,.867,100,37,79,.468,29,58,.500,8,21,.381,23,27,.852,105
658,NOP,2015-02-23,100,,TOR,W 100-97,240,40,78,.513,30,56,.536,10,22,.455,10,16,.625,100,35,84,.417,30,61,.492,5,23,.217,22,31,.710,97
659,DET,2015-02-20,100,,CHI,W 100-91,240,38,84,.452,32,62,.516,6,22,.273,18,33,.545,100,33,78,.423,28,62,.452,5,16,.313,20,22,.909,91
660,PHO,2015-02-06,100,,UTA,W 100-93,240,38,84,.452,24,57,.421,14,27,.519,10,14,.714,100,37,80,.463,30,60,.500,7,20,.350,12,18,.667,93
661,DAL,2015-02-02,100,,MIN,W 100-94,240,39,84,.464,29,53,.547,10,31,.323,12,18,.667,100,34,82,.415,31,69,.449,3,13,.231,23,26,.885,94
662,ORL,2015-01-29,100,,MIL,L 100-115,240,37,82,.451,32,64,.500,5,18,.278,21,30,.700,100,45,87,.517,33,62,.532,12,25,.480,13,18,.722,115
663,NYK,2015-01-28,100,,OKC,W 100-92,240,40,91,.440,32,74,.432,8,17,.471,12,17,.706,100,34,85,.400,29,63,.460,5,22,.227,19,22,.864,92
664,PHO,2015-01-25,100,,LAC,L 100-120,240,34,80,.425,24,51,.471,10,29,.345,22,27,.815,100,43,87,.494,33,64,.516,10,23,.435,24,36,.667,120
665,SAC,2015-01-21,100,,BRK,L 100-103,240,39,84,.464,34,66,.515,5,18,.278,17,24,.708,100,37,79,.468,32,59,.542,5,20,.250,24,30,.800,103
666,TOR,2015-01-14,100,,PHI,W 100-84,240,38,82,.463,28,53,.528,10,29,.345,14,22,.636,100,31,80,.388,28,61,.459,3,19,.158,19,31,.613,84
667,SAS,2015-01-09,100,,PHO,W 100-95,240,38,89,.427,27,66,.409,11,23,.478,13,18,.722,100,37,83,.446,30,57,.526,7,26,.269,14,21,.667,95
668,UTA,2014-12-30,100,,MIN,W 100-94,240,38,79,.481,31,60,.517,7,19,.368,17,22,.773,100,38,82,.463,30,65,.462,8,17,.471,10,14,.714,94
669,LAC,2014-12-25,100,,GSW,W 100-86,240,34,87,.391,25,55,.455,9,32,.281,23,31,.742,100,34,80,.425,28,52,.538,6,28,.214,12,22,.545,86
670,ORL,2014-12-23,100,,BOS,W 100-95,240,39,83,.470,32,65,.492,7,18,.389,15,23,.652,100,33,85,.388,26,62,.419,7,23,.304,22,29,.759,95
671,MIA,2014-12-21,100,,BOS,W 100-84,240,37,78,.474,31,57,.544,6,21,.286,20,26,.769,100,33,83,.398,27,60,.450,6,23,.261,12,15,.800,84
672,DET,2014-12-19,100,,TOR,L 100-110,240,41,94,.436,33,69,.478,8,25,.320,10,15,.667,100,42,88,.477,34,61,.557,8,27,.296,18,24,.750,110
673,ORL,2014-12-13,100,,ATL,W 100-99,240,37,74,.500,27,53,.509,10,21,.476,16,21,.762,100,35,84,.417,27,57,.474,8,27,.296,21,24,.875,99
674,UTA,2014-12-09,100,,SAS,W 100-96,240,40,80,.500,36,66,.545,4,14,.286,16,22,.727,100,39,84,.464,35,64,.547,4,20,.200,14,23,.609,96
675,HOU,2014-12-06,100,,PHO,W 100-95,240,33,81,.407,22,54,.407,11,27,.407,23,31,.742,100,34,93,.366,27,65,.415,7,28,.250,20,26,.769,95
676,ATL,2014-11-28,100,,NOP,W 100-91,240,38,76,.500,33,59,.559,5,17,.294,19,22,.864,100,36,89,.404,29,65,.446,7,24,.292,12,16,.750,91
677,DAL,2014-11-24,100,,IND,L 100-111,240,40,80,.500,32,56,.571,8,24,.333,12,21,.571,100,37,77,.481,24,51,.471,13,26,.500,24,36,.667,111
678,MIL,2014-11-22,100,,WAS,L 100-111,240,36,84,.429,31,69,.449,5,15,.333,23,26,.885,100,43,93,.462,35,75,.467,8,18,.444,17,22,.773,111
679,CHO,2014-11-21,100,,ORL,L 100-105,240,42,91,.462,35,71,.493,7,20,.350,9,15,.600,100,39,82,.476,35,66,.530,4,16,.250,23,32,.719,105
680,SAC,2014-11-18,100,,NOP,L 100-106,240,38,86,.442,34,75,.453,4,11,.364,20,29,.690,100,39,79,.494,30,55,.545,9,24,.375,19,24,.792,106
681,SAS,2014-11-17,100,,PHI,W 100-75,240,36,81,.444,26,55,.473,10,26,.385,18,21,.857,100,27,83,.325,23,57,.404,4,26,.154,17,24,.708,75
682,NYK,2014-11-14,100,,UTA,L 100-102,240,39,82,.476,34,74,.459,5,8,.625,17,20,.850,100,36,70,.514,26,48,.542,10,22,.455,20,25,.800,102
683,ATL,2014-11-12,100,,UTA,W 100-97,240,39,76,.513,30,56,.536,9,20,.450,13,18,.722,100,43,86,.500,38,63,.603,5,23,.217,6,12,.500,97
684,GSW,2014-11-11,100,,SAS,L 100-113,240,38,70,.543,31,50,.620,7,20,.350,17,20,.850,100,46,93,.495,36,68,.529,10,25,.400,11,15,.733,113
685,NOP,2014-11-04,100,,CHO,W 100-91,240,38,81,.469,33,63,.524,5,18,.278,19,19,1.000,100,37,80,.463,31,59,.525,6,21,.286,11,13,.846,91
686,TOR,2014-11-04,100,,OKC,W 100-88,240,32,81,.395,24,50,.480,8,31,.258,28,33,.848,100,34,65,.523,28,44,.636,6,21,.286,14,25,.560,88
687,LAL,2015-04-15,99,,SAC,L 99-122,240,36,94,.383,29,70,.414,7,24,.292,20,25,.800,99,46,84,.548,38,67,.567,8,17,.471,22,41,.537,122
688,IND,2015-04-14,99,,WAS,W 99-95 (2OT),290,40,105,.381,31,75,.413,9,30,.300,10,17,.588,99,37,104,.356,30,80,.375,7,24,.292,14,17,.824,95
689,ORL,2015-04-10,99,,TOR,L 99-101,240,41,89,.461,34,69,.493,7,20,.350,10,10,1.000,99,39,94,.415,30,64,.469,9,30,.300,14,15,.933,101
690,MIL,2015-04-08,99,,CLE,L 99-104,240,42,84,.500,36,66,.545,6,18,.333,9,13,.692,99,36,74,.486,25,40,.625,11,34,.324,21,26,.808,104
691,CLE,2015-04-05,99,,CHI,W 99-94,240,35,83,.422,19,46,.413,16,37,.432,13,22,.591,99,34,76,.447,23,49,.469,11,27,.407,15,21,.714,94
692,DET,2015-04-04,99,,MIA,W 99-98,240,36,73,.493,24,47,.511,12,26,.462,15,23,.652,99,37,77,.481,32,57,.561,5,20,.250,19,26,.731,98
693,POR,2015-04-04,99,,NOP,W 99-90,240,36,84,.429,30,68,.441,6,16,.375,21,23,.913,99,39,85,.459,32,69,.464,7,16,.438,5,10,.500,90
694,MIN,2015-04-01,99,,TOR,L 99-113,240,41,77,.532,36,63,.571,5,14,.357,12,19,.632,99,42,76,.553,29,46,.630,13,30,.433,16,23,.696,113
695,TOR,2015-03-30,99,,HOU,W 99-96,240,35,78,.449,27,56,.482,8,22,.364,21,27,.778,99,35,84,.417,27,57,.474,8,27,.296,18,31,.581,96
696,ATL,2015-03-27,99,,MIA,W 99-86,240,37,72,.514,31,54,.574,6,18,.333,19,24,.792,99,32,82,.390,21,47,.447,11,35,.314,11,15,.733,86
697,MIN,2015-03-25,99,,LAL,L 99-101 (OT),265,33,78,.423,27,56,.482,6,22,.273,27,30,.900,99,39,92,.424,33,66,.500,6,26,.231,17,18,.944,101
698,PHO,2015-03-25,99,,SAC,L 99-108,240,38,87,.437,32,62,.516,6,25,.240,17,26,.654,99,40,81,.494,32,60,.533,8,21,.381,20,23,.870,108
699,LAC,2015-03-17,99,,CHO,W 99-92,240,35,77,.455,26,53,.491,9,24,.375,20,28,.714,99,32,79,.405,27,65,.415,5,14,.357,23,29,.793,92
700,WAS,2015-03-06,99,,MIA,W 99-97,240,38,82,.463,31,59,.525,7,23,.304,16,18,.889,99,37,79,.468,27,52,.519,10,27,.370,13,19,.684,97
701,SAC,2015-03-01,99,,POR,L 99-110,240,39,86,.453,36,74,.486,3,12,.250,18,23,.783,99,41,83,.494,31,59,.525,10,24,.417,18,20,.900,110
702,WAS,2015-02-28,99,,DET,W 99-95,240,37,78,.474,30,58,.517,7,20,.350,18,25,.720,99,38,79,.481,30,53,.566,8,26,.308,11,21,.524,95
703,DAL,2015-02-24,99,,TOR,W 99-92,240,38,79,.481,30,60,.500,8,19,.421,15,18,.833,99,38,84,.452,29,58,.500,9,26,.346,7,11,.636,92
704,PHO,2015-01-30,99,,CHI,W 99-93,240,39,90,.433,33,68,.485,6,22,.273,15,17,.882,99,36,87,.414,32,69,.464,4,18,.222,17,27,.630,93
705,MEM,2015-01-29,99,,DEN,W 99-69,240,39,88,.443,36,72,.500,3,16,.188,18,27,.667,99,29,87,.333,27,61,.443,2,26,.077,9,10,.900,69
706,HOU,2015-01-28,99,,DAL,W 99-94,240,36,88,.409,22,53,.415,14,35,.400,13,15,.867,99,35,82,.427,25,57,.439,10,25,.400,14,16,.875,94
707,CLE,2015-01-28,99,,POR,W 99-94,240,34,85,.400,19,48,.396,15,37,.405,16,18,.889,99,35,80,.438,25,49,.510,10,31,.323,14,17,.824,94
708,NOP,2015-01-26,99,,PHI,W 99-74,240,39,86,.453,32,70,.457,7,16,.438,14,19,.737,99,28,81,.346,26,66,.394,2,15,.133,16,21,.762,74
709,ORL,2015-01-25,99,,IND,L 99-106,240,38,78,.487,32,61,.525,6,17,.353,17,23,.739,99,43,83,.518,35,63,.556,8,20,.400,12,18,.667,106
710,DEN,2015-01-23,99,,BOS,L 99-100,240,37,89,.416,31,68,.456,6,21,.286,19,26,.731,99,37,75,.493,28,54,.519,9,21,.429,17,27,.630,100
711,SAS,2015-01-23,99,,LAL,W 99-85,240,36,84,.429,29,60,.483,7,24,.292,20,27,.741,99,33,83,.398,28,70,.400,5,13,.385,14,20,.700,85
712,MIL,2015-01-22,99,,UTA,L 99-101,240,42,92,.457,37,79,.468,5,13,.385,10,12,.833,99,32,71,.451,18,40,.450,14,31,.452,23,28,.821,101
713,DEN,2015-01-20,99,,SAS,L 99-109,240,37,79,.468,32,65,.492,5,14,.357,20,29,.690,99,38,84,.452,27,57,.474,11,27,.407,22,27,.815,109
714,NYK,2015-01-19,99,,NOP,W 99-92,240,38,78,.487,28,55,.509,10,23,.435,13,17,.765,99,35,84,.417,27,57,.474,8,27,.296,14,20,.700,92
715,ORL,2015-01-18,99,,OKC,L 99-127,240,35,88,.398,27,65,.415,8,23,.348,21,27,.778,99,48,83,.578,39,58,.672,9,25,.360,22,32,.688,127
716,CHI,2015-01-17,99,,ATL,L 99-107,240,37,80,.463,28,54,.519,9,26,.346,16,20,.800,99,40,84,.476,29,58,.500,11,26,.423,16,21,.762,107
717,CHI,2015-01-14,99,,WAS,L 99-105,240,34,79,.430,21,52,.404,13,27,.481,18,24,.750,99,40,78,.513,35,63,.556,5,15,.333,20,25,.800,105
718,BRK,2015-01-12,99,,HOU,L 99-113,240,39,84,.464,34,63,.540,5,21,.238,16,18,.889,99,41,86,.477,25,46,.543,16,40,.400,15,20,.750,113
719,OKC,2015-01-09,99,,UTA,W 99-94,240,42,91,.462,35,70,.500,7,21,.333,8,9,.889,99,36,74,.486,29,53,.547,7,21,.333,15,22,.682,94
720,POR,2015-01-08,99,,MIA,W 99-83,240,40,95,.421,32,68,.471,8,27,.296,11,15,.733,99,29,77,.377,26,63,.413,3,14,.214,22,30,.733,83
721,LAC,2014-12-31,99,,NYK,W 99-78,240,36,82,.439,21,48,.438,15,34,.441,12,20,.600,99,32,84,.381,28,67,.418,4,17,.235,10,15,.667,78
722,OKC,2014-12-21,99,,NOP,L 99-101,240,38,83,.458,33,63,.524,5,20,.250,18,24,.750,99,43,90,.478,36,70,.514,7,20,.350,8,10,.800,101
723,DAL,2014-12-20,99,,SAS,W 99-93,240,37,86,.430,28,60,.467,9,26,.346,16,20,.800,99,32,77,.416,29,64,.453,3,13,.231,26,26,1.000,93
724,NYK,2014-12-07,99,,POR,L 99-103,240,41,79,.519,36,60,.600,5,19,.263,12,14,.857,99,36,85,.424,26,57,.456,10,28,.357,21,29,.724,103
725,POR,2014-11-28,99,,MEM,L 99-112,240,39,97,.402,31,69,.449,8,28,.286,13,18,.722,99,45,84,.536,39,71,.549,6,13,.462,16,26,.615,112
726,SAS,2014-11-22,99,,BRK,W 99-87,240,41,79,.519,33,58,.569,8,21,.381,9,11,.818,99,34,91,.374,25,64,.391,9,27,.333,10,10,1.000,87
727,ATL,2014-11-21,99,,DET,W 99-89,240,38,80,.475,33,56,.589,5,24,.208,18,26,.692,99,31,83,.373,27,62,.435,4,21,.190,23,24,.958,89
728,SAS,2014-11-08,99,,NOP,L 99-100,240,36,80,.450,31,62,.500,5,18,.278,22,29,.759,99,40,85,.471,32,64,.500,8,21,.381,12,14,.857,100
729,UTA,2015-04-01,98,,DEN,W 98-84,240,37,77,.481,28,54,.519,9,23,.391,15,24,.625,98,33,95,.347,26,62,.419,7,33,.212,11,12,.917,84
730,NYK,2015-04-01,98,,BRK,L 98-100,240,37,81,.457,26,58,.448,11,23,.478,13,15,.867,98,41,81,.506,32,65,.492,9,16,.563,9,12,.750,100
731,PHI,2015-03-27,98,,LAC,L 98-119,240,36,86,.419,25,55,.455,11,31,.355,15,27,.556,98,44,82,.537,32,53,.604,12,29,.414,19,31,.613,119
732,CHI,2015-03-23,98,,CHO,W 98-86,240,37,82,.451,34,66,.515,3,16,.188,21,29,.724,98,28,81,.346,20,61,.328,8,20,.400,22,28,.786,86
733,MIN,2015-03-22,98,,CHO,L 98-109,240,41,74,.554,37,63,.587,4,11,.364,12,16,.750,98,45,89,.506,39,71,.549,6,18,.333,13,16,.813,109
734,PHO,2015-03-22,98,,DAL,W 98-92,240,39,76,.513,33,55,.600,6,21,.286,14,23,.609,98,37,96,.385,32,77,.416,5,19,.263,13,22,.591,92
735,IND,2015-03-16,98,,TOR,L 98-117,240,38,88,.432,36,69,.522,2,19,.105,20,25,.800,98,39,82,.476,27,59,.458,12,23,.522,27,33,.818,117
736,LAC,2015-03-15,98,,HOU,L 98-100,240,36,82,.439,24,56,.429,12,26,.462,14,24,.583,98,32,86,.372,25,56,.446,7,30,.233,29,36,.806,100
737,IND,2015-03-06,98,,CHI,W 98-84,240,34,80,.425,28,60,.467,6,20,.300,24,33,.727,98,31,86,.360,26,63,.413,5,23,.217,17,19,.895,84
738,NOP,2015-03-06,98,,BOS,L 98-104,240,38,80,.475,30,59,.508,8,21,.381,14,15,.933,98,36,79,.456,26,56,.464,10,23,.435,22,25,.880,104
739,HOU,2015-02-21,98,,TOR,W 98-76,240,35,84,.417,29,55,.527,6,29,.207,22,31,.710,98,25,77,.325,21,59,.356,4,18,.222,22,28,.786,76
740,DAL,2015-02-09,98,,LAC,L 98-115,240,33,81,.407,23,47,.489,10,34,.294,22,30,.733,98,41,92,.446,32,65,.492,9,27,.333,24,29,.828,115
741,HOU,2015-02-08,98,,POR,L 98-109,240,31,82,.378,18,47,.383,13,35,.371,23,34,.676,98,40,76,.526,31,47,.660,9,29,.310,20,23,.870,109
742,DET,2015-02-06,98,,DEN,W 98-88,240,37,82,.451,33,58,.569,4,24,.167,20,26,.769,98,33,85,.388,28,63,.444,5,22,.227,17,22,.773,88
743,SAS,2015-02-06,98,,MIA,W 98-85,240,40,83,.482,29,54,.537,11,29,.379,7,9,.778,98,36,80,.450,31,64,.484,5,16,.313,8,9,.889,85
744,DAL,2015-01-23,98,,CHI,L 98-102,240,37,82,.451,31,64,.484,6,18,.333,18,18,1.000,98,38,78,.487,29,62,.468,9,16,.563,17,20,.850,102
745,POR,2015-01-19,98,,SAC,W 98-94,240,35,88,.398,24,52,.462,11,36,.306,17,26,.654,98,34,76,.447,30,64,.469,4,12,.333,22,30,.733,94
746,DET,2015-01-10,98,,BRK,W 98-93,240,34,80,.425,23,47,.489,11,33,.333,19,26,.731,98,37,88,.420,28,57,.491,9,31,.290,10,10,1.000,93
747,MIL,2015-01-09,98,,MIN,W 98-84,240,39,75,.520,27,56,.482,12,19,.632,8,10,.800,98,32,79,.405,26,57,.456,6,22,.273,14,17,.824,84
748,CHO,2015-01-07,98,,NOP,W 98-94,240,37,86,.430,33,72,.458,4,14,.286,20,26,.769,98,36,80,.450,30,62,.484,6,18,.333,16,24,.667,94
749,LAC,2015-01-05,98,,ATL,L 98-107,240,33,74,.446,26,49,.531,7,25,.280,25,33,.758,98,36,81,.444,23,54,.426,13,27,.481,22,33,.667,107
750,POR,2015-01-05,98,,LAL,W 98-94,240,33,83,.398,22,57,.386,11,26,.423,21,24,.875,98,37,88,.420,33,74,.446,4,14,.286,16,20,.800,94
751,ORL,2015-01-02,98,,BRK,L 98-100,240,37,88,.420,26,66,.394,11,22,.500,13,20,.650,98,41,72,.569,34,52,.654,7,20,.350,11,18,.611,100
752,LAC,2014-12-27,98,,TOR,L 98-110,240,37,81,.457,25,56,.446,12,25,.480,12,15,.800,98,41,86,.477,28,52,.538,13,34,.382,15,19,.789,110
753,OKC,2014-12-26,98,,CHO,W 98-75,240,36,88,.409,28,61,.459,8,27,.296,18,21,.857,98,25,87,.287,20,63,.317,5,24,.208,20,26,.769,75
754,CLE,2014-12-17,98,,ATL,L 98-127,240,37,82,.451,29,52,.558,8,30,.267,16,21,.762,98,49,76,.645,33,48,.688,16,28,.571,13,16,.813,127
755,DAL,2014-12-13,98,,GSW,L 98-105,240,36,89,.404,31,64,.484,5,25,.200,21,30,.700,98,37,83,.446,27,51,.529,10,32,.313,21,27,.778,105
756,LAL,2014-12-09,98,,SAC,W 98-95,240,38,96,.396,33,71,.465,5,25,.200,17,25,.680,98,32,70,.457,25,55,.455,7,15,.467,24,37,.649,95
757,GSW,2014-12-02,98,,ORL,W 98-97,240,38,82,.463,30,55,.545,8,27,.296,14,18,.778,98,39,87,.448,33,70,.471,6,17,.353,13,14,.929,97
758,IND,2014-11-28,98,,ORL,W 98-83,240,41,94,.436,37,78,.474,4,16,.250,12,14,.857,98,31,70,.443,24,52,.462,7,18,.389,14,16,.875,83
759,DET,2014-11-26,98,,LAC,L 98-104,240,35,78,.449,25,51,.490,10,27,.370,18,24,.750,98,37,78,.474,25,50,.500,12,28,.429,18,19,.947,104
760,MIL,2014-11-25,98,,DET,W 98-86,240,39,90,.433,29,68,.426,10,22,.455,10,13,.769,98,36,78,.462,29,58,.500,7,20,.350,7,17,.412,86
761,UTA,2014-11-18,98,,OKC,W 98-81,240,35,81,.432,25,57,.439,10,24,.417,18,26,.692,98,30,84,.357,22,61,.361,8,23,.348,13,19,.684,81
762,WAS,2014-11-15,98,,ORL,W 98-93,240,42,84,.500,39,74,.527,3,10,.300,11,16,.688,98,37,78,.474,30,61,.492,7,17,.412,12,18,.667,93
763,DET,2014-11-07,98,,MIL,W 98-95,240,37,75,.493,26,52,.500,11,23,.478,13,24,.542,98,36,77,.468,31,57,.544,5,20,.250,18,23,.783,95
764,HOU,2014-11-06,98,,SAS,W 98-81,240,34,72,.472,24,45,.533,10,27,.370,20,33,.606,98,31,90,.344,29,70,.414,2,20,.100,17,19,.895,81
765,DET,2014-11-05,98,,NYK,W 98-95,240,32,87,.368,21,64,.328,11,23,.478,23,33,.697,98,39,90,.433,30,70,.429,9,20,.450,8,10,.800,95
766,CHI,2014-11-04,98,,ORL,W 98-90,240,35,75,.467,28,60,.467,7,15,.467,21,27,.778,98,38,88,.432,32,74,.432,6,14,.429,8,14,.571,90
767,ORL,2014-10-30,98,,WAS,L 98-105,240,37,72,.514,31,57,.544,6,15,.400,18,24,.750,98,39,80,.488,32,67,.478,7,13,.538,20,26,.769,105
768,PHI,2015-04-13,97,,MIL,L 97-107,240,32,81,.395,26,53,.491,6,28,.214,27,34,.794,97,40,81,.494,36,72,.500,4,9,.444,23,36,.639,107
769,MEM,2015-03-30,97,,SAC,W 97-83,240,38,83,.458,30,60,.500,8,23,.348,13,17,.765,97,33,81,.407,28,65,.431,5,16,.313,12,20,.600,83
770,PHO,2015-03-29,97,,OKC,L 97-109,240,37,82,.451,32,60,.533,5,22,.227,18,24,.750,97,40,86,.465,30,60,.500,10,26,.385,19,26,.731,109
771,ORL,2015-03-27,97,,DET,L 97-111,240,43,82,.524,40,67,.597,3,15,.200,8,8,1.000,97,42,90,.467,35,72,.486,7,18,.389,20,27,.741,111
772,BOS,2015-03-22,97,,DET,L 97-105 (OT),265,38,105,.362,30,78,.385,8,27,.296,13,17,.765,97,39,89,.438,30,63,.476,9,26,.346,18,30,.600,105
773,MEM,2015-03-21,97,,POR,W 97-86,240,37,89,.416,26,71,.366,11,18,.611,12,16,.750,97,33,76,.434,27,54,.500,6,22,.273,14,15,.933,86
774,PHI,2015-03-20,97,,NYK,W 97-81,240,37,88,.420,26,58,.448,11,30,.367,12,15,.800,97,25,69,.362,17,53,.321,8,16,.500,23,26,.885,81
775,TOR,2015-03-15,97,,POR,L 97-113,240,37,78,.474,32,60,.533,5,18,.278,18,23,.783,97,45,86,.523,32,57,.561,13,29,.448,10,16,.625,113
776,MIL,2015-03-11,97,,ORL,W 97-91,240,39,79,.494,31,61,.508,8,18,.444,11,16,.688,97,34,85,.400,24,67,.358,10,18,.556,13,13,1.000,91
777,MEM,2015-03-06,97,,LAL,W 97-90,240,34,77,.442,33,66,.500,1,11,.091,28,33,.848,97,39,84,.464,34,72,.472,5,12,.417,7,9,.778,90
778,CHI,2015-03-03,97,,WAS,W 97-92,240,33,78,.423,24,49,.490,9,29,.310,22,30,.733,97,35,84,.417,27,62,.435,8,22,.364,14,19,.737,92
779,MIN,2015-02-28,97,,MEM,L 97-101,240,34,88,.386,27,69,.391,7,19,.368,22,27,.815,97,38,64,.594,34,53,.642,4,11,.364,21,29,.724,101
780,UTA,2015-02-25,97,,LAL,L 97-100,240,34,73,.466,27,61,.443,7,12,.583,22,34,.647,97,40,89,.449,38,78,.487,2,11,.182,18,21,.857,100
781,MIN,2015-02-25,97,,WAS,W 97-77,240,35,81,.432,31,68,.456,4,13,.308,23,28,.821,97,33,87,.379,29,69,.420,4,18,.222,7,8,.875,77
782,ORL,2015-02-08,97,,CHI,L 97-98,240,39,83,.470,30,58,.517,9,25,.360,10,13,.769,97,37,77,.481,29,55,.527,8,22,.364,16,18,.889,98
783,NYK,2015-02-03,97,,BOS,L 97-108,240,41,83,.494,34,63,.540,7,20,.350,8,11,.727,97,42,77,.545,36,53,.679,6,24,.250,18,23,.783,108
784,CLE,2015-02-02,97,,PHI,W 97-84,240,35,78,.449,23,51,.451,12,27,.444,15,22,.682,97,31,78,.397,19,45,.422,12,33,.364,10,14,.714,84
785,DAL,2015-01-16,97,,DEN,W 97-89,240,33,79,.418,25,54,.463,8,25,.320,23,29,.793,97,34,83,.410,25,58,.431,9,25,.360,12,25,.480,89
786,HOU,2015-01-10,97,,UTA,W 97-82,240,33,77,.429,20,43,.465,13,34,.382,18,21,.857,97,29,70,.414,24,53,.453,5,17,.294,19,21,.905,82
787,NOP,2014-12-26,97,,SAS,W 97-90,240,35,84,.417,29,67,.433,6,17,.353,21,24,.875,97,37,75,.493,31,61,.508,6,14,.429,10,14,.714,90
788,HOU,2014-12-20,97,,ATL,L 97-104,240,34,86,.395,19,43,.442,15,43,.349,14,18,.778,97,38,74,.514,28,48,.583,10,26,.385,18,24,.750,104
789,MEM,2014-12-19,97,,CHI,L 97-103,240,37,94,.394,35,81,.432,2,13,.154,21,24,.875,97,32,73,.438,22,47,.468,10,26,.385,29,33,.879,103
790,CLE,2014-12-15,97,,CHO,W 97-88,240,38,83,.458,29,59,.492,9,24,.375,12,17,.706,97,38,83,.458,33,67,.493,5,16,.313,7,14,.500,88
791,PHO,2014-12-09,97,,MIA,L 97-103,240,37,77,.481,20,42,.476,17,35,.486,6,9,.667,97,43,80,.538,34,63,.540,9,17,.529,8,12,.667,103
792,OKC,2014-11-26,97,,UTA,W 97-82,240,40,83,.482,28,57,.491,12,26,.462,5,10,.500,97,31,70,.443,28,54,.519,3,16,.188,17,28,.607,82
793,CHO,2014-11-26,97,,POR,L 97-105,240,41,94,.436,36,79,.456,5,15,.333,10,15,.667,97,39,92,.424,27,65,.415,12,27,.444,15,20,.750,105
794,MIA,2014-11-25,97,,GSW,L 97-114,240,33,85,.388,23,62,.371,10,23,.435,21,27,.778,97,43,75,.573,30,47,.638,13,28,.464,15,23,.652,114
795,CLE,2014-11-17,97,,DEN,L 97-106,240,34,79,.430,24,50,.480,10,29,.345,19,23,.826,97,41,85,.482,29,54,.537,12,31,.387,12,15,.800,106
796,POR,2014-11-15,97,,BRK,W 97-87,240,33,78,.423,22,52,.423,11,26,.423,20,27,.741,97,35,89,.393,34,70,.486,1,19,.053,16,17,.941,87
797,IND,2014-11-10,97,,UTA,W 97-86,240,39,90,.433,33,75,.440,6,15,.400,13,15,.867,97,32,74,.432,26,53,.491,6,21,.286,16,21,.762,86
798,MIN,2014-10-30,97,,DET,W 97-91,240,37,76,.487,33,66,.500,4,10,.400,19,28,.679,97,38,91,.418,31,70,.443,7,21,.333,8,13,.615,91
799,MIL,2015-04-12,96,,BRK,W 96-73,240,41,83,.494,35,63,.556,6,20,.300,8,12,.667,96,27,83,.325,24,65,.369,3,18,.167,16,22,.727,73
800,ATL,2015-04-07,96,,PHO,W 96-69,240,41,83,.494,37,58,.638,4,25,.160,10,14,.714,96,26,83,.313,22,63,.349,4,20,.200,13,18,.722,69
801,MEM,2015-03-14,96,,MIL,W 96-83,240,37,78,.474,29,64,.453,8,14,.571,14,16,.875,96,30,72,.417,25,53,.472,5,19,.263,18,27,.667,83
802,CHI,2015-02-27,96,,MIN,W 96-89,240,37,96,.385,28,65,.431,9,31,.290,13,16,.813,96,33,77,.429,31,63,.492,2,14,.143,21,31,.677,89
803,SAC,2015-02-27,96,,SAS,L 96-107,240,38,79,.481,37,75,.493,1,4,.250,19,23,.826,96,35,88,.398,27,65,.415,8,23,.348,29,32,.906,107
804,DEN,2015-02-25,96,,PHO,L 96-110,240,31,81,.383,19,47,.404,12,34,.353,22,33,.667,96,39,91,.429,31,67,.463,8,24,.333,24,32,.750,110
805,LAL,2015-02-10,96,,DEN,L 96-106,240,37,85,.435,31,67,.463,6,18,.333,16,27,.593,96,43,79,.544,39,63,.619,4,16,.250,16,23,.696,106
806,NOP,2015-02-09,96,,UTA,L 96-100,240,33,79,.418,20,57,.351,13,22,.591,17,20,.850,96,39,93,.419,30,72,.417,9,21,.429,13,19,.684,100
807,WAS,2015-02-09,96,,ORL,W 96-80,240,33,77,.429,26,52,.500,7,25,.280,23,27,.852,96,33,83,.398,29,61,.475,4,22,.182,10,15,.667,80
808,MIL,2015-02-07,96,,BOS,W 96-93,240,37,75,.493,29,55,.527,8,20,.400,14,19,.737,96,36,86,.419,29,57,.509,7,29,.241,14,20,.700,93
809,SAC,2015-02-03,96,,GSW,L 96-121,240,35,79,.443,28,63,.444,7,16,.438,19,24,.792,96,46,91,.505,36,68,.529,10,23,.435,19,26,.731,121
810,NOP,2015-01-21,96,,LAL,W 96-80,240,38,83,.458,35,67,.522,3,16,.188,17,21,.810,96,28,77,.364,22,57,.386,6,20,.300,18,21,.857,80
811,IND,2015-01-16,96,,DET,L 96-98,240,40,89,.449,34,71,.479,6,18,.333,10,12,.833,96,32,85,.376,19,54,.352,13,31,.419,21,24,.875,98
812,PHI,2015-01-16,96,,NOP,W 96-81,240,36,80,.450,29,58,.500,7,22,.318,17,27,.630,96,29,75,.387,25,58,.431,4,17,.235,19,29,.655,81
813,ORL,2015-01-16,96,,MEM,L 96-106,240,36,79,.456,27,55,.491,9,24,.375,15,20,.750,96,40,87,.460,37,73,.507,3,14,.214,23,29,.793,106
814,NYK,2015-01-08,96,,HOU,L 96-120,240,37,80,.463,26,54,.481,11,26,.423,11,21,.524,96,41,77,.532,25,41,.610,16,36,.444,22,32,.688,120
815,ATL,2015-01-07,96,,MEM,W 96-86,240,32,72,.444,19,47,.404,13,25,.520,19,23,.826,96,35,79,.443,30,62,.484,5,17,.294,11,11,1.000,86
816,MIL,2015-01-06,96,,PHO,L 96-102,240,37,88,.420,34,68,.500,3,20,.150,19,22,.864,96,37,81,.457,30,56,.536,7,25,.280,21,27,.778,102
817,IND,2014-12-23,96,,NOP,W 96-84,240,39,78,.500,34,63,.540,5,15,.333,13,18,.722,96,33,83,.398,29,63,.460,4,20,.200,14,19,.737,84
818,MIN,2014-12-21,96,,IND,L 96-100,240,36,77,.468,31,66,.470,5,11,.455,19,24,.792,96,42,84,.500,36,65,.554,6,19,.316,10,14,.714,100
819,IND,2014-12-10,96,,LAC,L 96-103,240,35,89,.393,26,62,.419,9,27,.333,17,22,.773,96,42,88,.477,35,64,.547,7,24,.292,12,14,.857,103
820,CHO,2014-12-10,96,,BOS,W 96-87,240,35,84,.417,32,70,.457,3,14,.214,23,29,.793,96,38,87,.437,33,64,.516,5,23,.217,6,10,.600,87
821,ATL,2014-12-07,96,,DEN,W 96-84,240,36,87,.414,26,60,.433,10,27,.370,14,19,.737,96,34,93,.366,28,58,.483,6,35,.171,10,13,.769,84
822,SAC,2014-12-06,96,,ORL,L 96-105,240,35,79,.443,31,64,.484,4,15,.267,22,28,.786,96,42,83,.506,33,57,.579,9,26,.346,12,14,.857,105
823,DET,2014-12-02,96,,LAL,L 96-106,240,33,90,.367,27,69,.391,6,21,.286,24,31,.774,96,39,81,.481,29,64,.453,10,17,.588,18,24,.750,106
824,UTA,2014-11-29,96,,LAC,L 96-112,240,34,75,.453,27,54,.500,7,21,.333,21,33,.636,96,45,80,.563,34,52,.654,11,28,.393,11,15,.733,112
825,ORL,2014-11-26,96,,GSW,L 96-111,240,36,87,.414,30,67,.448,6,20,.300,18,24,.750,96,44,85,.518,32,59,.542,12,26,.462,11,19,.579,111
826,PHI,2014-11-21,96,,PHO,L 96-122,240,36,78,.462,32,55,.582,4,23,.174,20,33,.606,96,44,86,.512,31,55,.564,13,31,.419,21,23,.913,122
827,TOR,2014-11-19,96,,MEM,W 96-92,240,38,83,.458,29,57,.509,9,26,.346,11,13,.846,96,35,80,.438,32,70,.457,3,10,.300,19,26,.731,92
828,DET,2014-11-09,96,,UTA,L 96-97,240,36,93,.387,30,70,.429,6,23,.261,18,25,.720,96,33,72,.458,27,57,.474,6,15,.400,25,35,.714,97
829,DAL,2014-11-09,96,,MIA,L 96-105,240,35,83,.422,26,54,.481,9,29,.310,17,24,.708,96,42,76,.553,33,53,.623,9,23,.391,12,20,.600,105
830,WAS,2014-11-05,96,,IND,W 96-94 (OT),265,34,91,.374,27,74,.365,7,17,.412,21,23,.913,96,35,90,.389,27,63,.429,8,27,.296,16,20,.800,94
831,CHO,2014-11-05,96,,MIA,W 96-89,240,35,82,.427,30,64,.469,5,18,.278,21,29,.724,96,30,77,.390,26,55,.473,4,22,.182,25,31,.806,89
832,NYK,2014-11-02,96,,CHO,W 96-93,240,39,78,.500,31,62,.500,8,16,.500,10,17,.588,96,33,70,.471,27,55,.491,6,15,.400,21,29,.724,93
833,PHI,2014-11-01,96,,MIA,L 96-114,240,35,67,.522,28,44,.636,7,23,.304,19,26,.731,96,41,83,.494,29,59,.492,12,24,.500,20,29,.690,114
834,MEM,2015-04-15,95,,IND,W 95-83,240,36,76,.474,34,67,.507,2,9,.222,21,26,.808,95,32,78,.410,24,54,.444,8,24,.333,11,15,.733,83
835,BOS,2015-04-14,95,,TOR,W 95-93,240,38,99,.384,32,72,.444,6,27,.222,13,15,.867,95,35,80,.438,26,56,.464,9,24,.375,14,20,.700,93
836,SAC,2015-04-05,95,,UTA,L 95-101,240,38,79,.481,33,64,.516,5,15,.333,14,24,.583,95,40,87,.460,32,63,.508,8,24,.333,13,18,.722,101
837,SAC,2015-04-03,95,,NOP,L 95-101,240,37,78,.474,31,61,.508,6,17,.353,15,25,.600,95,34,87,.391,20,58,.345,14,29,.483,19,28,.679,101
838,MIL,2015-04-01,95,,CHI,W 95-91,240,37,89,.416,29,68,.426,8,21,.381,13,18,.722,95,31,74,.419,26,48,.542,5,26,.192,24,37,.649,91
839,MIL,2015-03-28,95,,GSW,L 95-108,240,33,87,.379,31,72,.431,2,15,.133,27,32,.844,95,42,82,.512,30,57,.526,12,25,.480,12,14,.857,108
840,ATL,2015-03-22,95,,SAS,L 95-114,240,38,80,.475,26,56,.464,12,24,.500,7,7,1.000,95,46,82,.561,39,65,.600,7,17,.412,15,17,.882,114
841,CLE,2015-03-20,95,,IND,W 95-92,240,35,82,.427,26,56,.464,9,26,.346,16,21,.762,95,36,84,.429,28,64,.438,8,20,.400,12,13,.923,92
842,BOS,2015-03-13,95,,ORL,W 95-88,240,37,86,.430,27,60,.450,10,26,.385,11,20,.550,95,34,80,.425,28,60,.467,6,20,.300,14,28,.500,88
843,PHI,2015-03-11,95,,CHI,L 95-104 (OT),265,36,104,.346,25,63,.397,11,41,.268,12,25,.480,95,40,87,.460,30,63,.476,10,24,.417,14,20,.700,104
844,BOS,2015-03-11,95,,MEM,W 95-92,240,37,85,.435,29,58,.500,8,27,.296,13,17,.765,95,37,78,.474,32,66,.485,5,12,.417,13,13,1.000,92
845,NOP,2015-03-07,95,,MEM,W 95-89,240,38,80,.475,30,57,.526,8,23,.348,11,13,.846,95,32,74,.432,26,58,.448,6,16,.375,19,29,.655,89
846,ATL,2015-02-27,95,,ORL,W 95-88,240,36,81,.444,22,50,.440,14,31,.452,9,12,.750,95,36,80,.450,27,54,.500,9,26,.346,7,13,.538,88
847,PHI,2015-02-20,95,,IND,L 95-106,240,34,84,.405,26,59,.441,8,25,.320,19,29,.655,95,40,83,.482,32,61,.525,8,22,.364,18,22,.818,106
848,ORL,2015-02-20,95,,NOP,W 95-84,240,44,88,.500,40,70,.571,4,18,.222,3,6,.500,95,29,69,.420,24,50,.480,5,19,.263,21,28,.750,84
849,TOR,2015-02-11,95,,WAS,W 95-93,240,31,76,.408,20,50,.400,11,26,.423,22,26,.846,95,39,85,.459,34,64,.531,5,21,.238,10,16,.625,93
850,MEM,2015-02-10,95,,BRK,W 95-86,240,36,81,.444,30,62,.484,6,19,.316,17,25,.680,95,35,81,.432,32,69,.464,3,12,.250,13,17,.765,86
851,MIL,2015-01-31,95,,POR,W 95-88,240,37,82,.451,29,61,.475,8,21,.381,13,14,.929,95,33,89,.371,24,58,.414,9,31,.290,13,18,.722,88
852,SAS,2015-01-28,95,,CHO,W 95-86,240,35,83,.422,25,54,.463,10,29,.345,15,18,.833,95,34,83,.410,28,65,.431,6,18,.333,12,14,.857,86
853,DET,2015-01-27,95,,CLE,L 95-103,240,35,83,.422,27,59,.458,8,24,.333,17,23,.739,95,39,93,.419,30,59,.508,9,34,.265,16,17,.941,103
854,MEM,2015-01-19,95,,DAL,L 95-103,240,36,85,.424,33,63,.524,3,22,.136,20,22,.909,95,34,76,.447,24,51,.471,10,25,.400,25,33,.758,103
855,MIL,2015-01-15,95,,NYK,W 95-79,240,28,72,.389,20,54,.370,8,18,.444,31,42,.738,95,28,68,.412,20,46,.435,8,22,.364,15,20,.750,79
856,CHI,2015-01-10,95,,MIL,W 95-87,240,35,88,.398,31,71,.437,4,17,.235,21,24,.875,95,36,81,.444,33,70,.471,3,11,.273,12,16,.750,87
857,TOR,2015-01-08,95,,CHO,L 95-103,240,33,83,.398,23,52,.442,10,31,.323,19,25,.760,95,42,88,.477,38,72,.528,4,16,.250,15,22,.682,103
858,DAL,2015-01-07,95,,DET,L 95-108,240,38,87,.437,32,65,.492,6,22,.273,13,18,.722,95,43,97,.443,33,76,.434,10,21,.476,12,14,.857,108
859,PHI,2015-01-05,95,,CLE,W 95-92,240,38,79,.481,31,56,.554,7,23,.304,12,15,.800,95,33,85,.388,22,55,.400,11,30,.367,15,22,.682,92
860,BOS,2015-01-05,95,,CHO,L 95-104,240,36,91,.396,29,73,.397,7,18,.389,16,23,.696,95,38,78,.487,32,59,.542,6,19,.316,22,23,.957,104
861,SAS,2014-12-31,95,,NOP,W 95-93 (OT),265,39,89,.438,33,65,.508,6,24,.250,11,18,.611,95,34,89,.382,26,61,.426,8,28,.286,17,20,.850,93
862,MEM,2014-12-30,95,,SAS,W 95-87,240,35,72,.486,28,57,.491,7,15,.467,18,22,.818,95,35,78,.449,30,56,.536,5,22,.227,12,17,.706,87
863,MIA,2014-12-27,95,,MEM,L 95-103,240,37,72,.514,31,52,.596,6,20,.300,15,21,.714,95,34,73,.466,27,57,.474,7,16,.438,28,37,.757,103
864,CLE,2014-12-19,95,,BRK,W 95-91,240,31,77,.403,22,53,.415,9,24,.375,24,29,.828,95,37,78,.474,28,54,.519,9,24,.375,8,12,.667,91
865,TOR,2014-12-15,95,,ORL,W 95-82,240,37,83,.446,26,53,.491,11,30,.367,10,15,.667,95,36,74,.486,32,59,.542,4,15,.267,6,8,.750,82
866,UTA,2014-12-12,95,,MIA,L 95-100,240,34,77,.442,26,49,.531,8,28,.286,19,22,.864,95,36,72,.500,29,52,.558,7,20,.350,21,31,.677,100
867,BOS,2014-12-12,95,,NYK,L 95-101,240,37,85,.435,30,63,.476,7,22,.318,14,18,.778,95,40,81,.494,34,65,.523,6,16,.375,15,18,.833,101
868,ATL,2014-12-10,95,,PHI,W 95-79,240,38,91,.418,28,61,.459,10,30,.333,9,13,.692,95,30,72,.417,24,47,.511,6,25,.240,13,22,.591,79
869,BRK,2014-12-03,95,,SAS,W 95-93 (OT),265,37,90,.411,28,71,.394,9,19,.474,12,18,.667,95,36,101,.356,24,69,.348,12,32,.375,9,12,.750,93
870,CHO,2014-12-03,95,,CHI,L 95-102,240,36,90,.400,34,75,.453,2,15,.133,21,23,.913,95,37,80,.463,25,52,.481,12,28,.429,16,21,.762,102
871,UTA,2014-11-24,95,,CHI,L 95-97,240,42,86,.488,39,77,.506,3,9,.333,8,10,.800,95,36,72,.500,27,52,.519,9,20,.450,16,23,.696,97
872,HOU,2014-11-22,95,,DAL,W 95-92,240,30,82,.366,15,36,.417,15,46,.326,20,23,.870,95,35,88,.398,29,53,.547,6,35,.171,16,22,.727,92
873,MEM,2014-11-15,95,,DET,W 95-88,240,32,86,.372,28,71,.394,4,15,.267,27,33,.818,95,34,82,.415,24,56,.429,10,26,.385,10,17,.588,88
874,PHO,2014-11-14,95,,CHO,L 95-103,240,37,86,.430,29,57,.509,8,29,.276,13,14,.929,95,39,91,.429,32,75,.427,7,16,.438,18,19,.947,103
875,NYK,2014-11-12,95,,ORL,L 95-97,240,37,86,.430,29,63,.460,8,23,.348,13,14,.929,95,33,70,.471,27,58,.466,6,12,.500,25,32,.781,97
876,ORL,2014-11-01,95,,TOR,L 95-108,240,38,81,.469,31,61,.508,7,20,.350,12,24,.500,95,33,83,.398,29,62,.468,4,21,.190,38,48,.792,108
877,LAC,2015-04-11,94,,MEM,W 94-86,240,35,88,.398,29,61,.475,6,27,.222,18,22,.818,94,34,77,.442,32,68,.471,2,9,.222,16,24,.667,86
878,UTA,2015-03-28,94,,OKC,W 94-89,240,32,84,.381,26,55,.473,6,29,.207,24,35,.686,94,31,73,.425,25,57,.439,6,16,.375,21,32,.656,89
879,TOR,2015-03-27,94,,LAL,W 94-83,240,36,75,.480,29,57,.509,7,18,.389,15,21,.714,94,29,84,.345,25,67,.373,4,17,.235,21,29,.724,83
880,SAS,2015-03-27,94,,DAL,W 94-76,240,37,84,.440,28,58,.483,9,26,.346,11,14,.786,94,31,82,.378,27,64,.422,4,18,.222,10,15,.667,76
881,PHI,2015-03-18,94,,DET,W 94-83,240,36,84,.429,25,57,.439,11,27,.407,11,18,.611,94,29,88,.330,21,62,.339,8,26,.308,17,19,.895,83
882,UTA,2015-03-16,94,,CHO,W 94-66,240,33,78,.423,18,54,.333,15,24,.625,13,19,.684,94,23,78,.295,18,59,.305,5,19,.263,15,18,.833,66
883,LAL,2015-03-12,94,,NYK,L 94-101,240,38,90,.422,33,72,.458,5,18,.278,13,21,.619,94,36,77,.468,27,59,.458,9,18,.500,20,26,.769,101
884,DAL,2015-03-10,94,,CLE,L 94-127,240,33,81,.407,28,61,.459,5,20,.250,23,33,.697,94,44,87,.506,29,55,.527,15,32,.469,24,29,.828,127
885,POR,2015-03-05,94,,DAL,W 94-75,240,34,82,.415,27,60,.450,7,22,.318,19,21,.905,94,33,88,.375,31,72,.431,2,16,.125,7,8,.875,75
886,IND,2015-03-01,94,,PHI,W 94-74,240,36,88,.409,33,70,.471,3,18,.167,19,25,.760,94,29,84,.345,24,60,.400,5,24,.208,11,17,.647,74
887,DAL,2015-02-28,94,,BRK,L 94-104,240,35,82,.427,26,54,.481,9,28,.321,15,18,.833,94,40,77,.519,30,54,.556,10,23,.435,14,23,.609,104
888,MEM,2015-02-08,94,,ATL,W 94-88,240,36,92,.391,33,79,.418,3,13,.231,19,21,.905,94,33,80,.413,21,50,.420,12,30,.400,10,11,.909,88
889,CHO,2015-02-05,94,,WAS,W 94-87,240,33,76,.434,27,51,.529,6,25,.240,22,27,.815,94,35,84,.417,30,74,.405,5,10,.500,12,17,.706,87
890,IND,2015-01-31,94,,SAC,L 94-99,240,33,80,.413,28,55,.509,5,25,.200,23,25,.920,94,34,80,.425,29,65,.446,5,15,.333,26,29,.897,99
891,UTA,2015-01-16,94,,LAL,W 94-85,240,36,85,.424,24,54,.444,12,31,.387,10,10,1.000,94,31,65,.477,28,58,.483,3,7,.429,20,27,.741,85
892,DET,2015-01-14,94,,NOP,L 94-105,240,34,73,.466,26,51,.510,8,22,.364,18,23,.783,94,39,80,.488,31,59,.525,8,21,.381,19,23,.826,105
893,POR,2015-01-14,94,,LAC,L 94-100,240,35,87,.402,29,61,.475,6,26,.231,18,20,.900,94,37,88,.420,29,65,.446,8,23,.348,18,19,.947,100
894,LAL,2015-01-11,94,,POR,L 94-106,240,36,81,.444,29,59,.492,7,22,.318,15,19,.789,94,41,86,.477,28,55,.509,13,31,.419,11,17,.647,106
895,CHO,2014-12-29,94,,MIL,L 94-104 (OT),265,33,90,.367,26,65,.400,7,25,.280,21,26,.808,94,40,85,.471,34,64,.531,6,21,.286,18,21,.857,104
896,CHO,2014-12-27,94,,ORL,L 94-102,240,36,86,.419,28,62,.452,8,24,.333,14,18,.778,94,38,83,.458,30,63,.476,8,20,.400,18,24,.750,102
897,ORL,2014-12-19,94,,UTA,L 94-101,240,37,83,.446,25,61,.410,12,22,.545,8,12,.667,94,39,73,.534,35,62,.565,4,11,.364,19,24,.792,101
898,PHO,2014-12-15,94,,MIL,L 94-96,240,30,75,.400,18,37,.486,12,38,.316,22,27,.815,94,35,73,.479,27,57,.474,8,16,.500,18,22,.818,96
899,MIN,2014-12-14,94,,LAL,L 94-100,240,38,90,.422,35,80,.438,3,10,.300,15,20,.750,94,34,81,.420,29,64,.453,5,17,.294,27,34,.794,100
900,DET,2014-12-07,94,,OKC,L 94-96,240,34,76,.447,27,53,.509,7,23,.304,19,28,.679,94,39,87,.448,33,66,.500,6,21,.286,12,17,.706,96
901,LAL,2014-11-23,94,,DEN,L 94-101 (OT),265,33,89,.371,30,65,.462,3,24,.125,25,34,.735,94,34,90,.378,24,53,.453,10,37,.270,23,38,.605,101
902,MIA,2014-11-23,94,,CHO,W 94-93,240,33,66,.500,22,43,.512,11,23,.478,17,19,.895,94,37,79,.468,30,58,.517,7,21,.333,12,16,.750,93
903,UTA,2014-11-22,94,,NOP,L 94-106,240,33,71,.465,28,57,.491,5,14,.357,23,29,.793,94,42,93,.452,38,76,.500,4,17,.235,18,22,.818,106
904,SAC,2014-11-15,94,,SAS,W 94-91,240,37,86,.430,37,74,.500,0,12,.000,20,24,.833,94,34,80,.425,27,56,.482,7,24,.292,16,18,.889,91
905,BOS,2014-11-12,94,,OKC,L 94-109,240,37,83,.446,28,50,.560,9,33,.273,11,13,.846,94,40,82,.488,30,58,.517,10,24,.417,19,22,.864,109
906,SAS,2014-11-05,94,,ATL,W 94-92,240,31,69,.449,26,52,.500,5,17,.294,27,38,.711,94,38,92,.413,30,67,.448,8,25,.320,8,11,.727,92
907,PHO,2014-10-31,94,,SAS,W 94-89,240,35,87,.402,33,69,.478,2,18,.111,22,26,.846,94,32,78,.410,24,53,.453,8,25,.320,17,23,.739,89
908,IND,2015-04-03,93,,CHO,W 93-74,240,36,83,.434,28,67,.418,8,16,.500,13,18,.722,93,28,80,.350,24,62,.387,4,18,.222,14,20,.700,74
909,NOP,2015-03-25,93,,HOU,L 93-95,240,34,75,.453,29,60,.483,5,15,.333,20,32,.625,93,40,81,.494,34,59,.576,6,22,.273,9,12,.750,95
910,OKC,2015-03-22,93,,MIA,W 93-75,240,40,90,.444,34,72,.472,6,18,.333,7,13,.538,93,32,81,.395,29,63,.460,3,18,.167,8,15,.533,75
911,LAL,2015-03-10,93,,DET,W 93-85,240,32,75,.427,29,62,.468,3,13,.231,26,30,.867,93,32,84,.381,24,49,.490,8,35,.229,13,19,.684,85
912,LAL,2015-03-08,93,,DAL,L 93-100,240,38,82,.463,36,68,.529,2,14,.143,15,21,.714,93,38,78,.487,29,52,.558,9,26,.346,15,22,.682,100
913,LAC,2015-03-04,93,,POR,L 93-98 (OT),265,37,96,.385,26,65,.400,11,31,.355,8,18,.444,93,34,87,.391,26,55,.473,8,32,.250,22,29,.759,98
914,IND,2015-02-27,93,,CLE,W 93-86,240,34,80,.425,28,63,.444,6,17,.353,19,29,.655,93,33,92,.359,24,63,.381,9,29,.310,11,14,.786,86
915,DET,2015-02-24,93,,CLE,L 93-102,240,33,82,.402,24,58,.414,9,24,.375,18,30,.600,93,34,77,.442,20,40,.500,14,37,.378,20,24,.833,102
916,NOP,2015-02-11,93,,IND,L 93-106,240,34,74,.459,27,59,.458,7,15,.467,18,25,.720,93,40,75,.533,31,55,.564,9,20,.450,17,18,.944,106
917,IND,2015-02-09,93,,SAS,L 93-95,240,36,88,.409,28,67,.418,8,21,.381,13,13,1.000,93,37,89,.416,31,64,.484,6,25,.240,15,17,.882,95
918,TOR,2015-02-04,93,,BRK,L 93-109,240,35,79,.443,25,46,.543,10,33,.303,13,18,.722,93,40,81,.494,31,62,.500,9,19,.474,20,23,.870,109
919,ORL,2015-01-31,93,,DAL,L 93-108,240,33,78,.423,25,54,.463,8,24,.333,19,24,.792,93,42,74,.568,31,53,.585,11,21,.524,13,22,.591,108
920,ATL,2015-01-19,93,,DET,W 93-82,240,37,84,.440,28,54,.519,9,30,.300,10,14,.714,93,29,82,.354,20,47,.426,9,35,.257,15,26,.577,82
921,TOR,2015-01-18,93,,NOP,L 93-95,240,31,72,.431,24,47,.511,7,25,.280,24,29,.828,93,39,82,.476,34,65,.523,5,17,.294,12,20,.600,95
922,CHO,2015-01-14,93,,SAS,L 93-98,240,33,86,.384,29,73,.397,4,13,.308,23,35,.657,93,37,85,.435,29,64,.453,8,21,.381,16,20,.800,98
923,PHI,2015-01-10,93,,IND,W 93-92,240,32,80,.400,21,56,.375,11,24,.458,18,25,.720,93,29,87,.333,25,69,.362,4,18,.222,30,42,.714,92
924,MIN,2015-01-10,93,,SAS,L 93-108,240,32,81,.395,29,66,.439,3,15,.200,26,26,1.000,93,41,84,.488,32,60,.533,9,24,.375,17,20,.850,108
925,DEN,2015-01-07,93,,ORL,W 93-90,240,33,74,.446,26,57,.456,7,17,.412,20,26,.769,93,35,88,.398,27,66,.409,8,22,.364,12,16,.750,90
926,CLE,2015-01-07,93,,HOU,L 93-105,240,34,82,.415,24,53,.453,10,29,.345,15,19,.789,93,39,86,.453,27,52,.519,12,34,.353,15,24,.625,105
927,ATL,2014-12-15,93,,CHI,W 93-86,240,36,83,.434,29,62,.468,7,21,.333,14,17,.824,93,35,93,.376,29,64,.453,6,29,.207,10,14,.714,86
928,WAS,2014-12-14,93,,UTA,W 93-84,240,41,84,.488,37,71,.521,4,13,.308,7,12,.583,93,30,78,.385,25,61,.410,5,17,.294,19,28,.679,84
929,UTA,2014-12-05,93,,ORL,L 93-98,240,36,79,.456,28,63,.444,8,16,.500,13,21,.619,93,37,74,.500,30,57,.526,7,17,.412,17,20,.850,98
930,NYK,2014-12-02,93,,BRK,L 93-98,240,35,81,.432,24,53,.453,11,28,.393,12,14,.857,93,39,89,.438,33,72,.458,6,17,.353,14,20,.700,98
931,DET,2014-11-30,93,,GSW,L 93-104,240,33,91,.363,22,68,.324,11,23,.478,16,24,.667,93,37,79,.468,28,58,.483,9,21,.429,21,27,.778,104
932,LAL,2014-11-26,93,,MEM,L 93-99,240,33,81,.407,25,62,.403,8,19,.421,19,24,.792,93,36,80,.450,31,58,.534,5,22,.227,22,25,.880,99
933,CLE,2014-11-22,93,,TOR,L 93-110,240,35,81,.432,32,65,.492,3,16,.188,20,29,.690,93,32,80,.400,24,56,.429,8,24,.333,38,42,.905,110
934,MIA,2014-11-20,93,,LAC,L 93-110,240,30,67,.448,24,41,.585,6,26,.231,27,31,.871,93,43,77,.558,30,46,.652,13,31,.419,11,17,.647,110
935,DET,2014-11-17,93,,ORL,L 93-107,240,32,80,.400,21,56,.375,11,24,.458,18,24,.750,93,41,79,.519,28,53,.528,13,26,.500,12,15,.800,107
936,TOR,2014-11-13,93,,CHI,L 93-100,240,35,89,.393,27,64,.422,8,25,.320,15,21,.714,93,37,77,.481,33,62,.532,4,15,.267,22,32,.688,100
937,MIL,2014-11-08,93,,MEM,W 93-92,240,40,88,.455,35,70,.500,5,18,.278,8,11,.727,93,29,82,.354,26,68,.382,3,14,.214,31,34,.912,92
938,PHI,2014-11-03,93,,HOU,L 93-104,240,33,74,.446,22,52,.423,11,22,.500,16,23,.696,93,32,75,.427,16,41,.390,16,34,.471,24,30,.800,104
939,MEM,2014-11-03,93,,NOP,W 93-81,240,31,76,.408,27,62,.435,4,14,.286,27,37,.730,93,29,86,.337,25,62,.403,4,24,.167,19,29,.655,81
940,MIL,2014-10-31,93,,PHI,W 93-81,240,36,88,.409,27,64,.422,9,24,.375,12,21,.571,93,32,86,.372,27,63,.429,5,23,.217,12,22,.545,81
941,LAC,2014-10-30,93,,OKC,W 93-90,240,34,87,.391,27,57,.474,7,30,.233,18,25,.720,93,28,65,.431,22,44,.500,6,21,.286,28,34,.824,90
942,UTA,2014-10-29,93,,HOU,L 93-104,240,38,81,.469,35,63,.556,3,18,.167,14,17,.824,93,40,77,.519,26,50,.520,14,27,.519,10,14,.714,104
943,TOR,2015-04-15,92,,CHO,W 92-87,240,38,77,.494,26,44,.591,12,33,.364,4,4,1.000,92,30,71,.423,18,38,.474,12,33,.364,15,16,.938,87
944,CHO,2015-04-04,92,,PHI,W 92-91,240,35,86,.407,34,73,.466,1,13,.077,21,23,.913,92,28,76,.368,17,50,.340,11,26,.423,24,33,.727,91
945,DEN,2015-04-04,92,,LAC,L 92-107,240,32,85,.376,26,63,.413,6,22,.273,22,31,.710,92,34,79,.430,21,45,.467,13,34,.382,26,42,.619,107
946,LAL,2015-04-01,92,,NOP,L 92-113,240,37,83,.446,32,67,.478,5,16,.313,13,21,.619,92,44,78,.564,35,62,.565,9,16,.563,16,21,.762,113
947,NYK,2015-03-27,92,,BOS,L 92-96,240,38,87,.437,31,63,.492,7,24,.292,9,14,.643,92,29,69,.420,25,49,.510,4,20,.200,34,43,.791,96
948,NYK,2015-03-19,92,,MIN,L 92-95 (OT),265,40,97,.412,36,77,.468,4,20,.200,8,10,.800,92,34,83,.410,32,71,.451,2,12,.167,25,30,.833,95
949,MEM,2015-03-16,92,,DEN,W 92-81,240,33,80,.413,31,71,.437,2,9,.222,24,28,.857,92,30,81,.370,22,63,.349,8,18,.444,13,21,.619,81
950,PHI,2015-03-07,92,,ATL,W 92-84,240,35,95,.368,22,58,.379,13,37,.351,9,17,.529,92,30,77,.390,19,52,.365,11,25,.440,13,16,.813,84
951,DEN,2015-03-01,92,,NOP,L 92-99,240,37,92,.402,28,59,.475,9,33,.273,9,17,.529,92,36,74,.486,31,52,.596,5,22,.227,22,30,.733,99
952,POR,2015-02-22,92,,MEM,L 92-98,240,33,82,.402,20,49,.408,13,33,.394,13,16,.813,92,42,89,.472,39,80,.488,3,9,.333,11,13,.846,98
953,DAL,2015-02-22,92,,CHO,W 92-81,240,36,78,.462,31,60,.517,5,18,.278,15,19,.789,92,33,90,.367,27,71,.380,6,19,.316,9,13,.692,81
954,UTA,2015-02-20,92,,POR,W 92-76,240,37,83,.446,27,58,.466,10,25,.400,8,17,.471,92,26,72,.361,22,50,.440,4,22,.182,20,22,.909,76
955,NYK,2015-02-07,92,,GSW,L 92-106,240,35,87,.402,27,69,.391,8,18,.444,14,17,.824,92,37,81,.457,25,56,.446,12,25,.480,20,24,.833,106
956,BRK,2015-02-06,92,,NYK,W 92-88,240,37,74,.500,34,63,.540,3,11,.273,15,22,.682,92,34,89,.382,28,65,.431,6,24,.250,14,17,.824,88
957,NYK,2015-02-01,92,,LAL,W 92-80,240,37,84,.440,27,62,.435,10,22,.455,8,13,.615,92,27,76,.355,20,60,.333,7,16,.438,19,23,.826,80
958,LAL,2015-01-27,92,,WAS,L 92-98,240,37,87,.425,32,67,.478,5,20,.250,13,16,.813,92,38,78,.487,34,62,.548,4,16,.250,18,27,.667,98
959,OKC,2015-01-26,92,,MIN,W 92-84,240,36,86,.419,32,66,.485,4,20,.200,16,24,.667,92,29,85,.341,27,72,.375,2,13,.154,24,32,.750,84
960,MEM,2015-01-21,92,,TOR,W 92-86,240,34,74,.459,33,67,.493,1,7,.143,23,29,.793,92,27,85,.318,22,57,.386,5,28,.179,27,32,.844,86
961,BRK,2015-01-14,92,,MEM,L 92-103,240,36,75,.480,26,49,.531,10,26,.385,10,12,.833,92,39,83,.470,36,66,.545,3,17,.176,22,29,.759,103
962,UTA,2015-01-02,92,,ATL,L 92-98,240,32,86,.372,22,55,.400,10,31,.323,18,24,.750,92,33,81,.407,27,58,.466,6,23,.261,26,30,.867,98
963,WAS,2014-12-21,92,,PHO,L 92-104,240,34,83,.410,31,69,.449,3,14,.214,21,29,.724,92,40,78,.513,34,61,.557,6,17,.353,18,25,.720,104
964,SAC,2014-12-16,92,,OKC,L 92-104,240,36,84,.429,31,66,.470,5,18,.278,15,17,.882,92,41,87,.471,35,67,.522,6,20,.300,16,24,.667,104
965,MIN,2014-12-12,92,,OKC,L 92-111,240,36,78,.462,35,71,.493,1,7,.143,19,29,.655,92,45,88,.511,39,64,.609,6,24,.250,15,20,.750,111
966,IND,2014-12-08,92,,ATL,L 92-108,240,37,84,.440,28,57,.491,9,27,.333,9,17,.529,92,40,77,.519,31,56,.554,9,21,.429,19,27,.704,108
967,CHO,2014-11-24,92,,LAC,L 92-113,240,31,75,.413,29,55,.527,2,20,.100,28,35,.800,92,45,88,.511,30,56,.536,15,32,.469,8,10,.800,113
968,ORL,2014-11-22,92,,MIA,L 92-99,240,35,78,.449,32,62,.516,3,16,.188,19,27,.704,92,37,71,.521,25,45,.556,12,26,.462,13,18,.722,99
969,MIN,2014-11-21,92,,SAS,L 92-121,240,37,90,.411,33,77,.429,4,13,.308,14,22,.636,92,46,84,.548,33,63,.524,13,21,.619,16,18,.889,121
970,OKC,2014-11-21,92,,BRK,L 92-94,240,38,85,.447,34,65,.523,4,20,.200,12,19,.632,92,31,67,.463,26,52,.500,5,15,.333,27,30,.900,94
971,HOU,2014-11-19,92,,LAL,L 92-98,240,30,74,.405,15,36,.417,15,38,.395,17,23,.739,92,37,91,.407,32,71,.451,5,20,.250,19,23,.826,98
972,LAC,2014-11-02,92,,SAC,L 92-98,240,33,88,.375,24,57,.421,9,31,.290,17,21,.810,92,34,68,.500,31,58,.534,3,10,.300,27,33,.818,98
973,CHI,2015-04-15,91,,ATL,W 91-85,240,31,77,.403,24,53,.453,7,24,.292,22,26,.846,91,36,92,.391,28,63,.444,8,29,.276,5,7,.714,85
974,NYK,2015-04-10,91,,MIL,L 91-99,240,34,72,.472,29,59,.492,5,13,.385,18,24,.750,91,37,76,.487,31,59,.525,6,17,.353,19,29,.655,99
975,ORL,2015-04-01,91,,SAS,L 91-103,240,39,93,.419,34,76,.447,5,17,.294,8,9,.889,91,35,86,.407,22,57,.386,13,29,.448,20,23,.870,103
976,WAS,2015-03-29,91,,HOU,L 91-99,240,29,75,.387,25,60,.417,4,15,.267,29,37,.784,91,34,80,.425,25,51,.490,9,29,.310,22,33,.667,99
977,BRK,2015-03-23,91,,BOS,L 91-110,240,32,89,.360,31,72,.431,1,17,.059,26,30,.867,91,47,92,.511,41,70,.586,6,22,.273,10,14,.714,110
978,BRK,2015-03-10,91,,NOP,L 91-111,240,35,84,.417,29,68,.426,6,16,.375,15,23,.652,91,45,87,.517,33,66,.500,12,21,.571,9,11,.818,111
979,CHI,2015-03-09,91,,MEM,L 91-101,240,35,80,.438,25,58,.431,10,22,.455,11,14,.786,91,42,84,.500,37,70,.529,5,14,.357,12,17,.706,101
980,MIL,2015-03-07,91,,WAS,W 91-85,240,36,78,.462,26,58,.448,10,20,.500,9,15,.600,91,31,81,.383,22,53,.415,9,28,.321,14,22,.636,85
981,BRK,2015-03-04,91,,CHO,L 91-115,240,35,88,.398,32,72,.444,3,16,.188,18,24,.750,91,42,85,.494,34,66,.515,8,19,.421,23,28,.821,115
982,MIA,2015-02-28,91,,ATL,L 91-93,240,32,81,.395,25,55,.455,7,26,.269,20,21,.952,91,34,79,.430,24,54,.444,10,25,.400,15,20,.750,93
983,MIA,2015-02-21,91,,NOP,L 91-105,240,33,79,.418,28,62,.452,5,17,.294,20,27,.741,91,35,83,.422,27,62,.435,8,21,.381,27,31,.871,105
984,MIN,2015-02-11,91,,GSW,L 91-94,240,33,86,.384,28,72,.389,5,14,.357,20,27,.741,91,40,90,.444,33,63,.524,7,27,.259,7,9,.778,94
985,NOP,2015-02-04,91,,OKC,L 91-102,240,37,97,.381,30,72,.417,7,25,.280,10,13,.769,91,45,85,.529,40,70,.571,5,15,.333,7,11,.636,102
986,ATL,2015-01-31,91,,PHI,W 91-85,240,34,78,.436,24,50,.480,10,28,.357,13,18,.722,91,31,81,.383,17,46,.370,14,35,.400,9,15,.600,85
987,IND,2015-01-27,91,,TOR,L 91-104,240,34,82,.415,27,64,.422,7,18,.389,16,23,.696,91,34,73,.466,25,47,.532,9,26,.346,27,34,.794,104
988,PHI,2015-01-21,91,,NYK,L 91-98,240,29,79,.367,21,56,.375,8,23,.348,25,32,.781,91,37,91,.407,30,71,.423,7,20,.350,17,20,.850,98
989,BOS,2015-01-14,91,,ATL,L 91-105,240,34,83,.410,23,50,.460,11,33,.333,12,14,.857,91,36,73,.493,26,44,.591,10,29,.345,23,27,.852,105
990,MIL,2015-01-02,91,,IND,L 91-94,240,38,89,.427,31,65,.477,7,24,.292,8,10,.800,91,35,81,.432,27,61,.443,8,20,.400,16,20,.800,94
991,NYK,2014-12-25,91,,WAS,L 91-102,240,36,80,.450,32,58,.552,4,22,.182,15,19,.789,91,44,86,.512,37,70,.529,7,16,.438,7,10,.700,102
992,WAS,2014-12-23,91,,CHI,L 91-99,240,38,89,.427,33,80,.413,5,9,.556,10,16,.625,91,39,85,.459,34,68,.500,5,17,.294,16,24,.667,99
993,MEM,2014-12-22,91,,UTA,L 91-97,240,38,86,.442,31,63,.492,7,23,.304,8,9,.889,91,34,75,.453,25,56,.446,9,19,.474,20,27,.741,97
994,PHI,2014-12-19,91,,CHO,L 91-109,240,32,71,.451,20,45,.444,12,26,.462,15,17,.882,91,43,98,.439,33,74,.446,10,24,.417,13,17,.765,109
995,BRK,2014-12-16,91,,MIA,L 91-95,240,30,77,.390,22,49,.449,8,28,.286,23,32,.719,91,33,72,.458,24,48,.500,9,24,.375,20,26,.769,95
996,DEN,2014-12-14,91,,SAS,L 91-99,240,34,83,.410,26,67,.388,8,16,.500,15,21,.714,91,34,74,.459,29,58,.500,5,16,.313,26,35,.743,99
997,PHI,2014-12-05,91,,OKC,L 91-103,240,32,84,.381,24,56,.429,8,28,.286,19,30,.633,91,35,71,.493,26,48,.542,9,23,.391,24,31,.774,103
998,TOR,2014-12-05,91,,CLE,L 91-105,240,35,86,.407,27,62,.435,8,24,.333,13,20,.650,91,41,84,.488,32,64,.500,9,20,.450,14,21,.667,105
999,PHI,2014-11-26,91,,BRK,L 91-99,240,34,85,.400,25,61,.410,9,24,.375,14,17,.824,91,35,71,.493,27,47,.574,8,24,.333,21,28,.750,99
1000,HOU,2014-11-24,91,,NYK,W 91-86,240,32,76,.421,18,40,.450,14,36,.389,13,19,.684,91,35,76,.461,29,54,.537,6,22,.273,10,15,.667,86
1001,NYK,2014-11-22,91,,PHI,W 91-83,240,33,66,.500,27,49,.551,6,17,.353,19,21,.905,91,30,75,.400,22,49,.449,8,26,.308,15,25,.600,83
1002,WAS,2014-11-21,91,,CLE,W 91-78,240,41,84,.488,37,74,.500,4,10,.400,5,9,.556,91,27,75,.360,21,48,.438,6,27,.222,18,23,.783,78
1003,PHO,2014-11-05,91,,MEM,L 91-102,240,32,69,.464,24,48,.500,8,21,.381,19,21,.905,91,40,80,.500,31,63,.492,9,17,.529,13,17,.765,102
1004,BRK,2014-11-05,91,,MIN,L 91-98,240,36,82,.439,28,61,.459,8,21,.381,11,17,.647,91,37,90,.411,30,73,.411,7,17,.412,17,22,.773,98
1005,MIA,2014-11-04,91,,HOU,L 91-108,240,31,74,.419,19,46,.413,12,28,.429,17,27,.630,91,35,68,.515,18,31,.581,17,37,.459,21,27,.778,108
1006,NYK,2015-04-15,90,,DET,L 90-112,240,33,77,.429,26,58,.448,7,19,.368,17,27,.630,90,41,81,.506,31,55,.564,10,26,.385,20,27,.741,112
1007,CHO,2015-04-13,90,,HOU,L 90-100,240,34,83,.410,21,51,.412,13,32,.406,9,17,.529,90,35,85,.412,26,50,.520,9,35,.257,21,26,.808,100
1008,CLE,2015-04-10,90,,BOS,L 90-99,240,32,77,.416,23,43,.535,9,34,.265,17,25,.680,90,38,84,.452,30,62,.484,8,22,.364,15,21,.714,99
1009,NOP,2015-04-10,90,,PHO,W 90-75,240,37,84,.440,32,65,.492,5,19,.263,11,19,.579,90,30,85,.353,23,60,.383,7,25,.280,8,10,.800,75
1010,PHI,2015-04-08,90,,WAS,L 90-119,240,31,89,.348,22,62,.355,9,27,.333,19,27,.704,90,47,72,.653,39,57,.684,8,15,.533,17,23,.739,119
1011,MIL,2015-04-04,90,,ORL,L 90-97,240,39,89,.438,34,73,.466,5,16,.313,7,13,.538,90,40,86,.465,32,65,.492,8,21,.381,9,13,.692,97
1012,MIL,2015-03-22,90,,CLE,L 90-108,240,38,70,.543,35,58,.603,3,12,.250,11,14,.786,90,42,84,.500,29,53,.547,13,31,.419,11,16,.688,108
1013,MIA,2015-03-09,90,,BOS,L 90-100,240,29,69,.420,25,52,.481,4,17,.235,28,34,.824,90,39,87,.448,33,62,.532,6,25,.240,16,17,.941,100
1014,ORL,2015-02-25,90,,MIA,L 90-93 (OT),265,33,78,.423,27,56,.482,6,22,.273,18,31,.581,90,32,84,.381,26,53,.491,6,31,.194,23,32,.719,93
1015,UTA,2015-02-23,90,,SAS,W 90-81,240,34,83,.410,30,68,.441,4,15,.267,18,23,.783,90,32,79,.405,27,60,.450,5,19,.263,12,21,.571,81
1016,MIN,2015-02-06,90,,MEM,W 90-89,240,35,81,.432,30,64,.469,5,17,.294,15,17,.882,90,36,69,.522,34,57,.596,2,12,.167,15,20,.750,89
1017,UTA,2015-02-04,90,,MEM,L 90-100,240,33,73,.452,26,50,.520,7,23,.304,17,26,.654,90,38,80,.475,32,67,.478,6,13,.462,18,22,.818,100
1018,MIN,2015-01-31,90,,CLE,L 90-106,240,34,82,.415,28,69,.406,6,13,.462,16,21,.762,90,42,87,.483,32,55,.582,10,32,.313,12,19,.632,106
1019,DAL,2015-01-27,90,,MEM,L 90-109,240,38,78,.487,31,52,.596,7,26,.269,7,10,.700,90,42,79,.532,32,58,.552,10,21,.476,15,20,.750,109
1020,UTA,2015-01-26,90,,BOS,L 90-99,240,35,82,.427,26,58,.448,9,24,.375,11,19,.579,90,35,74,.473,27,55,.491,8,19,.421,21,23,.913,99
1021,BRK,2015-01-17,90,,WAS,L 90-99,240,36,82,.439,32,65,.492,4,17,.235,14,18,.778,90,40,77,.519,35,61,.574,5,16,.313,14,27,.519,99
1022,LAC,2015-01-11,90,,MIA,L 90-104,240,34,75,.453,25,49,.510,9,26,.346,13,18,.722,90,39,81,.481,33,60,.550,6,21,.286,20,24,.833,104
1023,CLE,2015-01-04,90,,DAL,L 90-109,240,35,86,.407,27,61,.443,8,25,.320,12,17,.706,90,44,78,.564,32,52,.615,12,26,.462,9,11,.818,109
1024,ORL,2015-01-03,90,,CHO,L 90-98,240,33,87,.379,29,68,.426,4,19,.211,20,21,.952,90,35,78,.449,31,62,.500,4,16,.250,24,32,.750,98
1025,IND,2014-12-29,90,,CHI,L 90-92,240,36,83,.434,31,70,.443,5,13,.385,13,21,.619,90,29,84,.345,24,71,.338,5,13,.385,29,33,.879,92
1026,NYK,2014-12-20,90,,PHO,L 90-99,240,35,88,.398,28,66,.424,7,22,.318,13,16,.813,90,35,78,.449,25,53,.472,10,25,.400,19,23,.826,99
1027,HOU,2014-12-18,90,,NOP,L 90-99,240,33,86,.384,27,61,.443,6,25,.240,18,23,.783,90,38,82,.463,33,64,.516,5,18,.278,18,22,.818,99
1028,NYK,2014-12-14,90,,TOR,L 90-95 (OT),265,29,78,.372,20,49,.408,9,29,.310,23,28,.821,90,36,78,.462,27,54,.500,9,24,.375,14,18,.778,95
1029,SAC,2014-12-13,90,,DET,L 90-95,240,33,93,.355,22,64,.344,11,29,.379,13,19,.684,90,35,79,.443,29,59,.492,6,20,.300,19,23,.826,95
1030,MIN,2014-12-10,90,,POR,W 90-82,240,32,81,.395,31,69,.449,1,12,.083,25,33,.758,90,31,80,.388,21,45,.467,10,35,.286,10,12,.833,82
1031,PHO,2014-11-30,90,,ORL,L 90-93,240,34,85,.400,27,59,.458,7,26,.269,15,18,.833,90,35,76,.461,30,61,.492,5,15,.333,18,25,.720,93
1032,ORL,2014-11-19,90,,LAC,L 90-114,240,34,86,.395,26,62,.419,8,24,.333,14,18,.778,90,45,84,.536,33,63,.524,12,21,.571,12,16,.750,114
1033,CLE,2014-11-19,90,,SAS,L 90-92,240,37,83,.446,30,65,.462,7,18,.389,9,13,.692,90,35,74,.473,30,58,.517,5,16,.313,17,25,.680,92
1034,PHI,2014-11-19,90,,BOS,L 90-101,240,34,86,.395,27,65,.415,7,21,.333,15,21,.714,90,41,83,.494,35,63,.556,6,20,.300,13,21,.619,101
1035,CHI,2014-11-15,90,,IND,L 90-99,240,35,83,.422,31,66,.470,4,17,.235,16,23,.696,90,37,77,.481,30,59,.508,7,18,.389,18,25,.720,99
1036,IND,2014-11-08,90,,WAS,L 90-97,240,33,77,.429,25,53,.472,8,24,.333,16,25,.640,90,39,81,.481,37,70,.529,2,11,.182,17,23,.739,97
1037,POR,2014-11-02,90,,GSW,L 90-95,240,37,92,.402,30,65,.462,7,27,.259,9,14,.643,90,36,81,.444,30,62,.484,6,19,.316,17,21,.810,95
1038,DET,2014-11-01,90,,BRK,L 90-102,240,32,76,.421,31,59,.525,1,17,.059,25,35,.714,90,42,87,.483,35,61,.574,7,26,.269,11,13,.846,102
1039,CLE,2014-10-30,90,,NYK,L 90-95,240,32,70,.457,23,46,.500,9,24,.375,17,20,.850,90,37,69,.536,31,57,.544,6,12,.500,15,18,.833,95
1040,LAL,2014-10-28,90,,HOU,L 90-108,240,28,79,.354,25,69,.362,3,10,.300,31,39,.795,90,31,73,.425,19,44,.432,12,29,.414,34,50,.680,108
1041,MEM,2015-03-25,89,,CLE,L 89-111,240,37,85,.435,33,68,.485,4,17,.235,11,16,.688,89,43,84,.512,29,50,.580,14,34,.412,11,13,.846,111
1042,UTA,2015-03-25,89,,POR,L 89-92,240,35,80,.438,31,64,.484,4,16,.250,15,23,.652,89,34,81,.420,27,54,.500,7,27,.259,17,20,.850,92
1043,MIL,2015-03-24,89,,MIA,W 89-88,240,36,87,.414,32,70,.457,4,17,.235,13,17,.765,89,33,75,.440,25,56,.446,8,19,.421,14,18,.778,88
1044,IND,2015-03-14,89,,BOS,L 89-93,240,34,85,.400,25,61,.410,9,24,.375,12,15,.800,89,35,83,.422,27,55,.491,8,28,.286,15,21,.714,93
1045,LAC,2015-03-09,89,,MIN,W 89-76,240,35,79,.443,24,48,.500,11,31,.355,8,15,.533,89,31,83,.373,29,75,.387,2,8,.250,12,21,.571,76
1046,CLE,2015-03-07,89,,PHO,W 89-79,240,31,75,.413,23,55,.418,8,20,.400,19,23,.826,89,30,84,.357,21,59,.356,9,25,.360,10,14,.714,79
1047,PHI,2015-02-27,89,,WAS,W 89-81,240,28,80,.350,16,47,.340,12,33,.364,21,34,.618,89,30,93,.323,26,76,.342,4,17,.235,17,22,.773,81
1048,TOR,2015-02-27,89,,GSW,L 89-113,240,31,77,.403,27,55,.491,4,22,.182,23,28,.821,89,42,87,.483,29,59,.492,13,28,.464,16,19,.842,113
1049,WAS,2015-02-20,89,,CLE,L 89-127,240,38,86,.442,37,70,.529,1,16,.063,12,16,.750,89,46,90,.511,32,57,.561,14,33,.424,21,28,.750,127
1050,MIL,2015-02-20,89,,DEN,W 89-81,240,33,78,.423,28,63,.444,5,15,.333,18,22,.818,89,30,84,.357,23,58,.397,7,26,.269,14,21,.667,81
1051,ORL,2015-02-11,89,,NYK,W 89-83,240,31,67,.463,27,56,.482,4,11,.364,23,28,.821,89,25,73,.342,20,58,.345,5,15,.333,28,36,.778,83
1052,BOS,2015-02-11,89,,ATL,W 89-88,240,30,93,.323,20,62,.323,10,31,.323,19,20,.950,89,33,78,.423,26,49,.531,7,29,.241,15,23,.652,88
1053,PHI,2015-02-07,89,,CHO,W 89-81,240,29,74,.392,20,51,.392,9,23,.391,22,30,.733,89,29,84,.345,23,61,.377,6,23,.261,17,20,.850,81
1054,UTA,2015-01-28,89,,LAC,L 89-94,240,35,81,.432,30,57,.526,5,24,.208,14,20,.700,89,34,76,.447,25,50,.500,9,26,.346,17,25,.680,94
1055,PHI,2015-01-28,89,,DET,W 89-69,240,37,78,.474,30,57,.526,7,21,.333,8,12,.667,89,23,75,.307,21,55,.382,2,20,.100,21,23,.913,69
1056,MIA,2015-01-23,89,,IND,W 89-87,240,36,75,.480,32,58,.552,4,17,.235,13,15,.867,89,32,78,.410,29,63,.460,3,15,.200,20,23,.870,87
1057,POR,2015-01-22,89,,BOS,L 89-90,240,33,89,.371,24,61,.393,9,28,.321,14,19,.737,89,39,87,.448,32,68,.471,7,19,.368,5,7,.714,90
1058,MIL,2015-01-19,89,,TOR,L 89-92,240,34,76,.447,29,58,.500,5,18,.278,16,25,.640,89,36,90,.400,30,66,.455,6,24,.250,14,24,.583,92
1059,SAS,2015-01-18,89,,UTA,W 89-69,240,31,80,.388,23,63,.365,8,17,.471,19,23,.826,89,28,84,.333,25,74,.338,3,10,.300,10,16,.625,69
1060,TOR,2015-01-16,89,,ATL,L 89-110,240,35,82,.427,29,57,.509,6,25,.240,13,17,.765,89,42,69,.609,30,46,.652,12,23,.522,14,16,.875,110
1061,MIN,2015-01-03,89,,UTA,L 89-101,240,34,86,.395,28,67,.418,6,19,.316,15,18,.833,89,38,75,.507,27,55,.491,11,20,.550,14,21,.667,101
1062,ORL,2014-12-26,89,,CLE,L 89-98,240,36,73,.493,27,52,.519,9,21,.429,8,12,.667,89,33,80,.413,25,50,.500,8,30,.267,24,26,.923,98
1063,ORL,2014-12-10,89,,WAS,L 89-91,240,38,84,.452,31,69,.449,7,15,.467,6,9,.667,89,41,81,.506,36,69,.522,5,12,.417,4,9,.444,91
1064,BOS,2014-11-30,89,,SAS,L 89-111,240,36,87,.414,30,69,.435,6,18,.333,11,15,.733,89,41,85,.482,30,59,.508,11,26,.423,18,20,.900,111
1065,NOP,2014-11-25,89,,SAC,L 89-99,240,33,79,.418,30,62,.484,3,17,.176,20,29,.690,89,37,77,.481,32,63,.508,5,14,.357,20,24,.833,99
1066,LAC,2014-11-17,89,,CHI,L 89-105,240,36,81,.444,29,58,.500,7,23,.304,10,22,.455,89,39,80,.488,29,54,.537,10,26,.385,17,25,.680,105
1067,OKC,2014-11-14,89,,DET,L 89-96 (OT),265,38,96,.396,26,60,.433,12,36,.333,1,6,.167,89,38,89,.427,27,58,.466,11,31,.355,9,15,.600,96
1068,OKC,2014-11-07,89,,MEM,L 89-91,240,37,79,.468,25,54,.463,12,25,.480,3,11,.273,89,34,81,.420,25,63,.397,9,18,.500,14,17,.824,91
1069,PHI,2014-11-05,89,,ORL,L 89-91,240,33,77,.429,25,52,.481,8,25,.320,15,23,.652,89,39,88,.443,36,68,.529,3,20,.150,10,12,.833,91
1070,IND,2014-10-31,89,,MEM,L 89-97,240,34,74,.459,26,53,.491,8,21,.381,13,16,.813,89,35,79,.443,28,60,.467,7,19,.368,20,27,.741,97
1071,DEN,2014-10-29,89,,DET,W 89-79,240,30,85,.353,24,61,.393,6,24,.250,23,31,.742,89,31,84,.369,25,58,.431,6,26,.231,11,19,.579,79
1072,MIN,2015-04-13,88,,NOP,L 88-100,240,31,78,.397,27,64,.422,4,14,.286,22,28,.786,88,37,84,.440,31,63,.492,6,21,.286,20,24,.833,100
1073,UTA,2015-04-10,88,,MEM,L 88-89,240,31,71,.437,20,48,.417,11,23,.478,15,22,.682,88,36,76,.474,31,61,.508,5,15,.333,12,19,.632,89
1074,OKC,2015-04-07,88,,SAS,L 88-113,240,34,84,.405,29,65,.446,5,19,.263,15,28,.536,88,47,89,.528,37,65,.569,10,24,.417,9,13,.692,113
1075,CHI,2015-04-03,88,,DET,W 88-82,240,33,85,.388,29,68,.426,4,17,.235,18,21,.857,88,32,74,.432,26,55,.473,6,19,.316,12,15,.800,82
1076,CHO,2015-03-25,88,,BRK,L 88-91,240,36,91,.396,33,79,.418,3,12,.250,13,20,.650,88,39,91,.429,36,77,.468,3,14,.214,10,11,.909,91
1077,UTA,2015-03-14,88,,DET,W 88-85,240,33,69,.478,27,55,.491,6,14,.429,16,24,.667,88,32,84,.381,24,61,.393,8,23,.348,13,22,.591,85
1078,BRK,2015-03-08,88,,UTA,L 88-95,240,38,76,.500,30,61,.492,8,15,.533,4,11,.364,88,34,72,.472,24,50,.480,10,22,.455,17,21,.810,95
1079,NOP,2015-03-04,88,,DET,W 88-85,240,37,90,.411,35,78,.449,2,12,.167,12,16,.750,88,38,93,.409,36,79,.456,2,14,.143,7,9,.778,85
1080,WAS,2015-02-02,88,,CHO,L 88-92,240,33,81,.407,27,66,.409,6,15,.400,16,19,.842,88,37,79,.468,33,64,.516,4,15,.267,14,19,.737,92
1081,BRK,2015-01-09,88,,PHI,L 88-90,240,33,73,.452,30,57,.526,3,16,.188,19,27,.704,88,36,79,.456,28,62,.452,8,17,.471,10,17,.588,90
1082,BRK,2015-01-05,88,,DAL,L 88-96 (OT),265,33,84,.393,30,59,.508,3,25,.120,19,23,.826,88,37,94,.394,27,67,.403,10,27,.370,12,19,.632,96
1083,LAL,2015-01-04,88,,IND,W 88-87,240,27,71,.380,21,53,.396,6,18,.333,28,30,.933,88,33,90,.367,25,62,.403,8,28,.286,13,18,.722,87
1084,MIA,2015-01-04,88,,BRK,W 88-84,240,31,67,.463,26,53,.491,5,14,.357,21,28,.750,88,34,86,.395,27,62,.435,7,24,.292,9,13,.692,84
1085,UTA,2014-12-27,88,,PHI,W 88-71,240,30,84,.357,26,61,.426,4,23,.174,24,28,.857,88,24,74,.324,19,48,.396,5,26,.192,18,28,.643,71
1086,ORL,2014-12-21,88,,PHI,L 88-96,240,35,84,.417,28,61,.459,7,23,.304,11,20,.550,88,35,82,.427,29,59,.492,6,23,.261,20,25,.800,96
1087,NOP,2014-12-20,88,,POR,L 88-114,240,30,85,.353,27,70,.386,3,15,.200,25,28,.893,88,48,90,.533,39,65,.600,9,25,.360,9,15,.600,114
1088,BRK,2014-12-12,88,,PHI,W 88-70,240,36,81,.444,31,61,.508,5,20,.250,11,17,.647,88,22,69,.319,11,41,.268,11,28,.393,15,20,.750,70
1089,BRK,2014-12-08,88,,CLE,L 88-110,240,36,81,.444,32,62,.516,4,19,.211,12,19,.632,88,43,90,.478,34,65,.523,9,25,.360,15,22,.682,110
1090,POR,2014-12-04,88,,IND,W 88-82,240,33,83,.398,29,62,.468,4,21,.190,18,23,.783,88,36,91,.396,31,73,.425,5,18,.278,5,8,.625,82
1091,DET,2014-11-28,88,,MIL,L 88-104,240,34,83,.410,28,60,.467,6,23,.261,14,25,.560,88,39,77,.506,26,48,.542,13,29,.448,13,16,.813,104
1092,BOS,2014-11-23,88,,POR,L 88-94,240,37,95,.389,32,72,.444,5,23,.217,9,12,.750,88,37,86,.430,30,67,.448,7,19,.368,13,15,.867,94
1093,IND,2014-11-19,88,,CHO,W 88-86,240,35,78,.449,33,63,.524,2,15,.133,16,24,.667,88,37,86,.430,32,72,.444,5,14,.357,7,12,.583,86
1094,HOU,2014-11-14,88,,PHI,W 88-87,240,29,78,.372,22,44,.500,7,34,.206,23,37,.622,88,34,80,.425,27,59,.458,7,21,.333,12,18,.667,87
1095,PHO,2015-04-04,87,,UTA,W 87-85,240,30,69,.435,25,55,.455,5,14,.357,22,29,.759,87,29,74,.392,22,53,.415,7,21,.333,20,24,.833,85
1096,CLE,2015-03-29,87,,PHI,W 87-86,240,33,85,.388,24,62,.387,9,23,.391,12,18,.667,87,34,84,.405,24,54,.444,10,30,.333,8,15,.533,86
1097,PHI,2015-03-14,87,,BRK,L 87-94,240,35,94,.372,27,57,.474,8,37,.216,9,14,.643,87,37,84,.440,35,67,.522,2,17,.118,18,26,.692,94
1098,PHO,2015-03-13,87,,ATL,L 87-96,240,32,78,.410,22,52,.423,10,26,.385,13,21,.619,87,39,83,.470,31,65,.477,8,18,.444,10,12,.833,96
1099,UTA,2015-03-10,87,,NYK,W 87-82,240,30,70,.429,24,52,.462,6,18,.333,21,29,.724,87,31,79,.392,26,66,.394,5,13,.385,15,17,.882,82
1100,LAC,2015-02-23,87,,MEM,L 87-90,240,35,79,.443,26,52,.500,9,27,.333,8,12,.667,87,33,81,.407,28,66,.424,5,15,.333,19,26,.731,90
1101,CHI,2015-02-23,87,,MIL,W 87-71,240,27,76,.355,19,50,.380,8,26,.308,25,32,.781,87,30,89,.337,26,71,.366,4,18,.222,7,13,.538,71
1102,NYK,2015-02-20,87,,MIA,L 87-111,240,35,82,.427,29,64,.453,6,18,.333,11,16,.688,87,38,79,.481,29,59,.492,9,20,.450,26,35,.743,111
1103,DAL,2015-02-11,87,,UTA,W 87-82,240,28,75,.373,18,47,.383,10,28,.357,21,26,.808,87,30,80,.375,19,51,.373,11,29,.379,11,21,.524,82
1104,DET,2015-02-11,87,,SAS,L 87-104,240,33,81,.407,24,60,.400,9,21,.429,12,17,.706,87,42,88,.477,32,61,.525,10,27,.370,10,11,.909,104
1105,TOR,2015-02-08,87,,SAS,W 87-82,240,32,74,.432,28,61,.459,4,13,.308,19,24,.792,87,31,93,.333,24,65,.369,7,28,.250,13,16,.813,82
1106,BOS,2015-01-30,87,,HOU,L 87-93,240,32,90,.356,25,66,.379,7,24,.292,16,23,.696,87,35,84,.417,27,54,.500,8,30,.267,15,20,.750,93
1107,LAL,2015-01-25,87,,HOU,L 87-99,240,34,79,.430,33,66,.500,1,13,.077,18,25,.720,87,35,87,.402,22,43,.512,13,44,.295,16,21,.762,99
1108,PHI,2015-01-13,87,,ATL,L 87-105,240,31,76,.408,22,51,.431,9,25,.360,16,25,.640,87,42,87,.483,30,64,.469,12,23,.522,9,16,.563,105
1109,CHO,2015-01-02,87,,CLE,L 87-91,240,32,87,.368,26,59,.441,6,28,.214,17,26,.654,87,33,87,.379,29,72,.403,4,15,.267,21,30,.700,91
1110,MIA,2014-12-23,87,,PHI,L 87-91,240,33,80,.413,25,54,.463,8,26,.308,13,18,.722,87,33,77,.429,28,58,.483,5,19,.263,20,27,.741,91
1111,MIA,2014-12-17,87,,UTA,L 87-105,240,27,70,.386,23,53,.434,4,17,.235,29,40,.725,87,35,66,.530,21,41,.512,14,25,.560,21,24,.875,105
1112,NYK,2014-12-16,87,,DAL,L 87-107,240,37,84,.440,32,63,.508,5,21,.238,8,10,.800,87,42,83,.506,27,50,.540,15,33,.455,8,8,1.000,107
1113,PHI,2014-12-15,87,,BOS,L 87-105,240,33,93,.355,29,65,.446,4,28,.143,17,21,.810,87,38,86,.442,32,61,.525,6,25,.240,23,35,.657,105
1114,CHO,2014-12-13,87,,BRK,L 87-114,240,31,79,.392,23,57,.404,8,22,.364,17,27,.630,87,42,72,.583,26,49,.531,16,23,.696,14,20,.700,114
1115,ATL,2014-12-12,87,,ORL,W 87-81,240,29,78,.372,20,49,.408,9,29,.310,20,27,.741,87,30,77,.390,21,51,.412,9,26,.346,12,16,.750,81
1116,LAL,2014-12-07,87,,NOP,L 87-104,240,36,90,.400,31,71,.437,5,19,.263,10,15,.667,87,43,83,.518,35,65,.538,8,18,.444,10,15,.667,104
1117,NYK,2014-12-04,87,,CLE,L 87-90,240,37,88,.420,29,62,.468,8,26,.308,5,6,.833,87,32,70,.457,27,52,.519,5,18,.278,21,26,.808,90
1118,IND,2014-11-14,87,,DEN,L 87-108,240,34,84,.405,26,62,.419,8,22,.364,11,22,.500,87,43,87,.494,35,64,.547,8,23,.348,14,25,.560,108
1119,HOU,2014-11-08,87,,GSW,L 87-98,240,30,86,.349,20,44,.455,10,42,.238,17,21,.810,87,39,87,.448,30,59,.508,9,28,.321,11,17,.647,98
1120,BRK,2015-04-13,86,,CHI,L 86-113,240,32,87,.368,29,75,.387,3,12,.250,19,22,.864,86,44,88,.500,32,58,.552,12,30,.400,13,17,.765,113
1121,NYK,2015-04-08,86,,IND,L 86-102,240,29,84,.345,22,67,.328,7,17,.412,21,26,.808,86,38,77,.494,34,55,.618,4,22,.182,22,27,.815,102
1122,BOS,2015-03-25,86,,MIA,L 86-93,240,28,69,.406,23,50,.460,5,19,.263,25,37,.676,86,34,77,.442,25,53,.472,9,24,.375,16,23,.696,93
1123,LAL,2015-03-15,86,,ATL,L 86-91,240,34,85,.400,27,67,.403,7,18,.389,11,15,.733,86,34,76,.447,29,53,.547,5,23,.217,18,27,.667,91
1124,NYK,2015-03-07,86,,IND,L 86-92,240,30,78,.385,27,63,.429,3,15,.200,23,30,.767,86,30,79,.380,23,61,.377,7,18,.389,25,30,.833,92
1125,NYK,2015-03-03,86,,SAC,L 86-124,240,30,82,.366,26,60,.433,4,22,.182,22,30,.733,86,41,83,.494,31,65,.477,10,18,.556,32,37,.865,124
1126,CHI,2015-03-01,86,,LAC,L 86-96,240,27,87,.310,17,61,.279,10,26,.385,22,30,.733,86,38,87,.437,31,60,.517,7,27,.259,13,24,.542,96
1127,CHI,2015-02-25,86,,CHO,L 86-98,240,34,77,.442,31,60,.517,3,17,.176,15,23,.652,86,39,84,.464,35,70,.500,4,14,.286,16,21,.762,98
1128,MIL,2015-02-22,86,,ATL,L 86-97,240,32,72,.444,28,56,.500,4,16,.250,18,18,1.000,86,35,87,.402,26,57,.456,9,30,.300,18,21,.857,97
1129,DEN,2015-01-31,86,,CHO,L 86-104,240,33,92,.359,28,68,.412,5,24,.208,15,20,.750,86,44,93,.473,44,82,.537,0,11,.000,16,25,.640,104
1130,PHI,2015-01-23,86,,TOR,L 86-91,240,31,81,.383,22,52,.423,9,29,.310,15,18,.833,86,33,80,.413,27,56,.482,6,24,.250,19,24,.792,91
1131,MIA,2015-01-20,86,,OKC,L 86-94,240,32,68,.471,24,46,.522,8,22,.364,14,19,.737,86,41,92,.446,35,66,.530,6,26,.231,6,10,.600,94
1132,ORL,2014-12-30,86,,DET,L 86-109,240,38,85,.447,34,65,.523,4,20,.200,6,10,.600,86,40,86,.465,26,53,.491,14,33,.424,15,29,.517,109
1133,DET,2014-12-09,86,,POR,L 86-98,240,34,97,.351,29,75,.387,5,22,.227,13,16,.813,86,41,84,.488,32,63,.508,9,21,.429,7,8,.875,98
1134,MIN,2014-12-08,86,,GSW,L 86-102,240,32,88,.364,30,77,.390,2,11,.182,20,29,.690,86,42,91,.462,37,69,.536,5,22,.227,13,14,.929,102
1135,MIN,2014-11-26,86,,MIL,L 86-103,240,31,81,.383,28,67,.418,3,14,.214,21,34,.618,86,40,85,.471,35,69,.507,5,16,.313,18,19,.947,103
1136,OKC,2014-11-23,86,,GSW,L 86-91,240,32,90,.356,29,73,.397,3,17,.176,19,27,.704,86,33,93,.355,26,68,.382,7,25,.280,18,24,.750,91
1137,DET,2014-11-19,86,,PHO,L 86-88,240,33,87,.379,26,62,.419,7,25,.280,13,19,.684,86,37,75,.493,33,60,.550,4,15,.267,10,13,.769,88
1138,MIL,2014-11-05,86,,CHI,L 86-95,240,33,89,.371,30,74,.405,3,15,.200,17,20,.850,86,34,73,.466,29,57,.509,5,16,.313,22,30,.733,95
1139,DEN,2015-03-25,85,,PHI,L 85-99,240,29,84,.345,21,55,.382,8,29,.276,19,27,.704,85,35,84,.417,21,50,.420,14,34,.412,15,22,.682,99
1140,NOP,2015-03-17,85,,MIL,W 85-84,240,29,83,.349,21,58,.362,8,25,.320,19,26,.731,85,32,86,.372,28,66,.424,4,20,.200,16,21,.762,84
1141,BOS,2015-03-04,85,,UTA,W 85-84,240,33,88,.375,25,61,.410,8,27,.296,11,20,.550,85,34,75,.453,31,56,.554,3,19,.158,13,21,.619,84
1142,MIN,2015-03-04,85,,DEN,L 85-100,240,32,82,.390,29,64,.453,3,18,.167,18,25,.720,85,42,92,.457,34,72,.472,8,20,.400,8,10,.800,100
1143,SAC,2015-02-08,85,,PHO,W 85-83,240,34,75,.453,30,63,.476,4,12,.333,13,21,.619,85,33,91,.363,28,63,.444,5,28,.179,12,17,.706,83
1144,MEM,2015-01-31,85,,OKC,W 85-74,240,34,91,.374,31,80,.388,3,11,.273,14,17,.824,85,27,78,.346,21,58,.362,6,20,.300,14,18,.778,74
1145,SAS,2015-01-31,85,,LAC,L 85-105,240,28,75,.373,18,45,.400,10,30,.333,19,28,.679,85,40,91,.440,32,69,.464,8,22,.364,17,18,.944,105
1146,NOP,2015-01-28,85,,DEN,L 85-93,240,32,82,.390,29,67,.433,3,15,.200,18,24,.750,85,39,85,.459,29,68,.426,10,17,.588,5,7,.714,93
1147,NOP,2015-01-05,85,,WAS,L 85-92,240,33,74,.446,27,55,.491,6,19,.316,13,17,.765,85,38,79,.481,36,69,.522,2,10,.200,14,17,.824,92
1148,MIL,2014-12-27,85,,ATL,L 85-90,240,31,80,.388,19,50,.380,12,30,.400,11,14,.786,85,33,90,.367,24,61,.393,9,29,.310,15,19,.789,90
1149,BRK,2014-12-27,85,,IND,L 85-110,240,28,77,.364,21,52,.404,7,25,.280,22,27,.815,85,44,86,.512,35,68,.515,9,18,.500,13,18,.722,110
1150,IND,2014-12-13,85,,POR,L 85-95,240,34,88,.386,30,73,.411,4,15,.267,13,16,.813,85,40,90,.444,35,73,.479,5,17,.294,10,12,.833,95
1151,SAC,2014-11-30,85,,MEM,L 85-97,240,33,70,.471,32,59,.542,1,11,.091,18,27,.667,85,38,79,.481,35,66,.530,3,13,.231,18,28,.643,97
1152,HOU,2014-11-28,85,,LAC,L 85-102,240,32,82,.390,22,45,.489,10,37,.270,11,15,.733,85,38,81,.469,29,56,.518,9,25,.360,17,22,.773,102
1153,MIL,2014-11-11,85,,OKC,W 85-78,240,33,81,.407,30,66,.455,3,15,.200,16,24,.667,85,29,87,.333,23,67,.343,6,20,.300,14,19,.737,78
1154,LAC,2014-11-10,85,,SAS,L 85-89,240,33,74,.446,28,52,.538,5,22,.227,14,17,.824,85,33,83,.398,31,64,.484,2,19,.105,21,27,.778,89
1155,NYK,2014-11-10,85,,ATL,L 85-91,240,36,83,.434,30,57,.526,6,26,.231,7,12,.583,85,27,71,.380,17,44,.386,10,27,.370,27,28,.964,91
1156,MIN,2015-04-03,84,,ORL,L 84-97,240,29,64,.453,28,53,.528,1,11,.091,25,32,.781,84,40,92,.435,34,71,.479,6,21,.286,11,17,.647,97
1157,MIN,2015-03-30,84,,UTA,L 84-104,240,28,76,.368,22,60,.367,6,16,.375,22,27,.815,84,39,82,.476,29,49,.592,10,33,.303,16,18,.889,104
1158,MEM,2015-03-27,84,,GSW,L 84-107,240,34,76,.447,29,63,.460,5,13,.385,11,15,.733,84,39,90,.433,23,59,.390,16,31,.516,13,17,.765,107
1159,UTA,2015-03-18,84,,WAS,L 84-88,240,34,82,.415,30,60,.500,4,22,.182,12,24,.500,84,33,63,.524,27,52,.519,6,11,.545,16,23,.696,88
1160,PHI,2015-02-09,84,,GSW,L 84-89,240,33,79,.418,26,55,.473,7,24,.292,11,14,.786,84,34,85,.400,27,56,.482,7,29,.241,14,19,.737,89
1161,CHI,2015-01-25,84,,MIA,L 84-96,240,31,87,.356,24,63,.381,7,24,.292,15,19,.789,84,38,84,.452,37,71,.521,1,13,.077,19,23,.826,96
1162,MIN,2015-01-23,84,,NOP,L 84-92,240,35,84,.417,33,75,.440,2,9,.222,12,17,.706,84,40,80,.500,37,76,.487,3,4,.750,9,14,.643,92
1163,BRK,2014-11-30,84,,CHI,L 84-102,240,32,86,.372,30,72,.417,2,14,.143,18,24,.750,84,34,69,.493,27,45,.600,7,24,.292,27,34,.794,102
1164,MIA,2014-11-16,84,,MIL,L 84-91,240,30,73,.411,19,48,.396,11,25,.440,13,22,.591,84,35,74,.473,30,56,.536,5,18,.278,16,26,.615,91
1165,MEM,2015-04-04,83,,WAS,L 83-92,240,34,81,.420,33,66,.500,1,15,.067,14,18,.778,83,38,79,.481,30,57,.526,8,22,.364,8,10,.800,92
1166,ORL,2015-03-25,83,,ATL,L 83-95,240,32,78,.410,29,62,.468,3,16,.188,16,20,.800,83,39,90,.433,29,59,.492,10,31,.323,7,10,.700,95
1167,PHI,2015-03-06,83,,UTA,L 83-89,240,32,88,.364,22,56,.393,10,32,.313,9,18,.500,83,27,71,.380,21,59,.356,6,12,.500,29,41,.707,89
1168,ORL,2015-03-01,83,,CHO,L 83-98,240,31,85,.365,25,70,.357,6,15,.400,15,20,.750,83,40,80,.500,32,62,.516,8,18,.444,10,14,.714,98
1169,NYK,2015-02-22,83,,CLE,L 83-101,240,37,99,.374,34,80,.425,3,19,.158,6,7,.857,83,40,79,.506,28,46,.609,12,33,.364,9,15,.600,101
1170,SAC,2015-01-16,83,,MIA,L 83-95,240,32,75,.427,25,59,.424,7,16,.438,12,14,.857,83,35,74,.473,27,57,.474,8,17,.471,17,21,.810,95
1171,WAS,2014-11-29,83,,NOP,W 83-80,240,35,76,.461,30,64,.469,5,12,.417,8,12,.667,83,30,81,.370,24,64,.375,6,17,.353,14,21,.667,80
1172,IND,2014-11-22,83,,PHO,L 83-106,240,31,84,.369,24,61,.393,7,23,.304,14,20,.700,83,38,85,.447,26,54,.481,12,31,.387,18,20,.900,106
1173,BRK,2014-11-17,83,,MIA,L 83-95,240,29,70,.414,20,47,.426,9,23,.391,16,26,.615,83,31,72,.431,22,45,.489,9,27,.333,24,27,.889,95
1174,NYK,2014-11-04,83,,WAS,L 83-98,240,30,81,.370,22,66,.333,8,15,.533,15,19,.789,83,39,80,.488,31,62,.500,8,18,.444,12,19,.632,98
1175,NYK,2015-03-23,82,,MEM,L 82-103,240,32,76,.421,28,58,.483,4,18,.222,14,17,.824,82,41,79,.519,34,67,.507,7,12,.583,14,19,.737,103
1176,MEM,2015-03-03,82,,UTA,L 82-93,240,33,82,.402,30,71,.423,3,11,.273,13,19,.684,82,36,80,.450,31,55,.564,5,25,.200,16,19,.842,93
1177,UTA,2015-02-28,82,,MIL,W 82-75,240,29,76,.382,23,54,.426,6,22,.273,18,23,.783,82,29,74,.392,24,59,.407,5,15,.333,12,14,.857,75
1178,DEN,2015-02-27,82,,UTA,L 82-104,240,28,84,.333,20,52,.385,8,32,.250,18,29,.621,82,39,68,.574,30,47,.638,9,21,.429,17,21,.810,104
1179,DEN,2015-02-23,82,,BRK,L 82-110,240,31,94,.330,24,67,.358,7,27,.259,13,22,.591,82,43,92,.467,39,71,.549,4,21,.190,20,23,.870,110
1180,NYK,2015-01-10,82,,CHO,L 82-110,240,33,85,.388,25,56,.446,8,29,.276,8,9,.889,82,39,78,.500,32,62,.516,7,16,.438,25,33,.758,110
1181,NYK,2015-01-04,82,,MIL,L 82-95,240,31,76,.408,22,51,.431,9,25,.360,11,14,.786,82,35,77,.455,31,61,.508,4,16,.250,21,27,.778,95
1182,CHI,2014-12-30,82,,BRK,L 82-96,240,33,86,.384,25,61,.410,8,25,.320,8,15,.533,82,36,83,.434,30,69,.435,6,14,.429,18,21,.857,96
1183,UTA,2014-11-07,82,,DAL,L 82-105,240,29,68,.426,20,40,.500,9,28,.321,15,19,.789,82,42,88,.477,33,64,.516,9,24,.375,12,14,.857,105
1184,MIA,2015-03-31,81,,SAS,L 81-95,240,32,79,.405,27,64,.422,5,15,.333,12,12,1.000,81,37,74,.500,29,56,.518,8,18,.444,13,17,.765,95
1185,PHO,2015-03-27,81,,POR,L 81-87,240,32,87,.368,26,67,.388,6,20,.300,11,12,.917,81,36,89,.404,29,63,.460,7,26,.269,8,18,.444,87
1186,BRK,2015-01-07,81,,BOS,L 81-89,240,30,74,.405,27,60,.450,3,14,.214,18,26,.692,81,35,88,.398,30,70,.429,5,18,.278,14,17,.824,89
1187,NYK,2015-01-02,81,,DET,L 81-97,240,32,91,.352,22,67,.328,10,24,.417,7,14,.500,81,38,76,.500,25,43,.581,13,33,.394,8,14,.571,97
1188,IND,2014-11-04,81,,MIL,L 81-87,240,31,78,.397,25,54,.463,6,24,.250,13,22,.591,81,37,83,.446,30,62,.484,7,21,.333,6,7,.857,87
1189,NYK,2015-03-25,80,,LAC,L 80-111,240,29,82,.354,24,59,.407,5,23,.217,17,19,.895,80,44,78,.564,33,50,.660,11,28,.393,12,18,.667,111
1190,PHO,2015-03-09,80,,GSW,L 80-98,240,29,77,.377,25,66,.379,4,11,.364,18,23,.783,80,35,83,.422,22,52,.423,13,31,.419,15,19,.789,98
1191,ATL,2015-02-20,80,,TOR,L 80-105,240,29,88,.330,21,50,.420,8,38,.211,14,21,.667,80,43,96,.448,30,66,.455,13,30,.433,6,8,.750,105
1192,CHO,2015-01-17,80,,IND,W 80-71 (OT),265,31,101,.307,29,86,.337,2,15,.133,16,25,.640,80,30,84,.357,28,63,.444,2,21,.095,9,13,.692,71
1193,WAS,2015-01-16,80,,BRK,L 80-102,240,31,73,.425,27,56,.482,4,17,.235,14,16,.875,80,37,81,.457,33,69,.478,4,12,.333,24,31,.774,102
1194,CLE,2014-12-31,80,,MIL,L 80-96,240,29,85,.341,21,54,.389,8,31,.258,14,16,.875,80,40,90,.444,29,65,.446,11,25,.440,5,10,.500,96
1195,CLE,2014-12-28,80,,DET,L 80-103,240,31,82,.378,26,53,.491,5,29,.172,13,17,.765,80,41,91,.451,24,60,.400,17,31,.548,4,9,.444,103
1196,CHO,2014-11-17,80,,DAL,L 80-107,240,32,80,.400,22,58,.379,10,22,.455,6,13,.462,80,43,84,.512,33,56,.589,10,28,.357,11,16,.688,107
1197,LAL,2014-11-14,80,,SAS,L 80-93,240,28,75,.373,26,63,.413,2,12,.167,22,31,.710,80,33,80,.413,23,57,.404,10,23,.435,17,20,.850,93
1198,NYK,2014-10-29,80,,CHI,L 80-104,240,31,85,.365,28,68,.412,3,17,.176,15,17,.882,80,36,71,.507,29,47,.617,7,24,.292,25,30,.833,104
1199,ORL,2015-04-11,79,,NYK,L 79-80,240,30,84,.357,24,62,.387,6,22,.273,13,18,.722,79,31,82,.378,25,62,.403,6,20,.300,12,13,.923,80
1200,MEM,2015-02-27,79,,LAC,L 79-97,240,33,87,.379,30,75,.400,3,12,.250,10,15,.667,79,36,78,.462,27,52,.519,9,26,.346,16,28,.571,97
1201,NYK,2014-11-30,79,,MIA,L 79-86,240,31,88,.352,28,64,.438,3,24,.125,14,20,.700,79,30,72,.417,23,49,.469,7,23,.304,19,31,.613,86
1202,MIA,2015-04-09,78,,CHI,L 78-89,240,34,88,.386,29,70,.414,5,18,.278,5,7,.714,78,35,91,.385,29,68,.426,6,23,.261,13,17,.765,89
1203,LAL,2015-04-05,78,,LAC,L 78-106,240,29,75,.387,22,58,.379,7,17,.412,13,22,.591,78,40,75,.533,25,48,.521,15,27,.556,11,18,.611,106
1204,CHO,2015-02-10,78,,DET,L 78-106,240,29,81,.358,20,57,.351,9,24,.375,11,14,.786,78,37,83,.446,32,64,.500,5,19,.263,27,30,.900,106
1205,SAC,2015-02-05,78,,DAL,L 78-101,240,29,79,.367,26,58,.448,3,21,.143,17,22,.773,78,41,96,.427,29,62,.468,12,34,.353,7,10,.700,101
1206,CHO,2015-01-21,78,,MIA,W 78-76,240,27,80,.338,23,61,.377,4,19,.211,20,30,.667,78,29,84,.345,24,66,.364,5,18,.278,13,15,.867,76
1207,LAL,2015-04-03,77,,POR,L 77-107,240,31,82,.378,26,68,.382,5,14,.357,10,17,.588,77,43,88,.489,33,62,.532,10,26,.385,11,11,1.000,107
1208,CHI,2015-01-07,77,,UTA,L 77-97,240,28,84,.333,22,64,.344,6,20,.300,15,20,.750,77,37,78,.474,32,62,.516,5,16,.313,18,24,.750,97
1209,PHI,2015-01-07,77,,MIL,L 77-97,240,25,83,.301,23,58,.397,2,25,.080,25,29,.862,77,41,76,.539,33,59,.559,8,17,.471,7,11,.636,97
1210,ATL,2014-12-26,77,,MIL,L 77-107,240,31,76,.408,27,53,.509,4,23,.174,11,14,.786,77,40,79,.506,32,60,.533,8,19,.421,19,23,.826,107
1211,MIN,2014-12-03,77,,PHI,L 77-85,240,30,84,.357,27,67,.403,3,17,.176,14,17,.824,77,32,82,.390,27,58,.466,5,24,.208,16,25,.640,85
1212,SAC,2014-10-29,77,,GSW,L 77-95,240,24,78,.308,21,60,.350,3,18,.167,26,35,.743,77,33,75,.440,27,48,.563,6,27,.222,23,32,.719,95
1213,CHO,2015-01-24,76,,NYK,W 76-71,240,25,76,.329,23,69,.333,2,7,.286,24,37,.649,76,28,79,.354,22,64,.344,6,15,.400,9,18,.500,71
1214,DEN,2014-12-20,76,,IND,W 76-73,240,30,82,.366,28,66,.424,2,16,.125,14,19,.737,76,27,88,.307,20,65,.308,7,23,.304,12,17,.706,73
1215,TOR,2015-02-02,75,,MIL,L 75-82,240,25,78,.321,18,51,.353,7,27,.259,18,22,.818,75,33,80,.413,26,64,.406,7,16,.438,9,17,.529,82
1216,BOS,2015-02-01,75,,MIA,L 75-83,240,30,81,.370,26,62,.419,4,19,.211,11,18,.611,75,32,77,.416,28,56,.500,4,21,.190,15,21,.714,83
1217,MIN,2015-01-21,75,,DAL,L 75-98,240,31,89,.348,29,74,.392,2,15,.133,11,15,.733,75,39,76,.513,28,49,.571,11,27,.407,9,14,.643,98
1218,LAL,2015-01-13,75,,MIA,L 75-78,240,29,92,.315,25,69,.362,4,23,.174,13,18,.722,75,33,78,.423,31,62,.500,2,16,.125,10,15,.667,78
1219,MIA,2014-12-14,75,,CHI,L 75-93,240,28,80,.350,24,58,.414,4,22,.182,15,18,.833,75,33,71,.465,24,53,.453,9,18,.500,18,21,.857,93
1220,BRK,2014-12-05,75,,ATL,L 75-98,240,30,80,.375,27,62,.435,3,18,.167,12,19,.632,75,35,81,.432,22,47,.468,13,34,.382,15,24,.625,98
1221,MIA,2014-11-12,75,,IND,L 75-81,240,29,68,.426,20,48,.417,9,20,.450,8,18,.444,75,30,80,.375,22,54,.407,8,26,.308,13,15,.867,81
1222,CHO,2015-04-08,74,,TOR,L 74-92,240,28,81,.346,18,59,.305,10,22,.455,8,11,.727,74,33,77,.429,21,50,.420,12,27,.444,14,19,.737,92
1223,PHO,2015-03-19,74,,NOP,W 74-72,240,29,83,.349,27,61,.443,2,22,.091,14,21,.667,74,31,83,.373,26,65,.400,5,18,.278,5,10,.500,72
1224,PHO,2015-02-28,74,,SAS,L 74-101,240,25,84,.298,20,68,.294,5,16,.313,19,24,.792,74,41,92,.446,37,73,.507,4,19,.211,15,17,.882,101
1225,LAL,2015-03-19,73,,UTA,L 73-80,240,31,77,.403,28,66,.424,3,11,.273,8,17,.471,73,25,62,.403,16,37,.432,9,25,.360,21,31,.677,80
1226,NOP,2015-02-07,72,,CHI,L 72-107,240,32,86,.372,28,69,.406,4,17,.235,4,7,.571,72,43,84,.512,33,62,.532,10,22,.455,11,13,.846,107
1227,MIA,2015-01-30,72,,DAL,L 72-93,240,29,88,.330,20,59,.339,9,29,.310,5,10,.500,72,34,82,.415,21,53,.396,13,29,.448,12,20,.600,93
1228,CHO,2015-03-09,69,,WAS,L 69-95,240,25,77,.325,21,55,.382,4,22,.182,15,20,.750,69,44,85,.518,42,71,.592,2,14,.143,5,5,1.000,95
1229,CHO,2014-11-01,69,,MEM,L 69-71,240,26,72,.361,22,58,.379,4,14,.286,13,18,.722,69,29,80,.363,26,69,.377,3,11,.273,10,13,.769,71
1230,OKC,2014-11-16,65,,HOU,L 65-69,240,20,68,.294,17,49,.347,3,19,.158,22,28,.786,65,23,80,.288,16,45,.356,7,35,.200,16,30,.533,69
