Rk,Team,Date,PTS,,Opp,Result,MP,FG,FGA,FG%,2P,2PA,2P%,3P,3PA,3P%,FT,FTA,FT%,PTS,FG,FGA,FG%,2P,2PA,2P%,3P,3PA,3P%,FT,FTA,FT%,PTS
1,GSW,2016-11-23,149,,LAL,W 149-106,240,53,86,.616,34,50,.680,19,36,.528,24,35,.686,149,40,93,.430,32,73,.438,8,20,.400,18,22,.818,106
2,GSW,2017-01-28,144,,LAC,W 144-98,240,57,92,.620,40,58,.690,17,34,.500,13,16,.813,144,36,82,.439,24,54,.444,12,28,.429,14,22,.636,98
3,HOU,2017-02-25,142,,MIN,W 142-130,240,44,94,.468,22,36,.611,22,58,.379,32,42,.762,142,49,94,.521,40,68,.588,9,26,.346,23,28,.821,130
4,ATL,2017-01-29,142,,NYK,W 142-139 (4OT),340,52,119,.437,42,88,.477,10,31,.323,28,40,.700,142,51,128,.398,33,77,.429,18,51,.353,19,23,.826,139
5,GSW,2016-12-05,142,,IND,W 142-106,240,54,104,.519,40,67,.597,14,37,.378,20,26,.769,142,35,85,.412,32,70,.457,3,15,.200,33,35,.943,106
6,DEN,2017-01-12,140,,IND,W 140-112,240,52,90,.578,37,58,.638,15,32,.469,21,23,.913,140,44,94,.468,32,65,.492,12,29,.414,12,13,.923,112
7,HOU,2016-12-30,140,,LAC,W 140-116,240,45,81,.556,31,41,.756,14,40,.350,36,43,.837,140,45,96,.469,32,63,.508,13,33,.394,13,16,.813,116
8,GSW,2017-04-02,139,,WAS,W 139-115,240,50,88,.568,34,52,.654,16,36,.444,23,26,.885,139,43,92,.467,33,65,.508,10,27,.370,19,25,.760,115
9,HOU,2017-03-15,139,,LAL,W 139-100,240,50,91,.549,32,48,.667,18,43,.419,21,32,.656,139,42,91,.462,39,66,.591,3,25,.120,13,18,.722,100
10,GSW,2016-12-03,138,,PHO,W 138-109,240,49,78,.628,35,57,.614,14,21,.667,26,34,.765,138,41,91,.451,30,59,.508,11,32,.344,16,21,.762,109
11,HOU,2017-03-26,137,,OKC,W 137-125,240,50,79,.633,30,40,.750,20,39,.513,17,21,.810,137,47,94,.500,36,64,.563,11,30,.367,20,28,.714,125
12,PHO,2017-02-15,137,,LAL,W 137-101,240,49,88,.557,39,64,.609,10,24,.417,29,34,.853,137,35,93,.376,26,67,.388,9,26,.346,22,28,.786,101
13,CLE,2016-11-23,137,,POR,W 137-125,240,48,90,.533,27,54,.500,21,36,.583,20,27,.741,137,47,90,.522,34,61,.557,13,29,.448,18,19,.947,125
14,CLE,2017-04-02,135,,IND,W 135-130 (2OT),290,47,95,.495,29,52,.558,18,43,.419,23,33,.697,135,48,105,.457,32,64,.500,16,41,.390,18,20,.900,130
15,WAS,2017-02-06,135,,CLE,L 135-140 (OT),265,50,99,.505,38,70,.543,12,29,.414,23,26,.885,135,49,92,.533,30,54,.556,19,38,.500,23,28,.821,140
16,GSW,2016-12-17,135,,POR,W 135-90,240,51,87,.586,37,59,.627,14,28,.500,19,26,.731,135,34,86,.395,26,58,.448,8,28,.286,14,20,.700,90
17,SAS,2017-01-12,134,,LAL,W 134-94,240,49,81,.605,39,60,.650,10,21,.476,26,29,.897,134,35,85,.412,29,65,.446,6,20,.300,18,25,.720,94
18,HOU,2016-12-07,134,,LAL,W 134-95,240,51,94,.543,36,58,.621,15,36,.417,17,21,.810,134,34,87,.391,29,67,.433,5,20,.250,22,27,.815,95
19,LAC,2017-03-29,133,,WAS,W 133-124,240,47,83,.566,35,53,.660,12,30,.400,27,37,.730,133,46,93,.495,33,59,.559,13,34,.382,19,29,.655,124
20,HOU,2017-02-11,133,,PHO,W 133-102,240,42,85,.494,24,49,.490,18,36,.500,31,39,.795,133,37,94,.394,29,72,.403,8,22,.364,20,26,.769,102
21,LAC,2016-12-10,133,,NOP,W 133-105,240,54,94,.574,37,58,.638,17,36,.472,8,9,.889,133,40,83,.482,32,64,.500,8,19,.421,17,26,.654,105
22,GSW,2016-11-13,133,,PHO,W 133-120,240,45,87,.517,29,54,.537,16,33,.485,27,31,.871,133,46,90,.511,38,66,.576,8,24,.333,20,26,.769,120
23,DEN,2017-02-13,132,,GSW,W 132-110,240,48,88,.545,24,47,.511,24,41,.585,12,16,.750,132,45,92,.489,37,60,.617,8,32,.250,12,13,.923,110
24,TOR,2017-01-13,132,,BRK,W 132-113,240,52,97,.536,41,69,.594,11,28,.393,17,21,.810,132,40,86,.465,23,50,.460,17,36,.472,16,20,.800,113
25,DEN,2016-12-15,132,,POR,W 132-120,240,43,84,.512,28,53,.528,15,31,.484,31,35,.886,132,41,88,.466,33,65,.508,8,23,.348,30,36,.833,120
26,HOU,2016-12-14,132,,SAC,W 132-98,240,50,85,.588,28,43,.651,22,42,.524,10,16,.625,132,39,92,.424,28,60,.467,11,32,.344,9,11,.818,98
27,NOP,2017-04-04,131,,DEN,L 131-134,240,51,100,.510,37,68,.544,14,32,.438,15,17,.882,131,53,99,.535,40,69,.580,13,30,.433,15,21,.714,134
28,TOR,2017-03-27,131,,ORL,W 131-112,240,49,83,.590,39,68,.574,10,15,.667,23,35,.657,131,43,88,.489,39,68,.574,4,20,.200,22,28,.786,112
29,HOU,2016-12-26,131,,PHO,W 131-115,240,46,92,.500,31,49,.633,15,43,.349,24,30,.800,131,43,101,.426,36,71,.507,7,30,.233,22,27,.815,115
30,POR,2016-11-30,131,,IND,W 131-109,240,51,94,.543,39,62,.629,12,32,.375,17,19,.895,131,36,72,.500,30,58,.517,6,14,.429,31,35,.886,109
31,POR,2017-04-01,130,,PHO,W 130-117,240,43,92,.467,28,55,.509,15,37,.405,29,31,.935,130,44,84,.524,41,74,.554,3,10,.300,26,32,.813,117
32,LAL,2017-03-24,130,,MIN,W 130-119 (OT),265,46,88,.523,32,65,.492,14,23,.609,24,28,.857,130,46,95,.484,39,74,.527,7,21,.333,20,22,.909,119
33,BOS,2017-03-24,130,,PHO,W 130-120,240,44,94,.468,30,53,.566,14,41,.341,28,35,.800,130,39,86,.453,33,67,.493,6,19,.316,36,49,.735,120
34,POR,2017-03-04,130,,BRK,W 130-116,240,49,86,.570,33,61,.541,16,25,.640,16,22,.727,130,45,86,.523,31,56,.554,14,30,.467,12,17,.706,116
35,ATL,2017-03-03,130,,CLE,L 130-135,240,49,91,.538,39,65,.600,10,26,.385,22,30,.733,130,47,86,.547,22,40,.550,25,46,.543,16,20,.800,135
36,MEM,2017-02-28,130,,PHO,W 130-112,240,48,86,.558,36,61,.590,12,25,.480,22,29,.759,130,43,83,.518,36,62,.581,7,21,.333,19,24,.792,112
37,MIA,2016-12-20,130,,ORL,L 130-136 (2OT),290,50,108,.463,38,78,.487,12,30,.400,18,26,.692,130,52,105,.495,41,83,.494,11,22,.500,21,31,.677,136
38,SAS,2016-12-10,130,,BRK,W 130-101,240,50,94,.532,36,68,.529,14,26,.538,16,18,.889,130,36,87,.414,29,60,.483,7,27,.259,22,25,.880,101
39,IND,2016-10-26,130,,DAL,W 130-121 (OT),265,47,93,.505,37,74,.500,10,19,.526,26,34,.765,130,45,104,.433,27,56,.482,18,48,.375,13,18,.722,121
40,SAC,2017-04-11,129,,PHO,W 129-104,240,43,83,.518,34,64,.531,9,19,.474,34,43,.791,129,41,109,.376,33,79,.418,8,30,.267,14,24,.583,104
41,WAS,2017-03-24,129,,BRK,W 129-108,240,49,97,.505,39,71,.549,10,26,.385,21,22,.955,129,43,82,.524,40,67,.597,3,15,.200,19,26,.731,108
42,DEN,2017-03-16,129,,LAC,W 129-114,240,46,86,.535,31,58,.534,15,28,.536,22,26,.846,129,44,84,.524,28,52,.538,16,32,.500,10,15,.667,114
43,DEN,2017-03-13,129,,LAL,W 129-101,240,45,84,.536,28,46,.609,17,38,.447,22,25,.880,129,42,97,.433,36,77,.468,6,20,.300,11,19,.579,101
44,DEN,2017-02-24,129,,BRK,W 129-109,240,49,97,.505,35,66,.530,14,31,.452,17,24,.708,129,41,83,.494,31,53,.585,10,30,.333,17,31,.548,109
45,MIN,2017-01-28,129,,BRK,W 129-109,240,47,93,.505,38,73,.521,9,20,.450,26,32,.813,129,41,85,.482,34,64,.531,7,21,.333,20,25,.800,109
46,HOU,2016-12-31,129,,NYK,W 129-122,240,42,92,.457,21,37,.568,21,55,.382,24,29,.828,129,47,105,.448,37,73,.507,10,32,.313,18,25,.720,122
47,DEN,2016-11-25,129,,OKC,L 129-132 (OT),265,48,101,.475,36,67,.537,12,34,.353,21,27,.778,129,48,96,.500,35,70,.500,13,26,.500,23,29,.793,132
48,SAC,2017-04-09,128,,HOU,L 128-135,240,47,94,.500,38,63,.603,9,31,.290,25,30,.833,128,45,80,.563,27,37,.730,18,43,.419,27,31,.871,135
49,NOP,2017-03-17,128,,HOU,W 128-112,240,49,92,.533,37,58,.638,12,34,.353,18,24,.750,128,37,91,.407,24,51,.471,13,40,.325,25,32,.781,112
50,CLE,2017-03-14,128,,DET,W 128-96,240,46,77,.597,27,47,.574,19,30,.633,17,23,.739,128,37,99,.374,33,80,.413,4,19,.211,18,19,.947,96
51,CHI,2017-02-24,128,,PHO,W 128-121 (OT),265,46,98,.469,34,72,.472,12,26,.462,24,31,.774,128,49,93,.527,41,69,.594,8,24,.333,15,25,.600,121
52,HOU,2017-02-07,128,,ORL,W 128-104,240,44,89,.494,28,51,.549,16,38,.421,24,36,.667,128,42,88,.477,36,63,.571,6,25,.240,14,20,.700,104
53,BOS,2017-01-27,128,,ORL,W 128-98,240,50,89,.562,34,55,.618,16,34,.471,12,15,.800,128,38,87,.437,29,62,.468,9,25,.360,13,18,.722,98
54,TOR,2016-12-03,128,,ATL,W 128-84,240,53,92,.576,40,68,.588,13,24,.542,9,11,.818,128,35,88,.398,28,60,.467,7,28,.250,7,14,.500,84
55,CLE,2016-11-25,128,,DAL,W 128-90,240,43,85,.506,23,42,.548,20,43,.465,22,24,.917,128,37,91,.407,29,56,.518,8,35,.229,8,12,.667,90
56,CLE,2016-11-03,128,,BOS,W 128-122,240,41,84,.488,27,50,.540,14,34,.412,32,37,.865,128,46,96,.479,35,64,.547,11,32,.344,19,22,.864,122
57,CLE,2016-11-01,128,,HOU,W 128-120,240,43,83,.518,27,51,.529,16,32,.500,26,31,.839,128,43,90,.478,26,46,.565,17,44,.386,17,25,.680,120
58,PHO,2017-03-07,127,,WAS,L 127-131,240,44,88,.500,31,61,.508,13,27,.481,26,33,.788,127,41,90,.456,34,72,.472,7,18,.389,42,53,.792,131
59,DEN,2017-01-26,127,,PHO,W 127-120,240,44,86,.512,35,63,.556,9,23,.391,30,35,.857,127,48,89,.539,38,65,.585,10,24,.417,14,17,.824,120
60,MIL,2017-01-23,127,,HOU,W 127-114,240,47,80,.588,36,57,.632,11,23,.478,22,27,.815,127,39,77,.506,25,42,.595,14,35,.400,22,28,.786,114
61,GSW,2017-01-12,127,,DET,W 127-107,240,50,89,.562,35,60,.583,15,29,.517,12,18,.667,127,43,88,.489,37,60,.617,6,28,.214,15,20,.750,107
62,LAL,2017-01-06,127,,MIA,W 127-100,240,48,96,.500,38,68,.559,10,28,.357,21,29,.724,127,38,92,.413,30,60,.500,8,32,.250,16,27,.593,100
63,GSW,2017-01-02,127,,DEN,W 127-119,240,50,95,.526,39,70,.557,11,25,.440,16,21,.762,127,48,101,.475,39,66,.591,9,35,.257,14,18,.778,119
64,DEN,2016-12-17,127,,NYK,W 127-114,240,50,90,.556,40,63,.635,10,27,.370,17,29,.586,127,35,80,.438,27,57,.474,8,23,.348,36,39,.923,114
65,GSW,2016-12-01,127,,HOU,L 127-132 (2OT),290,43,104,.413,31,60,.517,12,44,.273,29,37,.784,127,48,108,.444,34,64,.531,14,44,.318,22,30,.733,132
66,BRK,2016-11-29,127,,LAC,W 127-122 (2OT),290,45,104,.433,32,66,.485,13,38,.342,24,36,.667,127,46,109,.422,33,69,.478,13,40,.325,17,22,.773,122
67,LAC,2016-11-14,127,,BRK,W 127-95,240,48,90,.533,34,65,.523,14,25,.560,17,21,.810,127,34,77,.442,24,44,.545,10,33,.303,17,22,.773,95
68,ATL,2017-04-09,126,,CLE,W 126-125 (OT),265,44,94,.468,35,63,.556,9,31,.290,29,37,.784,126,45,98,.459,26,52,.500,19,46,.413,16,20,.800,125
69,BRK,2017-03-23,126,,PHO,W 126-98,240,43,95,.453,35,66,.530,8,29,.276,32,42,.762,126,34,93,.366,27,68,.397,7,25,.280,23,34,.676,98
70,DEN,2017-03-22,126,,CLE,W 126-113,240,51,96,.531,40,70,.571,11,26,.423,13,13,1.000,126,43,85,.506,28,48,.583,15,37,.405,12,14,.857,113
71,GSW,2017-02-01,126,,CHO,W 126-111,240,47,96,.490,26,48,.542,21,48,.438,11,14,.786,126,39,88,.443,30,57,.526,9,31,.290,24,26,.923,111
72,GSW,2017-01-16,126,,CLE,W 126-91,240,46,91,.505,31,57,.544,15,34,.441,19,24,.792,126,31,88,.352,22,54,.407,9,34,.265,20,27,.741,91
73,SAC,2016-12-20,126,,POR,W 126-121,240,40,72,.556,30,49,.612,10,23,.435,36,43,.837,126,44,86,.512,40,58,.690,4,28,.143,29,40,.725,121
74,OKC,2016-11-30,126,,WAS,W 126-115 (OT),265,46,95,.484,34,65,.523,12,30,.400,22,31,.710,126,44,98,.449,34,70,.486,10,28,.357,17,26,.654,115
75,HOU,2016-11-17,126,,POR,W 126-109,240,46,95,.484,32,63,.508,14,32,.438,20,25,.800,126,41,90,.456,31,62,.500,10,28,.357,17,21,.810,109
76,LAC,2017-04-10,125,,HOU,W 125-96,240,46,91,.505,36,65,.554,10,26,.385,23,28,.821,125,33,84,.393,24,44,.545,9,40,.225,21,27,.778,96
77,HOU,2017-03-20,125,,DEN,W 125-124,240,45,89,.506,28,51,.549,17,38,.447,18,23,.783,125,44,86,.512,32,57,.561,12,29,.414,24,26,.923,124
78,MIA,2017-03-01,125,,PHI,W 125-98,240,49,90,.544,36,60,.600,13,30,.433,14,21,.667,125,37,85,.435,31,68,.456,6,17,.353,18,22,.818,98
79,BRK,2017-02-15,125,,MIL,L 125-129,240,46,88,.523,32,52,.615,14,36,.389,19,23,.826,125,50,88,.568,43,73,.589,7,15,.467,22,32,.688,129
80,CLE,2017-02-11,125,,DEN,W 125-109,240,46,84,.548,31,54,.574,15,30,.500,18,22,.818,125,39,97,.402,27,60,.450,12,37,.324,19,22,.864,109
81,MIA,2017-02-04,125,,PHI,W 125-102,240,48,82,.585,36,60,.600,12,22,.545,17,23,.739,125,35,84,.417,29,61,.475,6,23,.261,26,31,.839,102
82,CLE,2017-02-01,125,,MIN,W 125-97,240,48,89,.539,33,52,.635,15,37,.405,14,22,.636,125,41,94,.436,34,73,.466,7,21,.333,8,10,.800,97
83,DEN,2017-01-16,125,,ORL,W 125-112,240,52,89,.584,43,62,.694,9,27,.333,12,15,.800,125,45,88,.511,37,63,.587,8,25,.320,14,18,.778,112
84,GSW,2017-01-04,125,,POR,W 125-117,240,44,87,.506,31,51,.608,13,36,.361,24,29,.828,125,40,89,.449,28,63,.444,12,26,.462,25,28,.893,117
85,LAL,2016-11-15,125,,BRK,W 125-118,240,41,92,.446,32,64,.500,9,28,.321,34,43,.791,125,45,99,.455,33,58,.569,12,41,.293,16,20,.800,118
86,MIN,2016-11-13,125,,LAL,W 125-99,240,42,80,.525,29,53,.547,13,27,.481,28,42,.667,125,33,71,.465,25,47,.532,8,24,.333,25,30,.833,99
87,MIL,2016-11-03,125,,IND,W 125-107,240,47,82,.573,35,55,.636,12,27,.444,19,24,.792,125,38,81,.469,28,58,.483,10,23,.435,21,27,.778,107
88,MIA,2017-04-10,124,,CLE,W 124-121 (OT),265,44,95,.463,32,62,.516,12,33,.364,24,34,.706,124,44,89,.494,30,54,.556,14,35,.400,19,22,.864,121
89,PHO,2017-04-09,124,,DAL,W 124-111,240,44,80,.550,36,61,.590,8,19,.421,28,32,.875,124,41,97,.423,25,52,.481,16,45,.356,13,19,.684,111
90,POR,2017-03-11,124,,WAS,L 124-125 (OT),265,48,94,.511,32,62,.516,16,32,.500,12,16,.750,124,47,90,.522,35,65,.538,12,25,.480,19,28,.679,125
91,LAC,2017-02-26,124,,CHO,W 124-121 (OT),265,45,97,.464,35,65,.538,10,32,.313,24,34,.706,124,38,80,.475,20,40,.500,18,40,.450,27,30,.900,121
92,CLE,2017-01-27,124,,BRK,W 124-116,240,49,92,.533,36,56,.643,13,36,.361,13,20,.650,124,43,87,.494,27,54,.500,16,33,.485,14,16,.875,116
93,NOP,2017-01-23,124,,CLE,W 124-122,240,43,87,.494,27,48,.563,16,39,.410,22,30,.733,124,43,93,.462,28,56,.500,15,37,.405,21,25,.840,122
94,POR,2017-01-08,124,,DET,L 124-125 (2OT),290,51,98,.520,36,63,.571,15,35,.429,7,12,.583,124,54,105,.514,46,80,.575,8,25,.320,9,12,.750,125
95,CLE,2016-12-29,124,,BOS,W 124-118,240,43,83,.518,29,45,.644,14,38,.368,24,33,.727,124,43,85,.506,31,48,.646,12,37,.324,20,21,.952,118
96,TOR,2016-12-08,124,,MIN,W 124-110,240,43,87,.494,31,60,.517,12,27,.444,26,33,.788,124,45,88,.511,36,60,.600,9,28,.321,11,15,.733,110
97,OKC,2016-11-18,124,,BRK,W 124-105,240,49,89,.551,42,63,.667,7,26,.269,19,24,.792,124,35,83,.422,24,54,.444,11,29,.379,24,30,.800,105
98,POR,2016-11-08,124,,PHO,W 124-121,240,45,81,.556,31,50,.620,14,31,.452,20,28,.714,124,43,86,.500,36,65,.554,7,21,.333,28,33,.848,121
99,HOU,2017-04-12,123,,MIN,W 123-118,240,45,97,.464,26,41,.634,19,56,.339,14,22,.636,123,48,91,.527,37,68,.544,11,23,.478,11,15,.733,118
100,GSW,2017-04-08,123,,NOP,W 123-101,240,49,96,.510,39,63,.619,10,33,.303,15,16,.938,123,42,86,.488,37,65,.569,5,21,.238,12,19,.632,101
101,ATL,2017-04-06,123,,BOS,W 123-116,240,44,89,.494,33,66,.500,11,23,.478,24,34,.706,123,37,90,.411,22,47,.468,15,43,.349,27,34,.794,116
102,NOP,2017-03-19,123,,MIN,W 123-109,240,49,90,.544,35,60,.583,14,30,.467,11,15,.733,123,44,86,.512,35,61,.574,9,25,.360,12,17,.706,109
103,MIA,2017-03-17,123,,MIN,W 123-105,240,50,85,.588,42,59,.712,8,26,.308,15,19,.789,123,41,82,.500,39,70,.557,2,12,.167,21,22,.955,105
104,HOU,2017-03-04,123,,MEM,W 123-108,240,39,78,.500,21,36,.583,18,42,.429,27,36,.750,123,43,97,.443,35,69,.507,8,28,.286,14,21,.667,108
105,GSW,2017-02-23,123,,LAC,W 123-113,240,43,81,.531,30,56,.536,13,25,.520,24,26,.923,123,38,93,.409,27,65,.415,11,28,.393,26,37,.703,113
106,NYK,2017-02-10,123,,DEN,L 123-131,240,52,93,.559,36,55,.655,16,38,.421,3,5,.600,123,54,95,.568,38,63,.603,16,32,.500,7,10,.700,131
107,GSW,2017-02-08,123,,CHI,W 123-92,240,48,85,.565,33,57,.579,15,28,.536,12,13,.923,123,37,92,.402,33,68,.485,4,24,.167,14,19,.737,92
108,WAS,2017-01-24,123,,BOS,W 123-108,240,48,84,.571,39,64,.609,9,20,.450,18,21,.857,123,38,84,.452,28,51,.549,10,33,.303,22,24,.917,108
109,DEN,2017-01-21,123,,LAC,W 123-98,240,46,87,.529,36,63,.571,10,24,.417,21,26,.808,123,40,96,.417,30,64,.469,10,32,.313,8,8,1.000,98
110,BOS,2017-01-21,123,,POR,L 123-127 (OT),265,42,92,.457,29,57,.509,13,35,.371,26,31,.839,123,43,92,.467,33,67,.493,10,25,.400,31,36,.861,127
111,IND,2017-01-07,123,,NYK,W 123-109,240,43,86,.500,32,62,.516,11,24,.458,26,28,.929,123,40,87,.460,28,56,.500,12,31,.387,17,24,.708,109
112,CHI,2017-01-07,123,,TOR,W 123-118 (OT),265,38,97,.392,27,69,.391,11,28,.393,36,39,.923,123,37,85,.435,29,54,.537,8,31,.258,36,43,.837,118
113,CHO,2017-01-04,123,,OKC,W 123-112,240,37,80,.463,28,56,.500,9,24,.375,40,49,.816,123,42,96,.438,33,66,.500,9,30,.300,19,23,.826,112
114,MIL,2016-12-23,123,,WAS,W 123-96,240,45,80,.563,36,55,.655,9,25,.360,24,27,.889,123,37,79,.468,30,55,.545,7,24,.292,15,18,.833,96
115,PHO,2016-12-23,123,,PHI,W 123-116,240,42,79,.532,30,53,.566,12,26,.462,27,37,.730,123,42,83,.506,29,52,.558,13,31,.419,19,22,.864,116
116,LAC,2016-11-21,123,,TOR,W 123-115,240,39,74,.527,29,49,.592,10,25,.400,35,42,.833,123,40,80,.500,32,61,.525,8,19,.421,27,32,.844,115
117,CHI,2017-04-10,122,,ORL,W 122-75,240,48,89,.539,36,63,.571,12,26,.462,14,16,.875,122,29,84,.345,24,57,.421,5,27,.185,12,16,.750,75
118,DEN,2017-04-07,122,,NOP,W 122-106,240,43,78,.551,30,46,.652,13,32,.406,23,32,.719,122,47,99,.475,44,76,.579,3,23,.130,9,13,.692,106
119,CLE,2017-04-04,122,,ORL,W 122-102,240,44,82,.537,26,46,.565,18,36,.500,16,21,.762,122,33,86,.384,22,53,.415,11,33,.333,25,26,.962,102
120,CLE,2017-03-31,122,,PHI,W 122-105,240,50,95,.526,37,66,.561,13,29,.448,9,16,.563,122,40,82,.488,29,49,.592,11,33,.333,14,19,.737,105
121,CHO,2017-03-31,122,,DEN,W 122-114,240,40,86,.465,23,50,.460,17,36,.472,25,30,.833,122,45,90,.500,29,57,.509,16,33,.485,8,11,.727,114
122,POR,2017-03-28,122,,DEN,W 122-113,240,45,91,.495,37,64,.578,8,27,.296,24,33,.727,122,44,94,.468,35,64,.547,9,30,.300,16,20,.800,113
123,OKC,2017-03-22,122,,PHI,W 122-97,240,48,88,.545,44,72,.611,4,16,.250,22,30,.733,122,37,87,.425,29,62,.468,8,25,.320,15,17,.882,97
124,TOR,2017-03-21,122,,CHI,W 122-120 (OT),265,47,95,.495,39,72,.542,8,23,.348,20,27,.741,122,42,90,.467,28,53,.528,14,37,.378,22,27,.815,120
125,GSW,2017-03-16,122,,ORL,W 122-92,240,50,87,.575,40,61,.656,10,26,.385,12,23,.522,122,35,94,.372,28,67,.418,7,27,.259,15,21,.714,92
126,CHO,2017-03-11,122,,NOP,L 122-125 (OT),265,46,102,.451,33,56,.589,13,46,.283,17,20,.850,122,50,99,.505,36,65,.554,14,34,.412,11,16,.688,125
127,SAC,2017-03-10,122,,WAS,L 122-130 (OT),265,44,92,.478,32,69,.464,12,23,.522,22,28,.786,122,52,104,.500,43,78,.551,9,26,.346,17,19,.895,130
128,DAL,2017-03-07,122,,LAL,W 122-111,240,45,83,.542,28,52,.538,17,31,.548,15,19,.789,122,42,90,.467,31,60,.517,11,30,.367,16,22,.727,111
129,PHI,2017-01-30,122,,SAC,W 122-119,240,45,83,.542,34,52,.654,11,31,.355,21,26,.808,122,41,74,.554,28,45,.622,13,29,.448,24,29,.828,119
130,DAL,2017-01-22,122,,LAL,W 122-73,240,43,87,.494,26,48,.542,17,39,.436,19,19,1.000,122,28,73,.384,25,52,.481,3,21,.143,14,17,.824,73
131,SAS,2017-01-17,122,,MIN,W 122-114,240,43,84,.512,35,66,.530,8,18,.444,28,35,.800,122,36,73,.493,30,60,.500,6,13,.462,36,41,.878,114
132,TOR,2017-01-08,122,,HOU,L 122-129,240,42,78,.538,31,53,.585,11,25,.440,27,30,.900,122,46,89,.517,35,51,.686,11,38,.289,26,31,.839,129
133,DEN,2016-12-30,122,,PHI,L 122-124,240,39,84,.464,28,57,.491,11,27,.407,33,41,.805,122,38,87,.437,22,54,.407,16,33,.485,32,40,.800,124
134,HOU,2016-12-16,122,,NOP,W 122-100,240,42,94,.447,18,33,.545,24,61,.393,14,19,.737,122,40,98,.408,31,71,.437,9,27,.333,11,20,.550,100
135,WAS,2016-12-16,122,,DET,W 122-108,240,44,77,.571,32,52,.615,12,25,.480,22,27,.815,122,42,86,.488,32,58,.552,10,28,.357,14,21,.667,108
136,HOU,2016-12-12,122,,BRK,W 122-118,240,42,91,.462,25,48,.521,17,43,.395,21,36,.583,122,42,80,.525,35,60,.583,7,20,.350,27,36,.750,118
137,TOR,2016-12-12,122,,MIL,W 122-100,240,42,81,.519,28,56,.500,14,25,.560,24,28,.857,122,42,89,.472,38,65,.585,4,24,.167,12,17,.706,100
138,TOR,2016-11-28,122,,PHI,W 122-95,240,42,77,.545,29,58,.500,13,19,.684,25,31,.806,122,36,86,.419,22,52,.423,14,34,.412,9,13,.692,95
139,POR,2016-11-11,122,,SAC,W 122-120 (OT),265,45,86,.523,32,53,.604,13,33,.394,19,27,.704,122,43,88,.489,37,67,.552,6,21,.286,28,35,.800,120
140,IND,2016-11-09,122,,PHI,W 122-115 (OT),265,49,90,.544,40,71,.563,9,19,.474,15,20,.750,122,46,95,.484,32,59,.542,14,36,.389,9,19,.474,115
141,CHO,2016-11-07,122,,IND,W 122-100,240,41,84,.488,29,52,.558,12,32,.375,28,32,.875,122,40,94,.426,31,61,.508,9,33,.273,11,15,.733,100
142,GSW,2016-11-03,122,,OKC,W 122-96,240,46,89,.517,32,59,.542,14,30,.467,16,20,.800,122,35,87,.402,25,60,.417,10,27,.370,16,28,.571,96
143,BOS,2016-10-26,122,,BRK,W 122-117,240,48,89,.539,37,57,.649,11,32,.344,15,18,.833,122,43,97,.443,28,53,.528,15,44,.341,16,20,.800,117
144,GSW,2017-04-04,121,,MIN,W 121-107,240,44,84,.524,30,52,.577,14,32,.438,19,24,.792,121,41,96,.427,37,77,.481,4,19,.211,21,26,.808,107
145,BRK,2017-04-01,121,,ORL,W 121-111,240,50,94,.532,42,63,.667,8,31,.258,13,16,.813,121,45,91,.495,35,66,.530,10,25,.400,11,15,.733,111
146,NOP,2017-03-29,121,,DAL,W 121-118,240,42,84,.500,30,54,.556,12,30,.400,25,33,.758,121,44,91,.484,30,64,.469,14,27,.519,16,17,.941,118
147,CHO,2017-03-10,121,,ORL,W 121-81,240,47,79,.595,37,58,.638,10,21,.476,17,20,.850,121,31,76,.408,26,49,.531,5,27,.185,14,22,.636,81
148,OKC,2017-03-07,121,,POR,L 121-126,240,44,85,.518,34,60,.567,10,25,.400,23,30,.767,121,47,85,.553,36,62,.581,11,23,.478,21,27,.778,126
149,DET,2017-02-08,121,,LAL,W 121-102,240,51,97,.526,47,81,.580,4,16,.250,15,24,.625,121,37,86,.430,31,63,.492,6,23,.261,22,26,.846,102
150,SAS,2017-02-04,121,,DEN,W 121-97,240,45,79,.570,35,58,.603,10,21,.476,21,26,.808,121,41,92,.446,31,66,.470,10,26,.385,5,10,.500,97
151,DEN,2017-02-03,121,,MIL,W 121-117,240,40,89,.449,31,61,.508,9,28,.321,32,44,.727,121,45,83,.542,36,59,.610,9,24,.375,18,23,.783,117
152,HOU,2017-02-03,121,,CHI,W 121-117 (OT),265,44,98,.449,28,55,.509,16,43,.372,17,25,.680,121,48,100,.480,40,75,.533,8,25,.320,13,18,.722,117
153,CHI,2017-01-29,121,,PHI,W 121-108,240,45,89,.506,37,75,.493,8,14,.571,23,28,.821,121,44,99,.444,34,71,.479,10,28,.357,10,14,.714,108
154,PHI,2017-01-24,121,,LAC,W 121-110,240,45,90,.500,35,61,.574,10,29,.345,21,22,.955,121,33,71,.465,15,37,.405,18,34,.529,26,41,.634,110
155,GSW,2017-01-18,121,,OKC,W 121-100,240,46,85,.541,36,64,.563,10,21,.476,19,27,.704,121,38,90,.422,30,62,.484,8,28,.286,16,19,.842,100
156,LAL,2017-01-17,121,,DEN,L 121-127,240,47,108,.435,36,78,.462,11,30,.367,16,18,.889,121,50,88,.568,39,62,.629,11,26,.423,16,26,.615,127
157,HOU,2017-01-10,121,,CHO,W 121-114,240,40,82,.488,23,43,.535,17,39,.436,24,33,.727,121,44,92,.478,25,49,.510,19,43,.442,7,9,.778,114
158,OKC,2017-01-07,121,,DEN,W 121-106,240,43,89,.483,31,53,.585,12,36,.333,23,29,.793,121,40,99,.404,31,75,.413,9,24,.375,17,24,.708,106
159,IND,2017-01-05,121,,BRK,W 121-109,240,48,93,.516,38,71,.535,10,22,.455,15,19,.789,121,41,90,.456,24,52,.462,17,38,.447,10,13,.769,109
160,GSW,2016-12-28,121,,TOR,W 121-111,240,46,81,.568,32,58,.552,14,23,.609,15,18,.833,121,40,103,.388,27,68,.397,13,35,.371,18,22,.818,111
161,TOR,2016-12-16,121,,ATL,L 121-125,240,47,86,.547,37,65,.569,10,21,.476,17,26,.654,121,46,86,.535,35,61,.574,11,25,.440,22,32,.688,125
162,LAC,2016-12-12,121,,POR,W 121-120,240,42,89,.472,31,66,.470,11,23,.478,26,28,.929,121,44,87,.506,34,66,.515,10,21,.476,22,25,.880,120
163,MIL,2016-11-19,121,,GSW,L 121-124,240,46,89,.517,36,69,.522,10,20,.500,19,25,.760,121,42,95,.442,28,57,.491,14,38,.368,26,32,.813,124
164,NOP,2016-11-19,121,,CHO,W 121-116 (OT),265,43,98,.439,29,62,.468,14,36,.389,21,25,.840,121,40,97,.412,25,54,.463,15,43,.349,21,28,.750,116
165,TOR,2016-11-16,121,,GSW,L 121-127,240,37,82,.451,27,57,.474,10,25,.400,37,41,.902,121,44,87,.506,31,51,.608,13,36,.361,26,28,.929,127
166,CLE,2016-11-15,121,,TOR,W 121-117,240,44,83,.530,31,50,.620,13,33,.394,20,28,.714,121,46,96,.479,33,67,.493,13,29,.448,12,18,.667,117
167,PHO,2017-04-07,120,,OKC,W 120-99,240,43,83,.518,35,65,.538,8,18,.444,26,31,.839,120,34,92,.370,27,62,.435,7,30,.233,24,33,.727,99
168,UTA,2017-04-07,120,,MIN,W 120-113,240,45,75,.600,31,50,.620,14,25,.560,16,22,.727,120,39,79,.494,32,63,.508,7,16,.438,28,28,1.000,113
169,CHO,2017-03-26,120,,PHO,W 120-106,240,42,87,.483,28,57,.491,14,30,.467,22,24,.917,120,41,81,.506,35,65,.538,6,16,.375,18,22,.818,106
170,LAL,2017-03-19,120,,CLE,L 120-125,240,47,91,.516,36,64,.563,11,27,.407,15,19,.789,120,45,85,.529,32,49,.653,13,36,.361,22,27,.815,125
171,MIA,2017-03-15,120,,NOP,W 120-112,240,44,87,.506,28,52,.538,16,35,.457,16,19,.842,120,42,88,.477,33,66,.500,9,22,.409,19,28,.679,112
172,SAC,2017-03-13,120,,ORL,W 120-115,240,44,82,.537,28,52,.538,16,30,.533,16,21,.762,120,45,98,.459,32,64,.500,13,34,.382,12,12,1.000,115
173,BRK,2017-03-12,120,,NYK,W 120-112,240,40,87,.460,21,49,.429,19,38,.500,21,29,.724,120,39,94,.415,31,71,.437,8,23,.348,26,32,.813,112
174,MIA,2017-03-04,120,,CLE,W 120-92,240,46,88,.523,28,54,.519,18,34,.529,10,12,.833,120,35,73,.479,24,46,.522,11,27,.407,11,18,.611,92
175,PHO,2017-03-02,120,,CHO,W 120-103,240,46,77,.597,39,58,.672,7,19,.368,21,25,.840,120,35,89,.393,25,55,.455,10,34,.294,23,28,.821,103
176,DET,2017-02-28,120,,POR,W 120-113 (OT),265,45,104,.433,38,79,.481,7,25,.280,23,31,.742,120,44,84,.524,34,59,.576,10,25,.400,15,22,.682,113
177,PHI,2017-02-24,120,,WAS,W 120-112,240,43,87,.494,33,58,.569,10,29,.345,24,30,.800,120,38,90,.422,33,66,.500,5,24,.208,31,40,.775,112
178,WAS,2017-02-13,120,,OKC,W 120-98,240,42,73,.575,29,53,.547,13,20,.650,23,28,.821,120,34,96,.354,27,62,.435,7,34,.206,23,30,.767,98
179,LAC,2017-02-02,120,,GSW,L 120-133,240,40,80,.500,30,55,.545,10,25,.400,30,39,.769,120,52,99,.525,38,65,.585,14,34,.412,15,18,.833,133
180,LAL,2017-01-31,120,,DEN,W 120-116,240,47,89,.528,35,63,.556,12,26,.462,14,18,.778,120,41,99,.414,26,72,.361,15,27,.556,19,23,.826,116
181,IND,2017-01-29,120,,HOU,W 120-101,240,47,87,.540,42,66,.636,5,21,.238,21,26,.808,120,34,83,.410,23,44,.523,11,39,.282,22,25,.880,101
182,BOS,2017-01-25,120,,HOU,W 120-109,240,47,91,.516,36,59,.610,11,32,.344,15,16,.938,120,36,77,.468,26,46,.565,10,31,.323,27,38,.711,109
183,LAC,2017-01-16,120,,OKC,W 120-98,240,45,82,.549,33,54,.611,12,28,.429,18,22,.818,120,36,85,.424,26,55,.473,10,30,.333,16,19,.842,98
184,WAS,2017-01-16,120,,POR,W 120-101,240,42,86,.488,29,63,.460,13,23,.565,23,25,.920,120,37,88,.420,29,62,.468,8,26,.308,19,25,.760,101
185,BRK,2016-12-26,120,,CHO,W 120-118,240,40,75,.533,25,44,.568,15,31,.484,25,31,.806,120,44,94,.468,36,68,.529,8,26,.308,22,25,.880,118
186,ATL,2016-12-13,120,,ORL,L 120-131,240,45,89,.506,34,61,.557,11,28,.393,19,21,.905,120,51,87,.586,36,53,.679,15,34,.441,14,20,.700,131
187,CHO,2016-12-03,120,,MIN,L 120-125 (OT),265,44,101,.436,30,65,.462,14,36,.389,18,26,.692,120,48,106,.453,38,79,.481,10,27,.370,19,22,.864,125
188,TOR,2016-11-30,120,,MEM,W 120-105,240,38,69,.551,22,37,.595,16,32,.500,28,33,.848,120,36,82,.439,25,55,.455,11,27,.407,22,26,.846,105
189,UTA,2016-11-29,120,,HOU,W 120-101,240,41,74,.554,26,46,.565,15,28,.536,23,27,.852,120,37,91,.407,26,61,.426,11,30,.367,16,22,.727,101
190,PHI,2016-11-19,120,,PHO,W 120-105,240,45,86,.523,28,51,.549,17,35,.486,13,20,.650,120,39,92,.424,33,71,.465,6,21,.286,21,34,.618,105
191,DEN,2016-11-16,120,,PHO,W 120-104,240,45,93,.484,37,76,.487,8,17,.471,22,24,.917,120,39,79,.494,31,59,.525,8,20,.400,18,29,.621,104
192,LAL,2016-10-26,120,,HOU,W 120-114,240,45,89,.506,33,54,.611,12,35,.343,18,22,.818,120,44,86,.512,37,57,.649,7,29,.241,19,27,.704,114
193,MIN,2017-03-30,119,,LAL,W 119-104,240,43,89,.483,33,68,.485,10,21,.476,23,30,.767,119,40,84,.476,31,57,.544,9,27,.333,15,16,.938,104
194,MIN,2017-03-13,119,,WAS,W 119-104,240,45,86,.523,35,65,.538,10,21,.476,19,22,.864,119,36,84,.429,29,58,.500,7,26,.269,25,31,.806,104
195,DEN,2017-03-10,119,,BOS,W 119-99,240,45,85,.529,33,54,.611,12,31,.387,17,22,.773,119,34,81,.420,22,48,.458,12,33,.364,19,23,.826,99
196,CLE,2017-02-23,119,,NYK,W 119-104,240,46,87,.529,31,49,.633,15,38,.395,12,15,.800,119,42,101,.416,34,75,.453,8,26,.308,12,17,.706,104
197,NOP,2017-01-27,119,,SAS,W 119-103,240,48,93,.516,35,63,.556,13,30,.433,10,14,.714,119,33,85,.388,21,57,.368,12,28,.429,25,29,.862,103
198,MIN,2017-01-11,119,,HOU,W 119-105,240,44,81,.543,36,58,.621,8,23,.348,23,25,.920,119,36,87,.414,21,45,.467,15,42,.357,18,22,.818,105
199,GSW,2017-01-06,119,,MEM,L 119-128 (OT),265,41,83,.494,33,53,.623,8,30,.267,29,39,.744,119,50,103,.485,37,70,.529,13,33,.394,15,19,.789,128
200,SAS,2016-12-28,119,,PHO,W 119-98,240,47,87,.540,42,70,.600,5,17,.294,20,25,.800,119,36,74,.486,29,58,.500,7,16,.438,19,24,.792,98
201,SAS,2016-12-25,119,,CHI,W 119-100,240,48,85,.565,39,67,.582,9,18,.500,14,19,.737,119,39,86,.453,32,68,.471,7,18,.389,15,20,.750,100
202,CLE,2016-12-23,119,,BRK,W 119-99,240,45,99,.455,37,64,.578,8,35,.229,21,24,.875,119,38,85,.447,30,55,.545,8,30,.267,15,18,.833,99
203,LAC,2016-12-20,119,,DEN,W 119-102,240,47,86,.547,31,50,.620,16,36,.444,9,13,.692,119,39,90,.433,28,51,.549,11,39,.282,13,20,.650,102
204,CLE,2016-12-17,119,,LAL,W 119-108,240,46,89,.517,31,56,.554,15,33,.455,12,18,.667,119,41,86,.477,25,49,.510,16,37,.432,10,13,.769,108
205,PHO,2016-12-11,119,,NOP,L 119-120 (OT),265,44,96,.458,30,55,.545,14,41,.341,17,26,.654,119,38,97,.392,22,57,.386,16,40,.400,28,35,.800,120
206,POR,2016-11-25,119,,NOP,W 119-104,240,47,100,.470,35,68,.515,12,32,.375,13,17,.765,119,36,76,.474,23,53,.434,13,23,.565,19,29,.655,104
207,WAS,2016-11-17,119,,NYK,W 119-112,240,44,81,.543,29,56,.518,15,25,.600,16,18,.889,119,41,86,.477,29,57,.509,12,29,.414,18,20,.900,112
208,BRK,2016-11-08,119,,MIN,W 119-110,240,42,76,.553,30,43,.698,12,33,.364,23,26,.885,119,39,92,.424,27,64,.422,12,28,.429,20,28,.714,110
209,LAL,2016-11-06,119,,PHO,W 119-108,240,41,90,.456,31,67,.463,10,23,.435,27,35,.771,119,40,91,.440,34,71,.479,6,20,.300,22,28,.786,108
210,PHI,2017-04-04,118,,BRK,L 118-141,240,43,97,.443,31,59,.525,12,38,.316,20,27,.741,118,48,75,.640,32,44,.727,16,31,.516,29,33,.879,141
211,WAS,2017-04-04,118,,CHO,W 118-111,240,43,85,.506,26,51,.510,17,34,.500,15,18,.833,118,40,79,.506,28,45,.622,12,34,.353,19,22,.864,111
212,PHO,2017-03-30,118,,LAC,L 118-124,240,49,92,.533,42,69,.609,7,23,.304,13,24,.542,118,44,80,.550,32,58,.552,12,22,.545,24,34,.706,124
213,SAS,2017-03-19,118,,SAC,W 118-102,240,43,87,.494,32,59,.542,11,28,.393,21,27,.778,118,41,83,.494,34,73,.466,7,10,.700,13,17,.765,102
214,PHO,2017-03-03,118,,OKC,W 118-111,240,44,89,.494,39,68,.574,5,21,.238,25,31,.806,118,37,87,.425,28,52,.538,9,35,.257,28,35,.800,111
215,OKC,2017-02-26,118,,NOP,W 118-110,240,42,88,.477,36,67,.537,6,21,.286,28,37,.757,118,36,80,.450,28,59,.475,8,21,.381,30,37,.811,110
216,OKC,2017-02-09,118,,CLE,W 118-109,240,50,106,.472,42,79,.532,8,27,.296,10,13,.769,118,38,79,.481,28,58,.483,10,21,.476,23,30,.767,109
217,TOR,2017-02-06,118,,LAC,W 118-109,240,41,84,.488,31,60,.517,10,24,.417,26,29,.897,118,42,90,.467,29,55,.527,13,35,.371,12,18,.667,109
218,DET,2017-02-01,118,,NOP,W 118-98,240,48,88,.545,38,62,.613,10,26,.385,12,17,.706,118,41,82,.500,36,61,.590,5,21,.238,11,14,.786,98
219,PHI,2017-01-27,118,,HOU,L 118-123,240,42,78,.538,32,53,.604,10,25,.400,24,32,.750,118,42,81,.519,30,50,.600,12,31,.387,27,28,.964,123
220,SAS,2017-01-19,118,,DEN,W 118-104,240,44,86,.512,35,64,.547,9,22,.409,21,25,.840,118,37,91,.407,27,60,.450,10,31,.323,20,26,.769,104
221,CLE,2017-01-19,118,,PHO,W 118-103,240,43,85,.506,24,43,.558,19,42,.452,13,19,.684,118,37,85,.435,33,66,.500,4,19,.211,25,31,.806,103
222,DET,2017-01-18,118,,ATL,W 118-95,240,45,91,.495,35,66,.530,10,25,.400,18,28,.643,118,30,78,.385,24,53,.453,6,25,.240,29,37,.784,95
223,NOP,2017-01-18,118,,ORL,W 118-98,240,46,93,.495,31,57,.544,15,36,.417,11,15,.733,118,39,88,.443,28,56,.500,11,32,.344,9,11,.818,98
224,SAC,2017-01-15,118,,OKC,L 118-122,240,37,81,.457,28,56,.500,9,25,.360,35,40,.875,118,40,90,.444,31,62,.500,9,28,.321,33,41,.805,122
225,HOU,2017-01-05,118,,OKC,W 118-116,240,41,86,.477,26,47,.553,15,39,.385,21,30,.700,118,41,91,.451,29,61,.475,12,30,.400,22,27,.815,116
226,POR,2017-01-05,118,,LAL,W 118-109,240,43,81,.531,31,48,.646,12,33,.364,20,30,.667,118,36,86,.419,26,55,.473,10,31,.323,27,33,.818,109
227,CHI,2017-01-02,118,,CHO,W 118-111,240,42,90,.467,35,67,.522,7,23,.304,27,29,.931,118,41,83,.494,32,64,.500,9,19,.474,20,22,.909,111
228,WAS,2016-12-30,118,,BRK,W 118-95,240,47,83,.566,36,61,.590,11,22,.500,13,14,.929,118,32,74,.432,22,49,.449,10,25,.400,21,25,.840,95
229,NYK,2016-12-20,118,,IND,W 118-111,240,44,88,.500,31,65,.477,13,23,.565,17,21,.810,118,39,91,.429,33,68,.485,6,23,.261,27,33,.818,111
230,ORL,2016-12-16,118,,BRK,W 118-111,240,39,97,.402,32,68,.471,7,29,.241,33,42,.786,118,39,83,.470,28,56,.500,11,27,.407,22,26,.846,111
231,IND,2016-12-10,118,,POR,W 118-111,240,40,83,.482,25,54,.463,15,29,.517,23,28,.821,118,40,82,.488,24,45,.533,16,37,.432,15,16,.938,111
232,NYK,2016-12-02,118,,MIN,W 118-114,240,41,86,.477,29,55,.527,12,31,.387,24,30,.800,118,41,88,.466,31,60,.517,10,28,.357,22,24,.917,114
233,MIL,2016-11-29,118,,CLE,W 118-101,240,46,86,.535,39,67,.582,7,19,.368,19,23,.826,118,32,75,.427,18,36,.500,14,39,.359,23,31,.742,101
234,IND,2016-11-25,118,,BRK,W 118-97,240,48,87,.552,37,61,.607,11,26,.423,11,16,.688,118,36,79,.456,25,45,.556,11,34,.324,14,23,.609,97
235,TOR,2016-11-12,118,,NYK,W 118-107,240,39,83,.470,32,61,.525,7,22,.318,33,38,.868,118,44,97,.454,37,74,.500,7,23,.304,12,16,.750,107
236,WAS,2016-11-09,118,,BOS,W 118-93,240,46,92,.500,36,71,.507,10,21,.476,16,20,.800,118,35,81,.432,25,50,.500,10,31,.323,13,22,.591,93
237,PHO,2016-11-02,118,,POR,W 118-115 (OT),265,44,103,.427,39,87,.448,5,16,.313,25,30,.833,118,42,101,.416,30,68,.441,12,33,.364,19,21,.905,115
238,CHI,2016-10-29,118,,IND,W 118-101,240,45,86,.523,36,65,.554,9,21,.429,19,21,.905,118,43,88,.489,36,70,.514,7,18,.389,8,9,.889,101
239,MIN,2017-04-01,117,,SAC,L 117-123,240,39,87,.448,30,60,.500,9,27,.333,30,38,.789,117,44,78,.564,33,59,.559,11,19,.579,24,33,.727,123
240,NOP,2017-03-31,117,,SAC,W 117-89,240,46,95,.484,36,62,.581,10,33,.303,15,19,.789,117,35,90,.389,29,70,.414,6,20,.300,13,17,.765,89
241,BOS,2017-03-31,117,,ORL,W 117-116,240,38,84,.452,26,51,.510,12,33,.364,29,34,.853,117,40,98,.408,28,68,.412,12,30,.400,24,25,.960,116
242,POR,2017-03-30,117,,HOU,W 117-107,240,43,90,.478,30,57,.526,13,33,.394,18,22,.818,117,40,91,.440,32,57,.561,8,34,.235,19,23,.826,107
243,HOU,2017-03-24,117,,NOP,W 117-107,240,44,93,.473,30,54,.556,14,39,.359,15,20,.750,117,41,91,.451,27,53,.509,14,38,.368,11,14,.786,107
244,IND,2017-03-24,117,,DEN,L 117-125,240,48,95,.505,35,71,.493,13,24,.542,8,11,.727,117,39,82,.476,32,55,.582,7,27,.259,40,43,.930,125
245,CHI,2017-03-22,117,,DET,W 117-95,240,47,80,.588,36,57,.632,11,23,.478,12,19,.632,117,39,88,.443,32,68,.471,7,20,.350,10,17,.588,95
246,GSW,2017-03-18,117,,MIL,W 117-92,240,45,75,.600,33,52,.635,12,23,.522,15,19,.789,117,36,89,.404,27,62,.435,9,27,.333,11,14,.786,92
247,BOS,2017-03-15,117,,MIN,W 117-104,240,43,79,.544,30,46,.652,13,33,.394,18,21,.857,117,40,91,.440,32,64,.500,8,27,.296,16,20,.800,104
248,HOU,2017-03-12,117,,CLE,W 117-112,240,41,96,.427,25,51,.490,16,45,.356,19,28,.679,117,42,80,.525,25,37,.676,17,43,.395,11,13,.846,112
249,MIN,2017-02-12,117,,CHI,W 117-89,240,44,81,.543,38,57,.667,6,24,.250,23,26,.885,117,35,84,.417,25,59,.424,10,25,.400,9,13,.692,89
250,PHI,2017-02-11,117,,MIA,W 117-109,240,39,86,.453,30,61,.492,9,25,.360,30,38,.789,117,39,85,.459,32,61,.525,7,24,.292,24,28,.857,109
251,ATL,2017-02-08,117,,DEN,W 117-106,240,47,93,.505,39,66,.591,8,27,.296,15,18,.833,117,40,100,.400,27,56,.482,13,44,.295,13,21,.619,106
252,IND,2017-02-08,117,,CLE,L 117-132,240,41,82,.500,28,57,.491,13,25,.520,22,26,.846,117,46,84,.548,30,48,.625,16,36,.444,24,26,.923,132
253,WAS,2017-01-31,117,,NYK,W 117-101,240,49,88,.557,42,66,.636,7,22,.318,12,15,.800,117,34,93,.366,29,69,.420,5,24,.208,28,35,.800,101
254,BOS,2017-01-11,117,,WAS,W 117-108,240,43,85,.506,26,44,.591,17,41,.415,14,18,.778,117,45,105,.429,35,79,.443,10,26,.385,8,12,.667,108
255,BOS,2017-01-07,117,,NOP,W 117-108,240,40,93,.430,22,57,.386,18,36,.500,19,21,.905,117,40,85,.471,30,54,.556,10,31,.323,18,23,.783,108
256,IND,2017-01-01,117,,ORL,W 117-104,240,43,86,.500,34,64,.531,9,22,.409,22,24,.917,117,42,97,.433,32,59,.542,10,38,.263,10,11,.909,104
257,BOS,2016-12-30,117,,MIA,W 117-114,240,38,74,.514,21,42,.500,17,32,.531,24,29,.828,117,48,90,.533,37,62,.597,11,28,.393,7,10,.700,114
258,CHO,2016-12-20,117,,LAL,W 117-113,240,43,94,.457,32,69,.464,11,25,.440,20,24,.833,117,44,90,.489,28,57,.491,16,33,.485,9,11,.818,113
259,DEN,2016-12-19,117,,DAL,W 117-107,240,45,80,.563,32,55,.582,13,25,.520,14,18,.778,117,43,80,.538,29,55,.527,14,25,.560,7,9,.778,107
260,WAS,2016-12-18,117,,LAC,W 117-110,240,43,81,.531,33,62,.532,10,19,.526,21,30,.700,117,43,87,.494,36,63,.571,7,24,.292,17,24,.708,110
261,NOP,2016-11-23,117,,MIN,W 117-96,240,45,83,.542,36,59,.610,9,24,.375,18,23,.783,117,33,86,.384,30,69,.435,3,17,.176,27,33,.818,96
262,OKC,2016-11-13,117,,ORL,L 117-119,240,47,92,.511,40,67,.597,7,25,.280,16,26,.615,117,46,86,.535,35,62,.565,11,24,.458,16,20,.800,119
263,ATL,2016-11-12,117,,PHI,W 117-96,240,48,95,.505,35,63,.556,13,32,.406,8,14,.571,117,36,83,.434,25,54,.463,11,29,.379,13,20,.650,96
264,MIL,2016-11-05,117,,SAC,W 117-91,240,41,82,.500,27,49,.551,14,33,.424,21,25,.840,117,33,84,.393,23,56,.411,10,28,.357,15,19,.789,91
265,LAL,2016-11-04,117,,GSW,W 117-97,240,45,95,.474,37,65,.569,8,30,.267,19,21,.905,117,39,86,.453,34,54,.630,5,32,.156,14,20,.700,97
266,CLE,2016-10-25,117,,NYK,W 117-88,240,45,94,.479,32,59,.542,13,35,.371,14,19,.737,117,32,87,.368,23,60,.383,9,27,.333,15,20,.750,88
267,PHO,2017-04-02,116,,HOU,L 116-123,240,42,100,.420,34,66,.515,8,34,.235,24,29,.828,116,47,100,.470,33,62,.532,14,38,.368,15,23,.652,123
268,TOR,2017-03-19,116,,IND,W 116-91,240,45,91,.495,33,64,.516,12,27,.444,14,16,.875,116,33,80,.413,27,57,.474,6,23,.261,19,26,.731,91
269,PHI,2017-03-17,116,,DAL,W 116-74,240,42,80,.525,30,51,.588,12,29,.414,20,23,.870,116,30,87,.345,25,64,.391,5,23,.217,9,17,.529,74
270,LAL,2017-03-12,116,,PHI,L 116-118,240,44,88,.500,40,68,.588,4,20,.200,24,28,.857,116,41,79,.519,31,55,.564,10,24,.417,26,32,.813,118
271,LAC,2017-03-06,116,,BOS,W 116-102,240,39,73,.534,30,53,.566,9,20,.450,29,47,.617,116,34,83,.410,24,48,.500,10,35,.286,24,29,.828,102
272,SAC,2017-02-23,116,,DEN,W 116-100,240,46,88,.523,39,74,.527,7,14,.500,17,19,.895,116,39,88,.443,27,53,.509,12,35,.343,10,14,.714,100
273,OKC,2017-02-15,116,,NYK,W 116-105,240,41,88,.466,29,65,.446,12,23,.522,22,31,.710,116,41,86,.477,30,65,.462,11,21,.524,12,14,.857,105
274,BOS,2017-02-15,116,,PHI,W 116-108,240,38,80,.475,25,52,.481,13,28,.464,27,36,.750,116,44,93,.473,36,62,.581,8,31,.258,12,18,.667,108
275,DET,2017-02-03,116,,MIN,W 116-108,240,44,98,.449,33,72,.458,11,26,.423,17,22,.773,116,44,89,.494,39,72,.542,5,17,.294,15,19,.789,108
276,WAS,2017-02-02,116,,LAL,W 116-108,240,44,96,.458,32,63,.508,12,33,.364,16,21,.762,116,40,87,.460,28,48,.583,12,39,.308,16,22,.727,108
277,MIA,2017-02-01,116,,ATL,W 116-93,240,45,93,.484,33,61,.541,12,32,.375,14,19,.737,116,34,86,.395,27,60,.450,7,26,.269,18,21,.857,93
278,MIA,2017-01-28,116,,DET,W 116-103,240,42,80,.525,28,52,.538,14,28,.500,18,23,.783,116,46,89,.517,42,77,.545,4,12,.333,7,12,.583,103
279,TOR,2017-01-15,116,,NYK,W 116-101,240,44,89,.494,36,67,.537,8,22,.364,20,23,.870,116,35,84,.417,23,55,.418,12,29,.414,19,27,.704,101
280,MIL,2017-01-13,116,,MIA,W 116-108,240,40,80,.500,31,65,.477,9,15,.600,27,31,.871,116,41,83,.494,29,51,.569,12,32,.375,14,18,.778,108
281,PHO,2017-01-08,116,,CLE,L 116-120,240,46,87,.529,37,60,.617,9,27,.333,15,19,.789,116,44,82,.537,29,48,.604,15,34,.441,17,19,.895,120
282,DET,2017-01-03,116,,IND,L 116-121,240,48,97,.495,38,68,.559,10,29,.345,10,12,.833,116,43,74,.581,34,58,.586,9,16,.563,26,30,.867,121
283,LAL,2017-01-03,116,,MEM,W 116-102,240,42,82,.512,25,49,.510,17,33,.515,15,28,.536,116,30,77,.390,20,46,.435,10,31,.323,32,35,.914,102
284,MIN,2016-12-30,116,,MIL,W 116-99,240,43,77,.558,30,52,.577,13,25,.520,17,21,.810,116,40,74,.541,32,56,.571,8,18,.444,11,17,.647,99
285,TOR,2016-12-20,116,,BRK,W 116-104,240,42,91,.462,34,73,.466,8,18,.444,24,31,.774,116,36,91,.396,26,56,.464,10,35,.286,22,28,.786,104
286,SAC,2016-12-12,116,,LAL,W 116-92,240,47,84,.560,37,61,.607,10,23,.435,12,21,.571,116,33,84,.393,23,61,.377,10,23,.435,16,21,.762,92
287,CLE,2016-12-10,116,,CHO,W 116-105,240,42,73,.575,29,42,.690,13,31,.419,19,28,.679,116,39,86,.453,29,59,.492,10,27,.370,17,24,.708,105
288,BRK,2016-12-07,116,,DEN,W 116-111,240,41,85,.482,32,59,.542,9,26,.346,25,31,.806,116,42,105,.400,31,68,.456,11,37,.297,16,21,.762,111
289,WAS,2016-12-06,116,,ORL,L 116-124,240,44,93,.473,33,70,.471,11,23,.478,17,24,.708,116,43,83,.518,31,57,.544,12,26,.462,26,36,.722,124
290,SAC,2016-11-23,116,,OKC,W 116-101,240,44,94,.468,32,66,.485,12,28,.429,16,17,.941,116,32,76,.421,25,51,.490,7,25,.280,30,38,.789,101
291,GSW,2016-11-09,116,,DAL,W 116-95,240,43,74,.581,26,41,.634,17,33,.515,13,22,.591,116,34,86,.395,28,58,.483,6,28,.214,21,28,.750,95
292,GSW,2016-11-07,116,,NOP,W 116-106,240,45,90,.500,29,55,.527,16,35,.457,10,12,.833,116,39,80,.488,32,59,.542,7,21,.333,21,27,.778,106
293,ATL,2016-11-02,116,,LAL,L 116-123,240,41,85,.482,30,53,.566,11,32,.344,23,29,.793,116,48,90,.533,39,68,.574,9,22,.409,18,20,.900,123
294,MIN,2016-11-01,116,,MEM,W 116-80,240,43,78,.551,31,58,.534,12,20,.600,18,23,.783,116,27,75,.360,23,51,.451,4,24,.167,22,29,.759,80
295,LAC,2016-10-31,116,,PHO,W 116-98,240,40,80,.500,34,64,.531,6,16,.375,30,38,.789,116,35,84,.417,30,69,.435,5,15,.333,23,31,.742,98
296,LAC,2017-04-12,115,,SAC,W 115-95,240,43,83,.518,33,55,.600,10,28,.357,19,25,.760,115,40,81,.494,35,70,.500,5,11,.455,10,14,.714,95
297,ORL,2017-04-06,115,,BRK,W 115-107,240,42,90,.467,33,65,.508,9,25,.360,22,26,.846,115,40,87,.460,29,57,.509,11,30,.367,16,22,.727,107
298,LAC,2017-04-01,115,,LAL,W 115-104,240,38,69,.551,27,44,.614,11,25,.440,28,34,.824,115,39,90,.433,33,67,.493,6,23,.261,20,30,.667,104
299,CLE,2017-03-25,115,,WAS,L 115-127,240,41,83,.494,29,50,.580,12,33,.364,21,27,.778,115,49,82,.598,41,64,.641,8,18,.444,21,26,.808,127
300,ORL,2017-03-24,115,,DET,W 115-87,240,47,91,.516,35,65,.538,12,26,.462,9,13,.692,115,34,96,.354,32,74,.432,2,22,.091,17,20,.850,87
301,IND,2017-03-08,115,,DET,W 115-98,240,44,88,.500,33,65,.508,11,23,.478,16,19,.842,115,39,89,.438,32,63,.508,7,26,.269,13,22,.591,98
302,WAS,2017-03-05,115,,ORL,W 115-114,240,39,81,.481,25,55,.455,14,26,.538,23,25,.920,115,44,89,.494,30,54,.556,14,35,.400,12,19,.632,114
303,PHO,2017-02-10,115,,CHI,W 115-97,240,48,95,.505,40,76,.526,8,19,.421,11,13,.846,115,37,86,.430,32,67,.478,5,19,.263,18,22,.818,97
304,NYK,2017-02-08,115,,LAC,L 115-119,240,46,92,.500,38,65,.585,8,27,.296,15,18,.833,115,45,92,.489,35,67,.522,10,25,.400,19,28,.679,119
305,POR,2017-01-31,115,,CHO,W 115-98,240,42,93,.452,31,62,.500,11,31,.355,20,23,.870,115,33,83,.398,22,52,.423,11,31,.355,21,25,.840,98
306,IND,2017-01-27,115,,SAC,W 115-111 (OT),265,38,78,.487,28,50,.560,10,28,.357,29,33,.879,115,35,70,.500,22,45,.489,13,25,.520,28,36,.778,111
307,CLE,2017-01-21,115,,SAS,L 115-118 (OT),265,45,91,.495,32,57,.561,13,34,.382,12,22,.545,115,48,96,.500,38,70,.543,10,26,.385,12,14,.857,118
308,DET,2017-01-05,115,,CHO,W 115-114,240,39,97,.402,29,69,.420,10,28,.357,27,32,.844,115,37,91,.407,27,65,.415,10,26,.385,30,34,.882,114
309,LAC,2017-01-04,115,,MEM,W 115-106,240,37,73,.507,28,50,.560,9,23,.391,32,45,.711,115,38,88,.432,27,60,.450,11,28,.393,19,25,.760,106
310,BOS,2017-01-03,115,,UTA,W 115-104,240,41,74,.554,24,43,.558,17,31,.548,16,17,.941,115,38,82,.463,27,56,.482,11,26,.423,17,21,.810,104
311,MEM,2016-12-23,115,,HOU,W 115-109,240,41,81,.506,28,56,.500,13,25,.520,20,25,.800,115,38,89,.427,18,37,.486,20,52,.385,13,15,.867,109
312,MIA,2016-12-22,115,,LAL,W 115-107,240,45,84,.536,34,62,.548,11,22,.500,14,21,.667,115,40,90,.444,26,52,.500,14,38,.368,13,15,.867,107
313,MIN,2016-12-19,115,,PHO,W 115-108,240,42,86,.488,35,67,.522,7,19,.368,24,25,.960,115,37,82,.451,28,61,.459,9,21,.429,25,35,.714,108
314,LAL,2016-12-09,115,,PHO,L 115-119,240,40,87,.460,31,61,.508,9,26,.346,26,34,.765,115,45,95,.474,32,65,.492,13,30,.433,16,21,.762,119
315,MIL,2016-12-07,115,,POR,W 115-107,240,40,77,.519,30,53,.566,10,24,.417,25,37,.676,115,37,85,.435,20,45,.444,17,40,.425,16,19,.842,107
316,GSW,2016-11-26,115,,MIN,W 115-102,240,45,81,.556,34,59,.576,11,22,.500,14,17,.824,115,41,89,.461,31,54,.574,10,35,.286,10,12,.833,102
317,SAC,2016-11-18,115,,LAC,L 115-121,240,38,86,.442,28,60,.467,10,26,.385,29,35,.829,115,40,76,.526,27,47,.574,13,29,.448,28,34,.824,121
318,HOU,2016-11-14,115,,PHI,W 115-88,240,44,91,.484,27,51,.529,17,40,.425,10,17,.588,115,34,90,.378,29,68,.426,5,22,.227,15,17,.882,88
319,BOS,2016-11-11,115,,NYK,W 115-87,240,35,90,.389,24,63,.381,11,27,.407,34,43,.791,115,33,94,.351,27,71,.380,6,23,.261,15,17,.882,87
320,ATL,2016-11-09,115,,CHI,W 115-107,240,42,83,.506,33,63,.524,9,20,.450,22,27,.815,115,41,91,.451,32,64,.500,9,27,.333,16,21,.762,107
321,IND,2016-11-01,115,,LAL,W 115-108,240,41,87,.471,31,59,.525,10,28,.357,23,29,.793,115,40,89,.449,34,61,.557,6,28,.214,22,25,.880,108
322,NYK,2017-04-12,114,,PHI,W 114-113,240,41,83,.494,32,61,.525,9,22,.409,23,32,.719,114,46,93,.495,39,70,.557,7,23,.304,14,20,.700,113
323,BOS,2017-04-10,114,,BRK,W 114-105,240,41,91,.451,27,53,.509,14,38,.368,18,21,.857,114,31,86,.360,23,55,.418,8,31,.258,35,39,.897,105
324,CHO,2017-04-08,114,,BOS,L 114-121,240,38,84,.452,29,56,.518,9,28,.321,29,32,.906,114,45,87,.517,28,48,.583,17,39,.436,14,17,.824,121
325,IND,2017-03-28,114,,MIN,L 114-115,240,40,81,.494,35,63,.556,5,18,.278,29,35,.829,114,37,78,.474,28,58,.483,9,20,.450,32,37,.865,115
326,GSW,2017-03-24,114,,SAC,W 114-100,240,44,89,.494,34,58,.586,10,31,.323,16,18,.889,114,40,83,.482,30,62,.484,10,21,.476,10,13,.769,100
327,LAC,2017-03-20,114,,NYK,W 114-105,240,43,87,.494,33,56,.589,10,31,.323,18,24,.750,114,40,89,.449,34,65,.523,6,24,.250,19,24,.792,105
328,UTA,2017-03-13,114,,LAC,W 114-108,240,41,78,.526,27,57,.474,14,21,.667,18,22,.818,114,39,78,.500,27,48,.563,12,30,.400,18,23,.783,108
329,POR,2017-03-09,114,,PHI,W 114-108 (OT),265,40,88,.455,34,67,.507,6,21,.286,28,33,.848,114,41,94,.436,30,65,.462,11,29,.379,15,20,.750,108
330,SAS,2017-03-08,114,,SAC,W 114-104,240,42,84,.500,28,55,.509,14,29,.483,16,21,.762,114,42,86,.488,35,67,.522,7,19,.368,13,16,.813,104
331,POR,2017-03-02,114,,OKC,W 114-109,240,39,79,.494,29,54,.537,10,25,.400,26,35,.743,114,34,86,.395,23,57,.404,11,29,.379,30,32,.938,109
332,DET,2017-02-23,114,,CHO,W 114-108 (OT),265,44,107,.411,29,70,.414,15,37,.405,11,12,.917,114,38,92,.413,31,62,.500,7,30,.233,25,26,.962,108
333,OKC,2017-02-11,114,,GSW,L 114-130,240,40,83,.482,34,59,.576,6,24,.250,28,36,.778,114,46,87,.529,33,56,.589,13,31,.419,25,35,.714,130
334,MIL,2017-02-10,114,,LAL,L 114-122,240,40,76,.526,32,48,.667,8,28,.286,26,31,.839,114,39,75,.520,24,44,.545,15,31,.484,29,35,.829,122
335,OKC,2017-02-03,114,,MEM,W 114-102,240,38,80,.475,25,54,.463,13,26,.500,25,33,.758,114,40,83,.482,37,64,.578,3,19,.158,19,22,.864,102
336,PHO,2017-02-01,114,,LAC,L 114-124,240,39,96,.406,32,76,.421,7,20,.350,29,35,.829,114,44,85,.518,39,66,.591,5,19,.263,31,38,.816,124
337,CHI,2017-01-25,114,,ATL,L 114-119,240,43,94,.457,35,67,.522,8,27,.296,20,26,.769,114,43,83,.518,26,53,.491,17,30,.567,16,19,.842,119
338,NOP,2017-01-20,114,,BRK,L 114-143,240,43,105,.410,32,71,.451,11,34,.324,17,23,.739,114,48,83,.578,33,53,.623,15,30,.500,32,35,.914,143
339,UTA,2017-01-14,114,,ORL,W 114-107,240,41,83,.494,34,57,.596,7,26,.269,25,36,.694,114,38,82,.463,26,48,.542,12,34,.353,19,27,.704,107
340,TOR,2017-01-10,114,,BOS,W 114-106,240,41,87,.471,31,65,.477,10,22,.455,22,27,.815,114,40,85,.471,31,58,.534,9,27,.333,17,20,.850,106
341,ATL,2017-01-01,114,,SAS,W 114-112 (OT),265,42,92,.457,28,64,.438,14,28,.500,16,27,.593,114,42,90,.467,33,63,.524,9,27,.333,19,22,.864,112
342,LAL,2017-01-01,114,,TOR,L 114-123,240,37,92,.402,22,60,.367,15,32,.469,25,31,.806,114,42,75,.560,32,58,.552,10,17,.588,29,32,.906,123
343,OKC,2016-12-31,114,,LAC,W 114-88,240,37,78,.474,27,49,.551,10,29,.345,30,35,.857,114,31,75,.413,23,45,.511,8,30,.267,18,21,.857,88
344,MEM,2016-12-29,114,,OKC,W 114-80,240,43,82,.524,30,60,.500,13,22,.591,15,20,.750,114,25,74,.338,21,52,.404,4,22,.182,26,38,.684,80
345,NYK,2016-12-25,114,,BOS,L 114-119,240,41,87,.471,33,64,.516,8,23,.348,24,27,.889,114,45,93,.484,31,57,.544,14,36,.389,15,20,.750,119
346,OKC,2016-12-17,114,,PHO,W 114-101,240,41,81,.506,34,65,.523,7,16,.438,25,34,.735,114,39,90,.433,31,68,.456,8,22,.364,15,20,.750,101
347,PHI,2016-12-14,114,,TOR,L 114-123,240,43,86,.500,34,57,.596,9,29,.310,19,25,.760,114,41,87,.471,31,58,.534,10,29,.345,31,36,.861,123
348,POR,2016-12-13,114,,OKC,W 114-95,240,43,80,.538,35,57,.614,8,23,.348,20,27,.741,114,33,87,.379,25,60,.417,8,27,.296,21,28,.750,95
349,CLE,2016-12-09,114,,MIA,W 114-84,240,46,83,.554,37,59,.627,9,24,.375,13,19,.684,114,31,90,.344,25,63,.397,6,27,.222,16,21,.762,84
350,BOS,2016-11-30,114,,DET,L 114-121,240,40,91,.440,25,49,.510,15,42,.357,19,20,.950,114,48,87,.552,39,67,.582,9,20,.450,16,21,.762,121
351,PHO,2016-11-27,114,,DEN,L 114-120,240,36,89,.404,25,64,.391,11,25,.440,31,36,.861,114,39,89,.438,26,60,.433,13,29,.448,29,32,.906,120
352,POR,2016-11-27,114,,HOU,L 114-130,240,40,83,.482,28,50,.560,12,33,.364,22,29,.759,114,46,82,.561,29,46,.630,17,36,.472,21,28,.750,130
353,CHO,2016-11-23,114,,SAS,L 114-119,240,45,89,.506,34,69,.493,11,20,.550,13,18,.722,114,44,86,.512,31,55,.564,13,31,.419,18,20,.900,119
354,LAC,2016-11-07,114,,DET,W 114-82,240,41,76,.539,28,51,.549,13,25,.520,19,22,.864,114,30,82,.366,26,70,.371,4,12,.333,18,26,.692,82
355,NOP,2016-10-28,114,,GSW,L 114-122,240,47,100,.470,42,78,.538,5,22,.227,15,23,.652,114,44,91,.484,35,63,.556,9,28,.321,25,28,.893,122
356,ATL,2016-10-27,114,,WAS,W 114-99,240,44,88,.500,32,62,.516,12,26,.462,14,18,.778,114,40,94,.426,34,74,.459,6,20,.300,13,18,.722,99
357,ORL,2017-04-12,113,,DET,W 113-109,240,42,87,.483,29,62,.468,13,25,.520,16,17,.941,113,41,106,.387,30,70,.429,11,36,.306,16,28,.571,109
358,TOR,2017-04-02,113,,PHI,W 113-105,240,46,85,.541,40,66,.606,6,19,.316,15,19,.789,113,36,80,.450,25,44,.568,11,36,.306,22,25,.880,105
359,MIA,2017-04-02,113,,DEN,L 113-116,240,42,87,.483,29,60,.483,13,27,.481,16,21,.762,113,44,87,.506,39,67,.582,5,20,.250,23,27,.852,116
360,MEM,2017-03-13,113,,MIL,W 113-93,240,41,79,.519,27,52,.519,14,27,.519,17,23,.739,113,31,67,.463,17,41,.415,14,26,.538,17,20,.850,93
361,DEN,2017-03-08,113,,WAS,L 113-123,240,46,87,.529,33,59,.559,13,28,.464,8,17,.471,113,50,88,.568,39,62,.629,11,26,.423,12,19,.632,123
362,MIA,2017-02-25,113,,IND,W 113-95,240,38,78,.487,25,47,.532,13,31,.419,24,31,.774,113,34,85,.400,30,73,.411,4,12,.333,23,26,.885,95
363,CLE,2017-02-15,113,,IND,W 113-104,240,39,82,.476,21,43,.488,18,39,.462,17,19,.895,113,40,86,.465,28,62,.452,12,24,.500,12,14,.857,104
364,DAL,2017-02-07,113,,POR,L 113-114,240,37,75,.493,25,47,.532,12,28,.429,27,32,.844,113,42,86,.488,31,58,.534,11,28,.393,19,24,.792,114
365,MIN,2017-02-06,113,,MIA,L 113-115,240,43,80,.538,38,69,.551,5,11,.455,22,28,.786,113,45,86,.523,30,58,.517,15,28,.536,10,14,.714,115
366,DET,2017-02-06,113,,PHI,W 113-96,240,46,99,.465,41,77,.532,5,22,.227,16,17,.941,113,36,85,.424,31,57,.544,5,28,.179,19,28,.679,96
367,ATL,2017-02-04,113,,ORL,W 113-86,240,41,78,.526,31,50,.620,10,28,.357,21,27,.778,113,27,78,.346,20,51,.392,7,27,.259,25,28,.893,86
368,BOS,2017-02-03,113,,LAL,W 113-107,240,39,82,.476,26,47,.553,13,35,.371,22,28,.786,113,37,94,.394,23,56,.411,14,38,.368,19,26,.731,107
369,DAL,2017-02-01,113,,PHI,W 113-95,240,40,86,.465,30,60,.500,10,26,.385,23,28,.821,113,35,77,.455,29,55,.527,6,22,.273,19,26,.731,95
370,BOS,2017-01-30,113,,DET,W 113-109,240,36,82,.439,23,50,.460,13,32,.406,28,33,.848,113,43,97,.443,40,70,.571,3,27,.111,20,29,.690,109
371,TOR,2017-01-29,113,,ORL,L 113-114,240,36,79,.456,24,51,.471,12,28,.429,29,36,.806,113,42,79,.532,32,56,.571,10,23,.435,20,26,.769,114
372,DET,2017-01-21,113,,WAS,W 113-112,240,43,87,.494,32,59,.542,11,28,.393,16,22,.727,113,39,91,.429,31,65,.477,8,26,.308,26,33,.788,112
373,CHO,2017-01-20,113,,TOR,W 113-78,240,40,80,.500,28,55,.509,12,25,.480,21,25,.840,113,29,86,.337,22,56,.393,7,30,.233,13,14,.929,78
374,LAC,2017-01-14,113,,LAL,W 113-97,240,48,92,.522,38,64,.594,10,28,.357,7,8,.875,113,36,80,.450,26,59,.441,10,21,.476,15,27,.556,97
375,DAL,2017-01-03,113,,WAS,W 113-105,240,37,78,.474,20,46,.435,17,32,.531,22,24,.917,113,41,92,.446,30,62,.484,11,30,.367,12,14,.857,105
376,DEN,2017-01-03,113,,SAC,L 113-120,240,41,82,.500,23,44,.523,18,38,.474,13,13,1.000,113,46,88,.523,35,59,.593,11,29,.379,17,18,.944,120
377,BOS,2016-12-27,113,,MEM,W 113-103,240,41,85,.482,29,54,.537,12,31,.387,19,21,.905,113,37,88,.420,28,58,.483,9,30,.300,20,29,.690,103
378,DET,2016-12-23,113,,GSW,L 113-119,240,43,85,.506,33,56,.589,10,29,.345,17,28,.607,113,43,77,.558,32,50,.640,11,27,.407,22,24,.917,119
379,CLE,2016-12-21,113,,MIL,W 113-102,240,43,87,.494,28,60,.467,15,27,.556,12,19,.632,113,36,77,.468,27,55,.491,9,22,.409,21,29,.724,102
380,CHI,2016-12-19,113,,DET,W 113-82,240,49,82,.598,41,66,.621,8,16,.500,7,7,1.000,113,34,83,.410,31,60,.517,3,23,.130,11,13,.846,82
381,SAS,2016-12-18,113,,NOP,W 113-100,240,42,86,.488,31,64,.484,11,22,.500,18,22,.818,113,41,89,.461,31,63,.492,10,26,.385,8,14,.571,100
382,PHO,2016-12-13,113,,NYK,W 113-111 (OT),265,38,93,.409,29,63,.460,9,30,.300,28,33,.848,113,38,97,.392,31,77,.403,7,20,.350,28,38,.737,111
383,ORL,2016-12-10,113,,DEN,L 113-121,240,43,88,.489,32,61,.525,11,27,.407,16,24,.667,113,47,83,.566,39,64,.609,8,19,.421,19,25,.760,121
384,BRK,2016-12-05,113,,WAS,L 113-118,240,40,81,.494,29,54,.537,11,27,.407,22,30,.733,113,45,92,.489,31,58,.534,14,34,.412,14,18,.778,118
385,TOR,2016-12-02,113,,LAL,W 113-80,240,45,83,.542,33,54,.611,12,29,.414,11,13,.846,113,32,93,.344,26,67,.388,6,26,.231,10,17,.588,80
386,NYK,2016-11-25,113,,CHO,W 113-111 (OT),265,45,97,.464,34,69,.493,11,28,.393,12,13,.923,113,43,93,.462,35,64,.547,8,29,.276,17,27,.630,111
387,NOP,2016-11-18,113,,POR,W 113-101,240,45,82,.549,36,58,.621,9,24,.375,14,20,.700,113,33,88,.375,21,54,.389,12,34,.353,23,26,.885,101
388,NOP,2016-11-01,113,,MIL,L 113-117,240,36,82,.439,27,56,.482,9,26,.346,32,41,.780,113,44,91,.484,34,59,.576,10,32,.313,19,21,.905,117
389,OKC,2016-10-30,113,,LAL,W 113-96,240,45,95,.474,36,69,.522,9,26,.346,14,17,.824,113,35,87,.402,28,55,.509,7,32,.219,19,24,.792,96
390,DEN,2016-10-29,113,,POR,L 113-115 (OT),265,38,100,.380,32,77,.416,6,23,.261,31,39,.795,113,45,98,.459,35,66,.530,10,32,.313,15,21,.714,115
391,OKC,2016-10-28,113,,PHO,W 113-110 (OT),265,40,96,.417,35,75,.467,5,21,.238,28,38,.737,113,42,94,.447,37,66,.561,5,28,.179,21,32,.656,110
392,POR,2016-10-25,113,,UTA,W 113-104,240,39,75,.520,26,56,.464,13,19,.684,22,22,1.000,113,40,82,.488,32,58,.552,8,24,.333,16,16,1.000,104
393,CHI,2017-04-12,112,,BRK,W 112-73,240,41,95,.432,27,65,.415,14,30,.467,16,21,.762,112,28,86,.326,25,53,.472,3,33,.091,14,18,.778,73
394,BOS,2017-04-12,112,,MIL,W 112-94,240,41,91,.451,29,54,.537,12,37,.324,18,26,.692,112,37,84,.440,31,61,.508,6,23,.261,14,17,.824,94
395,ORL,2017-04-08,112,,IND,L 112-127,240,41,84,.488,27,54,.500,14,30,.467,16,22,.727,112,51,86,.593,40,64,.625,11,22,.500,14,19,.737,127
396,LAC,2017-04-05,112,,DAL,W 112-101,240,38,75,.507,26,44,.591,12,31,.387,24,31,.774,112,38,86,.442,27,55,.491,11,31,.355,14,18,.778,101
397,BOS,2017-03-26,112,,MIA,W 112-108,240,41,77,.532,33,53,.623,8,24,.333,22,25,.880,112,41,91,.451,34,62,.548,7,29,.241,19,24,.792,108
398,POR,2017-03-25,112,,MIN,W 112-100,240,45,71,.634,34,49,.694,11,22,.500,11,17,.647,112,37,76,.487,35,66,.530,2,10,.200,24,32,.750,100
399,MIA,2017-03-21,112,,PHO,W 112-97,240,42,96,.438,31,69,.449,11,27,.407,17,23,.739,112,36,82,.439,32,66,.485,4,16,.250,21,29,.724,97
400,ORL,2017-03-20,112,,PHI,W 112-109 (OT),265,35,94,.372,31,71,.437,4,23,.174,38,46,.826,112,39,102,.382,30,68,.441,9,34,.265,22,24,.917,109
401,DET,2017-03-19,112,,PHO,W 112-95,240,40,92,.435,28,67,.418,12,25,.480,20,30,.667,112,35,99,.354,29,77,.377,6,22,.273,19,30,.633,95
402,WAS,2017-03-17,112,,CHI,W 112-107,240,46,101,.455,36,75,.480,10,26,.385,10,12,.833,112,44,88,.500,37,61,.607,7,27,.259,12,18,.667,107
403,OKC,2017-03-11,112,,UTA,W 112-104,240,43,86,.500,35,63,.556,8,23,.348,18,24,.750,112,36,75,.480,27,55,.491,9,20,.450,23,28,.821,104
404,DET,2017-03-11,112,,NYK,W 112-92,240,46,96,.479,37,69,.536,9,27,.333,11,19,.579,112,36,82,.439,23,52,.442,13,30,.433,7,11,.636,92
405,LAC,2017-03-11,112,,PHI,W 112-100,240,40,81,.494,32,56,.571,8,25,.320,24,29,.828,112,40,84,.476,30,54,.556,10,30,.333,10,14,.714,100
406,SAS,2017-03-06,112,,HOU,W 112-110,240,40,88,.455,29,60,.483,11,28,.393,21,23,.913,112,41,88,.466,27,49,.551,14,39,.359,14,17,.824,110
407,MIL,2017-03-03,112,,LAC,W 112-101,240,44,80,.550,34,55,.618,10,25,.400,14,15,.933,112,36,64,.563,28,45,.622,8,19,.421,21,36,.583,101
408,UTA,2017-03-03,112,,BRK,W 112-97,240,38,74,.514,26,48,.542,12,26,.462,24,34,.706,112,36,89,.404,29,59,.492,7,30,.233,18,24,.750,97
409,WAS,2017-02-28,112,,GSW,W 112-108,240,41,91,.451,29,63,.460,12,28,.429,18,20,.900,112,39,84,.464,31,55,.564,8,29,.276,22,27,.815,108
410,TOR,2017-02-26,112,,POR,W 112-106,240,42,78,.538,35,58,.603,7,20,.350,21,27,.778,112,35,79,.443,26,58,.448,9,21,.429,27,35,.771,106
411,GSW,2017-02-25,112,,BRK,W 112-95,240,42,100,.420,31,69,.449,11,31,.355,17,22,.773,112,38,94,.404,30,66,.455,8,28,.286,11,17,.647,95
412,DAL,2017-02-11,112,,ORL,W 112-80,240,45,91,.495,28,56,.500,17,35,.486,5,6,.833,112,32,82,.390,29,59,.492,3,23,.130,13,18,.722,80
413,WAS,2017-02-10,112,,IND,W 112-107,240,41,88,.466,31,59,.525,10,29,.345,20,30,.667,112,45,92,.489,41,71,.577,4,21,.190,13,15,.867,107
414,DAL,2017-02-09,112,,UTA,W 112-105 (OT),265,44,87,.506,39,67,.582,5,20,.250,19,25,.760,112,39,85,.459,26,56,.464,13,29,.448,14,17,.824,105
415,MIN,2017-02-08,112,,TOR,W 112-109,240,39,80,.488,32,61,.525,7,19,.368,27,30,.900,112,42,79,.532,31,51,.608,11,28,.393,14,20,.700,109
416,PHO,2017-02-04,112,,MIL,L 112-137,240,38,91,.418,27,63,.429,11,28,.393,25,30,.833,112,52,82,.634,45,65,.692,7,17,.412,26,35,.743,137
417,PHO,2017-01-28,112,,DEN,L 112-123,240,41,91,.451,35,70,.500,6,21,.286,24,32,.750,112,39,80,.488,31,55,.564,8,25,.320,37,42,.881,123
418,POR,2017-01-27,112,,MEM,W 112-109,240,38,81,.469,22,46,.478,16,35,.457,20,21,.952,112,37,77,.481,28,51,.549,9,26,.346,26,33,.788,109
419,CLE,2017-01-25,112,,SAC,L 112-116 (OT),265,40,82,.488,25,44,.568,15,38,.395,17,34,.500,112,43,95,.453,32,64,.500,11,31,.355,19,22,.864,116
420,CHO,2017-01-21,112,,BRK,W 112-105,240,39,82,.476,25,52,.481,14,30,.467,20,22,.909,112,38,88,.432,21,47,.447,17,41,.415,12,15,.800,105
421,ORL,2017-01-20,112,,MIL,W 112-96,240,40,87,.460,32,59,.542,8,28,.286,24,31,.774,112,34,83,.410,24,58,.414,10,25,.400,18,26,.692,96
422,BRK,2017-01-15,112,,HOU,L 112-137,240,41,93,.441,26,49,.531,15,44,.341,15,19,.789,112,46,92,.500,25,48,.521,21,44,.477,24,32,.750,137
423,WAS,2017-01-06,112,,MIN,W 112-105,240,46,79,.582,34,57,.596,12,22,.545,8,9,.889,112,42,88,.477,35,70,.500,7,18,.389,14,17,.824,105
424,ORL,2016-12-26,112,,MEM,W 112-102,240,44,86,.512,31,60,.517,13,26,.500,11,16,.688,112,35,76,.461,25,51,.490,10,25,.400,22,28,.786,102
425,OKC,2016-12-25,112,,MIN,W 112-100,240,42,82,.512,34,58,.586,8,24,.333,20,24,.833,112,39,83,.470,35,71,.493,4,12,.333,18,23,.783,100
426,BOS,2016-12-23,112,,OKC,L 112-117,240,41,93,.441,32,65,.492,9,28,.321,21,26,.808,112,41,80,.513,30,54,.556,11,26,.423,24,36,.667,117
427,MIA,2016-12-12,112,,WAS,W 112-101,240,45,88,.511,36,62,.581,9,26,.346,13,19,.684,112,39,84,.464,34,61,.557,5,23,.217,18,22,.818,101
428,DAL,2016-12-12,112,,DEN,W 112-92,240,45,77,.584,33,51,.647,12,26,.462,10,12,.833,112,35,83,.422,28,58,.483,7,25,.280,15,18,.833,92
429,LAL,2016-12-11,112,,NYK,L 112-118,240,42,88,.477,32,60,.533,10,28,.357,18,22,.818,112,41,84,.488,31,62,.500,10,22,.455,26,31,.839,118
430,UTA,2016-12-06,112,,PHO,W 112-105,240,36,73,.493,24,46,.522,12,27,.444,28,32,.875,112,39,84,.464,33,66,.500,6,18,.333,21,25,.840,105
431,TOR,2016-12-05,112,,CLE,L 112-116,240,38,88,.432,25,56,.446,13,32,.406,23,27,.852,112,40,84,.476,26,52,.500,14,32,.438,22,27,.815,116
432,MIL,2016-12-03,112,,BRK,W 112-103,240,40,85,.471,34,61,.557,6,24,.250,26,36,.722,112,34,91,.374,23,50,.460,11,41,.268,24,33,.727,103
433,POR,2016-11-13,112,,DEN,W 112-105,240,39,99,.394,31,70,.443,8,29,.276,26,32,.813,112,36,91,.396,25,62,.403,11,29,.379,22,29,.759,105
434,CHI,2016-11-07,112,,ORL,W 112-80,240,42,89,.472,39,70,.557,3,19,.158,25,31,.806,112,33,85,.388,24,55,.436,9,30,.300,5,6,.833,80
435,ATL,2016-11-05,112,,HOU,W 112-97,240,45,85,.529,37,65,.569,8,20,.400,14,24,.583,112,37,85,.435,25,49,.510,12,36,.333,11,13,.846,97
436,OKC,2016-11-05,112,,MIN,W 112-92,240,45,86,.523,38,70,.543,7,16,.438,15,24,.625,112,33,84,.393,29,65,.446,4,19,.211,22,29,.759,92
437,MEM,2016-10-30,112,,WAS,W 112-103 (OT),265,39,88,.443,24,57,.421,15,31,.484,19,26,.731,112,38,86,.442,33,61,.541,5,25,.200,22,25,.880,103
438,PHI,2017-04-10,111,,IND,L 111-120,240,35,75,.467,22,42,.524,13,33,.394,28,31,.903,111,49,85,.576,44,69,.638,5,16,.313,17,21,.810,120
439,PHO,2017-04-05,111,,GSW,L 111-120,240,43,103,.417,36,76,.474,7,27,.259,18,26,.692,111,45,89,.506,32,59,.542,13,30,.433,17,24,.708,120
440,TOR,2017-03-31,111,,IND,W 111-100,240,37,82,.451,23,55,.418,14,27,.519,23,35,.657,111,36,87,.414,25,61,.410,11,26,.423,17,21,.810,100
441,ATL,2017-03-06,111,,GSW,L 111-119,240,38,82,.463,25,54,.463,13,28,.464,22,31,.710,111,41,87,.471,21,43,.488,20,44,.455,17,22,.773,119
442,UTA,2017-02-15,111,,POR,W 111-88,240,42,81,.519,31,59,.525,11,22,.500,16,23,.696,111,32,79,.405,23,57,.404,9,22,.409,15,20,.750,88
443,ORL,2017-02-09,111,,PHI,L 111-112,240,41,84,.488,31,63,.492,10,21,.476,19,24,.792,111,40,95,.421,29,67,.433,11,28,.393,21,27,.778,112
444,POR,2017-02-09,111,,BOS,L 111-120,240,39,77,.506,30,51,.588,9,26,.346,24,31,.774,111,44,91,.484,34,61,.557,10,30,.333,22,27,.815,120
445,CHO,2017-02-07,111,,BRK,W 111-107,240,40,102,.392,33,76,.434,7,26,.269,24,29,.828,111,39,86,.453,27,50,.540,12,36,.333,17,21,.810,107
446,NOP,2017-02-06,111,,PHO,W 111-106,240,42,92,.457,33,66,.500,9,26,.346,18,22,.818,111,40,93,.430,35,66,.530,5,27,.185,21,25,.840,106
447,MIN,2017-01-30,111,,ORL,W 111-105 (OT),265,40,91,.440,28,62,.452,12,29,.414,19,26,.731,111,41,96,.427,31,61,.508,10,35,.286,13,19,.684,105
448,POR,2017-01-29,111,,GSW,L 111-113,240,46,93,.495,36,66,.545,10,27,.370,9,12,.750,111,36,79,.456,28,53,.528,8,26,.308,33,39,.846,113
449,PHO,2017-01-24,111,,MIN,L 111-112,240,38,86,.442,31,67,.463,7,19,.368,28,32,.875,111,44,84,.524,38,67,.567,6,17,.353,18,24,.750,112
450,MIN,2017-01-22,111,,DEN,W 111-108,240,45,85,.529,39,70,.557,6,15,.400,15,21,.714,111,42,82,.512,35,58,.603,7,24,.292,17,21,.810,108
451,HOU,2017-01-18,111,,MIL,W 111-92,240,43,95,.453,29,51,.569,14,44,.318,11,15,.733,111,37,93,.398,30,65,.462,7,28,.250,11,14,.786,92
452,ATL,2017-01-15,111,,MIL,W 111-98,240,42,80,.525,29,54,.537,13,26,.500,14,18,.778,111,39,79,.494,33,60,.550,6,19,.316,14,18,.778,98
453,LAL,2017-01-08,111,,ORL,W 111-95,240,42,87,.483,34,55,.618,8,32,.250,19,24,.792,111,34,90,.378,27,64,.422,7,26,.269,20,29,.690,95
454,MIL,2017-01-06,111,,NYK,L 111-116,240,39,78,.500,27,56,.482,12,22,.545,21,28,.750,111,41,83,.494,28,60,.467,13,23,.565,21,27,.778,116
455,IND,2016-12-30,111,,CHI,W 111-101,240,39,81,.481,32,62,.516,7,19,.368,26,30,.867,111,35,84,.417,29,61,.475,6,23,.261,25,31,.806,101
456,WAS,2016-12-28,111,,IND,W 111-105,240,38,78,.487,30,56,.536,8,22,.364,27,37,.730,111,35,79,.443,24,51,.471,11,28,.393,24,29,.828,105
457,NOP,2016-12-26,111,,DAL,W 111-104,240,37,70,.529,25,45,.556,12,25,.480,25,30,.833,111,37,75,.493,24,43,.558,13,32,.406,17,22,.773,104
458,LAL,2016-12-25,111,,LAC,W 111-102,240,40,84,.476,32,59,.542,8,25,.320,23,30,.767,111,37,85,.435,27,56,.482,10,29,.345,18,22,.818,102
459,PHO,2016-12-21,111,,HOU,L 111-125,240,44,93,.473,35,68,.515,9,25,.360,14,20,.700,111,46,86,.535,28,48,.583,18,38,.474,15,26,.577,125
460,DAL,2016-12-09,111,,IND,W 111-103,240,39,80,.488,24,48,.500,15,32,.469,18,24,.750,111,32,69,.464,18,44,.409,14,25,.560,25,26,.962,103
461,CHI,2016-12-02,111,,CLE,W 111-105,240,47,96,.490,44,78,.564,3,18,.167,14,17,.824,111,45,83,.542,35,57,.614,10,26,.385,5,10,.500,105
462,LAL,2016-11-22,111,,OKC,W 111-109,240,42,83,.506,28,56,.500,14,27,.519,13,16,.813,111,45,92,.489,34,65,.523,11,27,.407,8,11,.727,109
463,OKC,2016-11-20,111,,IND,L 111-115 (OT),265,44,101,.436,34,65,.523,10,36,.278,13,18,.722,111,40,89,.449,29,67,.433,11,22,.500,24,31,.774,115
464,WAS,2016-11-19,111,,MIA,L 111-114,240,42,89,.472,31,62,.500,11,27,.407,16,22,.727,111,43,85,.506,30,58,.517,13,27,.481,15,26,.577,114
465,HOU,2016-11-19,111,,UTA,W 111-102,240,42,94,.447,30,62,.484,12,32,.375,15,20,.750,111,39,76,.513,27,49,.551,12,27,.444,12,17,.706,102
466,DEN,2016-11-18,111,,TOR,L 111-113 (OT),265,39,83,.470,35,58,.603,4,25,.160,29,39,.744,111,43,94,.457,35,71,.493,8,23,.348,19,31,.613,113
467,CHO,2016-11-11,111,,TOR,L 111-113,240,38,93,.409,21,52,.404,17,41,.415,18,24,.750,111,43,90,.478,37,68,.544,6,22,.273,21,22,.955,113
468,LAC,2016-11-09,111,,POR,W 111-80,240,38,87,.437,27,55,.491,11,32,.344,24,33,.727,111,31,88,.352,25,58,.431,6,30,.200,12,14,.857,80
469,IND,2016-11-05,111,,CHI,W 111-94,240,46,86,.535,34,60,.567,12,26,.462,7,12,.583,111,34,79,.430,28,61,.459,6,18,.333,20,25,.800,94
470,NOP,2016-11-04,111,,PHO,L 111-112 (OT),265,43,94,.457,33,64,.516,10,30,.333,15,28,.536,111,40,93,.430,32,69,.464,8,24,.333,24,28,.857,112
471,NYK,2016-10-29,111,,MEM,W 111-104,240,40,76,.526,34,55,.618,6,21,.286,25,39,.641,111,37,86,.430,28,61,.459,9,25,.360,21,26,.808,104
472,MIA,2017-04-12,110,,WAS,W 110-102,240,46,88,.523,38,64,.594,8,24,.333,10,12,.833,110,42,87,.483,35,61,.574,7,26,.269,11,14,.786,102
473,LAL,2017-04-09,110,,MIN,W 110-109,240,42,86,.488,32,59,.542,10,27,.370,16,20,.800,110,40,80,.500,37,65,.569,3,15,.200,26,31,.839,109
474,HOU,2017-04-05,110,,DEN,W 110-104,240,37,87,.425,27,53,.509,10,34,.294,26,38,.684,110,41,104,.394,34,66,.515,7,38,.184,15,18,.833,104
475,OKC,2017-04-04,110,,MIL,W 110-79,240,40,84,.476,31,56,.554,9,28,.321,21,25,.840,110,29,81,.358,26,63,.413,3,18,.167,18,26,.692,79
476,MIN,2017-04-03,110,,POR,W 110-109,240,41,84,.488,37,75,.493,4,9,.444,24,28,.857,110,38,86,.442,27,54,.500,11,32,.344,22,25,.880,109
477,NOP,2017-04-02,110,,CHI,L 110-117,240,33,81,.407,23,51,.451,10,30,.333,34,35,.971,110,45,92,.489,32,66,.485,13,26,.500,14,18,.778,117
478,MEM,2017-03-29,110,,IND,W 110-97,240,41,88,.466,29,56,.518,12,32,.375,16,18,.889,110,37,85,.435,27,60,.450,10,25,.400,13,15,.867,97
479,POR,2017-03-23,110,,NYK,W 110-95,240,39,80,.488,28,59,.475,11,21,.524,21,29,.724,110,36,88,.409,31,66,.470,5,22,.227,18,20,.900,95
480,BOS,2017-03-20,110,,WAS,W 110-102,240,40,93,.430,30,60,.500,10,33,.303,20,28,.714,110,37,86,.430,29,51,.569,8,35,.229,20,26,.769,102
481,OKC,2017-03-18,110,,SAC,W 110-94,240,41,82,.500,31,56,.554,10,26,.385,18,25,.720,110,35,85,.412,30,64,.469,5,21,.238,19,23,.826,94
482,NYK,2017-03-16,110,,BRK,L 110-121,240,41,88,.466,38,70,.543,3,18,.167,25,26,.962,110,41,86,.477,31,54,.574,10,32,.313,29,35,.829,121
483,PHO,2017-03-09,110,,LAL,L 110-122,240,42,91,.462,36,72,.500,6,19,.316,20,25,.800,110,47,98,.480,35,71,.493,12,27,.444,16,24,.667,122
484,ATL,2017-03-08,110,,BRK,W 110-105,240,41,95,.432,37,75,.493,4,20,.200,24,32,.750,110,37,80,.463,26,47,.553,11,33,.333,20,25,.800,105
485,ORL,2017-03-03,110,,MIA,W 110-99,240,45,90,.500,40,73,.548,5,17,.294,15,19,.789,110,35,91,.385,27,63,.429,8,28,.286,21,25,.840,99
486,NYK,2017-02-25,110,,PHI,W 110-109,240,43,91,.473,37,70,.529,6,21,.286,18,23,.783,110,40,95,.421,33,64,.516,7,31,.226,22,27,.815,109
487,OKC,2017-02-24,110,,LAL,W 110-93,240,44,97,.454,34,73,.466,10,24,.417,12,17,.706,110,40,101,.396,33,66,.500,7,35,.200,6,14,.429,93
488,BRK,2017-02-08,110,,WAS,L 110-114 (OT),265,38,91,.418,29,58,.500,9,33,.273,25,36,.694,110,40,97,.412,31,72,.431,9,25,.360,25,33,.758,114
489,MEM,2017-02-08,110,,PHO,W 110-91,240,35,72,.486,21,48,.438,14,24,.583,26,34,.765,110,29,87,.333,24,64,.375,5,23,.217,28,34,.824,91
490,DEN,2017-02-06,110,,DAL,W 110-87,240,42,84,.500,31,56,.554,11,28,.393,15,16,.938,110,34,79,.430,26,53,.491,8,26,.308,11,17,.647,87
491,NYK,2017-01-27,110,,CHO,W 110-107,240,46,96,.479,37,69,.536,9,27,.333,9,13,.692,110,40,90,.444,27,53,.509,13,37,.351,14,15,.933,107
492,ATL,2017-01-21,110,,PHI,W 110-93,240,45,91,.495,38,71,.535,7,20,.350,13,23,.565,110,33,78,.423,21,49,.429,12,29,.414,15,18,.833,93
493,NYK,2017-01-19,110,,WAS,L 110-113,240,42,90,.467,35,66,.530,7,24,.292,19,22,.864,110,44,88,.500,31,56,.554,13,32,.406,12,14,.857,113
494,UTA,2017-01-13,110,,DET,W 110-77,240,43,80,.538,27,49,.551,16,31,.516,8,13,.615,110,30,76,.395,24,59,.407,6,17,.353,11,16,.688,77
495,BOS,2017-01-06,110,,PHI,W 110-106,240,35,87,.402,16,47,.340,19,40,.475,21,25,.840,110,37,79,.468,28,51,.549,9,28,.321,23,26,.885,106
496,SAS,2017-01-03,110,,TOR,W 110-82,240,43,78,.551,30,54,.556,13,24,.542,11,15,.733,110,31,83,.373,27,65,.415,4,18,.222,16,22,.727,82
497,SAS,2016-12-30,110,,POR,W 110-94,240,39,78,.500,28,56,.500,11,22,.500,21,25,.840,110,35,77,.455,29,57,.509,6,20,.300,18,21,.857,94
498,NOP,2016-12-21,110,,OKC,L 110-121,240,42,88,.477,34,68,.500,8,20,.400,18,23,.783,110,45,88,.511,34,60,.567,11,28,.393,20,24,.833,121
499,IND,2016-12-12,110,,CHO,W 110-94,240,43,88,.489,26,52,.500,17,36,.472,7,10,.700,110,28,84,.333,18,58,.310,10,26,.385,28,32,.875,94
500,MEM,2016-12-10,110,,GSW,W 110-89,240,38,87,.437,30,61,.492,8,26,.308,26,29,.897,110,34,77,.442,25,50,.500,9,27,.333,12,20,.600,89
501,WAS,2016-12-10,110,,MIL,W 110-105,240,40,88,.455,32,67,.478,8,21,.381,22,28,.786,110,40,79,.506,27,54,.500,13,25,.520,12,15,.800,105
502,MIL,2016-12-09,110,,ATL,L 110-114,240,44,94,.468,32,66,.485,12,28,.429,10,14,.714,110,40,84,.476,28,50,.560,12,34,.353,22,29,.759,114
503,CHI,2016-12-05,110,,POR,L 110-112,240,35,83,.422,28,60,.467,7,23,.304,33,38,.868,110,45,93,.484,36,69,.522,9,24,.375,13,18,.722,112
504,DEN,2016-12-02,110,,HOU,L 110-128,240,46,104,.442,37,73,.507,9,31,.290,9,16,.563,110,45,88,.511,28,51,.549,17,37,.459,21,25,.840,128
505,UTA,2016-12-01,110,,MIA,L 110-111,240,40,73,.548,23,43,.535,17,30,.567,13,17,.765,110,44,86,.512,36,67,.537,8,19,.421,15,19,.789,111
506,DEN,2016-11-22,110,,CHI,W 110-107,240,43,100,.430,33,78,.423,10,22,.455,14,17,.824,110,43,95,.453,37,77,.481,6,18,.333,15,18,.833,107
507,LAL,2016-11-20,110,,CHI,L 110-118,240,41,93,.441,28,62,.452,13,31,.419,15,21,.714,110,45,87,.517,37,65,.569,8,22,.364,20,28,.714,118
508,MIN,2016-11-17,110,,PHI,W 110-86,240,43,84,.512,37,59,.627,6,25,.240,18,20,.900,110,31,83,.373,22,51,.431,9,32,.281,15,19,.789,86
509,NYK,2016-11-09,110,,BRK,W 110-96,240,44,92,.478,34,62,.548,10,30,.333,12,17,.706,110,33,79,.418,22,46,.478,11,33,.333,19,27,.704,96
510,MIL,2016-10-29,110,,BRK,W 110-108,240,41,88,.466,33,66,.500,8,22,.364,20,24,.833,110,37,84,.440,26,50,.520,11,34,.324,23,28,.821,108
511,GSW,2017-04-12,109,,LAL,W 109-94,240,41,90,.456,29,54,.537,12,36,.333,15,22,.682,109,41,93,.441,37,76,.487,4,17,.235,8,14,.571,94
512,HOU,2017-04-07,109,,DET,L 109-114,240,36,87,.414,20,36,.556,16,51,.314,21,28,.750,109,46,108,.426,37,82,.451,9,26,.346,13,16,.813,114
513,SAS,2017-04-02,109,,UTA,W 109-103,240,40,77,.519,30,58,.517,10,19,.526,19,22,.864,109,43,89,.483,34,65,.523,9,24,.375,8,13,.615,103
514,NYK,2017-03-27,109,,DET,W 109-95,240,45,84,.536,38,63,.603,7,21,.333,12,13,.923,109,36,84,.429,27,61,.443,9,23,.391,14,21,.667,95
515,BOS,2017-03-22,109,,IND,W 109-100,240,43,84,.512,32,57,.561,11,27,.407,12,14,.857,109,38,87,.437,27,59,.458,11,28,.393,13,19,.684,100
516,LAL,2017-03-21,109,,LAC,L 109-133,240,43,92,.467,37,72,.514,6,20,.300,17,27,.630,109,45,84,.536,30,51,.588,15,33,.455,28,32,.875,133
517,CHO,2017-03-13,109,,CHI,L 109-115,240,43,93,.462,36,64,.563,7,29,.241,16,19,.842,109,41,92,.446,27,52,.519,14,40,.350,19,22,.864,115
518,DET,2017-03-06,109,,CHI,W 109-95,240,45,92,.489,39,71,.549,6,21,.286,13,20,.650,109,34,83,.410,26,55,.473,8,28,.286,19,21,.905,95
519,MEM,2017-03-06,109,,BRK,L 109-122,240,34,77,.442,24,52,.462,10,25,.400,31,39,.795,109,39,73,.534,25,43,.581,14,30,.467,30,38,.789,122
520,PHO,2017-03-05,109,,BOS,W 109-106,240,42,94,.447,38,74,.514,4,20,.200,21,26,.808,109,32,85,.376,19,48,.396,13,37,.351,29,40,.725,106
521,SAC,2017-03-05,109,,UTA,L 109-110 (OT),265,43,83,.518,35,66,.530,8,17,.471,15,20,.750,109,41,90,.456,31,57,.544,10,33,.303,18,27,.667,110
522,NOP,2017-03-01,109,,DET,W 109-86,240,39,78,.500,30,53,.566,9,25,.360,22,23,.957,109,40,103,.388,37,80,.463,3,23,.130,3,17,.176,86
523,OKC,2017-02-28,109,,UTA,W 109-106,240,39,76,.513,24,54,.444,15,22,.682,16,23,.696,109,43,93,.462,34,71,.479,9,22,.409,11,13,.846,106
524,GSW,2017-02-15,109,,SAC,W 109-86,240,41,84,.488,28,48,.583,13,36,.361,14,21,.667,109,33,89,.371,26,65,.400,7,24,.292,13,17,.765,86
525,HOU,2017-02-15,109,,MIA,L 109-117,240,36,87,.414,23,47,.489,13,40,.325,24,31,.774,109,44,84,.524,31,49,.633,13,35,.371,16,24,.667,117
526,SAC,2017-02-04,109,,GSW,W 109-106 (OT),265,43,88,.489,36,65,.554,7,23,.304,16,19,.842,109,36,87,.414,21,43,.488,15,44,.341,19,24,.792,106
527,BOS,2017-02-01,109,,TOR,W 109-104,240,36,87,.414,24,51,.471,12,36,.333,25,30,.833,109,41,78,.526,33,47,.702,8,31,.258,14,25,.560,104
528,OKC,2017-01-26,109,,DAL,W 109-98,240,37,72,.514,28,50,.560,9,22,.409,26,36,.722,109,38,84,.452,27,58,.466,11,26,.423,11,13,.846,98
529,MIL,2017-01-25,109,,PHI,L 109-114,240,42,91,.462,35,63,.556,7,28,.250,18,23,.783,109,40,75,.533,28,49,.571,12,26,.462,22,25,.880,114
530,UTA,2017-01-21,109,,IND,W 109-100,240,39,84,.464,33,60,.550,6,24,.250,25,32,.781,109,39,77,.506,29,57,.509,10,20,.500,12,17,.706,100
531,MIA,2017-01-21,109,,MIL,W 109-97,240,41,77,.532,28,47,.596,13,30,.433,14,22,.636,109,33,79,.418,27,61,.443,6,18,.333,25,32,.781,97
532,BRK,2017-01-17,109,,TOR,L 109-119,240,40,89,.449,33,63,.524,7,26,.269,22,24,.917,109,48,92,.522,38,73,.521,10,19,.526,13,16,.813,119
533,MIA,2017-01-17,109,,HOU,W 109-103,240,42,90,.467,33,61,.541,9,29,.310,16,24,.667,109,36,90,.400,27,51,.529,9,39,.231,22,28,.786,103
534,WAS,2017-01-14,109,,PHI,W 109-93,240,44,91,.484,36,74,.486,8,17,.471,13,18,.722,109,36,87,.414,26,56,.464,10,31,.323,11,21,.524,93
535,POR,2017-01-13,109,,ORL,L 109-115,240,39,97,.402,29,63,.460,10,34,.294,21,25,.840,109,41,83,.494,31,65,.477,10,18,.556,23,26,.885,115
536,LAC,2017-01-02,109,,PHO,W 109-98,240,37,80,.463,30,64,.469,7,16,.438,28,38,.737,109,39,102,.382,37,87,.425,2,15,.133,18,22,.818,98
537,CHO,2016-12-31,109,,CLE,L 109-121,240,40,78,.513,31,54,.574,9,24,.375,20,23,.870,109,43,85,.506,29,54,.537,14,31,.452,21,25,.840,121
538,CLE,2016-12-25,109,,GSW,W 109-108,240,37,95,.389,25,60,.417,12,35,.343,23,32,.719,109,37,77,.481,28,47,.596,9,30,.300,25,29,.862,108
539,ORL,2016-12-23,109,,LAL,W 109-90,240,45,89,.506,34,62,.548,11,27,.407,8,14,.571,109,31,87,.356,23,64,.359,8,23,.348,20,24,.833,90
540,MEM,2016-12-20,109,,BOS,L 109-112 (OT),265,38,94,.404,26,64,.406,12,30,.400,21,26,.808,109,33,81,.407,21,44,.477,12,37,.324,34,38,.895,112
541,MIN,2016-12-17,109,,HOU,L 109-111 (OT),265,41,92,.446,34,71,.479,7,21,.333,20,27,.741,109,39,96,.406,22,45,.489,17,51,.333,16,20,.800,111
542,WAS,2016-12-14,109,,CHO,W 109-106,240,45,87,.517,40,69,.580,5,18,.278,14,17,.824,109,38,74,.514,24,41,.585,14,33,.424,16,21,.762,106
543,UTA,2016-12-14,109,,OKC,W 109-89,240,42,72,.583,29,49,.592,13,23,.565,12,15,.800,109,30,82,.366,24,63,.381,6,19,.316,23,27,.852,89
544,NOP,2016-12-13,109,,GSW,L 109-113,240,39,82,.476,25,47,.532,14,35,.400,17,21,.810,109,42,95,.442,28,61,.459,14,34,.412,15,19,.789,113
545,HOU,2016-12-10,109,,DAL,W 109-87,240,37,74,.500,18,37,.486,19,37,.514,16,22,.727,109,32,79,.405,21,45,.467,11,34,.324,12,14,.857,87
546,CHO,2016-12-09,109,,ORL,W 109-88,240,41,85,.482,32,63,.508,9,22,.409,18,23,.783,109,34,91,.374,25,57,.439,9,34,.265,11,14,.786,88
547,PHO,2016-11-30,109,,ATL,W 109-107,240,40,89,.449,30,68,.441,10,21,.476,19,25,.760,109,45,89,.506,36,64,.563,9,25,.360,8,10,.800,107
548,LAL,2016-11-27,109,,ATL,W 109-94,240,42,95,.442,34,75,.453,8,20,.400,17,20,.850,109,39,88,.443,27,53,.509,12,35,.343,4,10,.400,94
549,BRK,2016-11-20,109,,POR,L 109-129,240,37,93,.398,27,58,.466,10,35,.286,25,31,.806,109,49,85,.576,34,49,.694,15,36,.417,16,21,.762,129
550,PHI,2016-11-16,109,,WAS,W 109-102,240,42,77,.545,32,49,.653,10,28,.357,15,22,.682,109,38,91,.418,30,68,.441,8,23,.348,18,25,.720,102
551,PHI,2016-11-11,109,,IND,W 109-105 (OT),265,36,86,.419,25,54,.463,11,32,.344,26,31,.839,109,39,88,.443,34,69,.493,5,19,.263,22,23,.957,105
552,NYK,2016-11-06,109,,UTA,L 109-114,240,42,83,.506,34,63,.540,8,20,.400,17,19,.895,109,38,75,.507,30,50,.600,8,25,.320,30,35,.857,114
553,BRK,2016-11-02,109,,DET,W 109-101,240,41,76,.539,28,49,.571,13,27,.481,14,17,.824,109,37,88,.420,28,63,.444,9,25,.360,18,21,.857,101
554,CHO,2016-11-02,109,,PHI,W 109-93,240,39,79,.494,26,45,.578,13,34,.382,18,26,.692,109,34,86,.395,22,48,.458,12,38,.316,13,15,.867,93
555,TOR,2016-10-26,109,,DET,W 109-91,240,41,86,.477,38,68,.559,3,18,.167,24,29,.828,109,35,84,.417,31,62,.500,4,22,.182,17,22,.773,91
556,LAL,2017-04-11,108,,NOP,W 108-96,240,42,88,.477,34,66,.515,8,22,.364,16,23,.696,108,37,79,.468,30,57,.526,7,22,.318,15,20,.750,96
557,IND,2017-04-04,108,,TOR,W 108-90,240,39,89,.438,27,64,.422,12,25,.480,18,18,1.000,108,34,76,.447,29,53,.547,5,23,.217,17,19,.895,90
558,LAL,2017-04-02,108,,MEM,W 108-103,240,40,85,.471,33,66,.500,7,19,.368,21,27,.778,108,40,80,.500,27,50,.540,13,30,.433,10,14,.714,103
559,MIL,2017-03-31,108,,DET,W 108-105 (OT),265,35,84,.417,21,48,.438,14,36,.389,24,34,.706,108,44,97,.454,37,67,.552,7,30,.233,10,16,.625,105
560,LAL,2017-03-28,108,,WAS,L 108-119,240,43,85,.506,35,63,.556,8,22,.364,14,16,.875,108,48,94,.511,42,71,.592,6,23,.261,17,25,.680,119
561,CHO,2017-03-28,108,,MIL,L 108-118,240,39,80,.488,32,52,.615,7,28,.250,23,29,.793,108,46,74,.622,32,44,.727,14,30,.467,12,17,.706,118
562,UTA,2017-03-27,108,,NOP,W 108-100,240,41,85,.482,26,58,.448,15,27,.556,11,18,.611,108,37,80,.463,27,55,.491,10,25,.400,16,24,.667,100
563,LAC,2017-03-25,108,,UTA,W 108-95,240,38,84,.452,31,57,.544,7,27,.259,25,28,.893,108,37,86,.430,29,60,.483,8,26,.308,13,18,.722,95
564,UTA,2017-03-22,108,,NYK,W 108-101,240,41,90,.456,34,62,.548,7,28,.250,19,29,.655,108,38,80,.475,29,59,.492,9,21,.429,16,18,.889,101
565,LAC,2017-03-18,108,,CLE,W 108-78,240,40,78,.513,32,52,.615,8,26,.308,20,29,.690,108,32,83,.386,27,56,.482,5,27,.185,9,13,.692,78
566,MIA,2017-03-08,108,,CHO,W 108-101,240,37,85,.435,20,44,.455,17,41,.415,17,24,.708,108,37,80,.463,30,59,.508,7,21,.333,20,21,.952,101
567,HOU,2017-03-08,108,,UTA,L 108-115,240,35,79,.443,27,47,.574,8,32,.250,30,40,.750,108,41,76,.539,29,45,.644,12,31,.387,21,24,.875,115
568,DEN,2017-03-06,108,,SAC,W 108-96,240,37,74,.500,24,44,.545,13,30,.433,21,28,.750,108,36,83,.434,30,67,.448,6,16,.375,18,21,.857,96
569,PHI,2017-02-27,108,,GSW,L 108-119,240,37,82,.451,27,48,.563,10,34,.294,24,27,.889,108,40,89,.449,34,60,.567,6,29,.207,33,39,.846,119
570,HOU,2017-02-27,108,,IND,L 108-117,240,32,88,.364,22,43,.512,10,45,.222,34,42,.810,108,41,91,.451,28,61,.459,13,30,.433,22,25,.880,117
571,MIN,2017-02-14,108,,CLE,L 108-116,240,42,86,.488,33,63,.524,9,23,.391,15,19,.789,108,44,86,.512,31,47,.660,13,39,.333,15,22,.682,116
572,PHO,2017-02-13,108,,NOP,L 108-110,240,40,93,.430,32,70,.457,8,23,.348,20,24,.833,108,37,78,.474,29,50,.580,8,28,.286,28,35,.800,110
573,SAC,2017-02-10,108,,ATL,W 108-107,240,38,80,.475,20,44,.455,18,36,.500,14,21,.667,108,36,71,.507,25,41,.610,11,30,.367,24,31,.774,107
574,SAC,2017-02-08,108,,BOS,W 108-92,240,42,84,.500,32,59,.542,10,25,.400,14,15,.933,108,29,73,.397,19,41,.463,10,32,.313,24,27,.889,92
575,HOU,2017-02-02,108,,ATL,L 108-113,240,35,93,.376,22,42,.524,13,51,.255,25,33,.758,108,44,85,.518,36,55,.655,8,30,.267,17,23,.739,113
576,TOR,2017-01-31,108,,NOP,W 108-106 (OT),265,43,94,.457,33,63,.524,10,31,.323,12,15,.800,108,40,94,.426,28,64,.438,12,30,.400,14,19,.737,106
577,SAS,2017-01-31,108,,OKC,W 108-94,240,37,86,.430,30,65,.462,7,21,.333,27,38,.711,108,30,85,.353,23,57,.404,7,28,.250,27,32,.844,94
578,MIL,2017-01-28,108,,BOS,L 108-112 (OT),265,37,87,.425,28,66,.424,9,21,.429,25,32,.781,108,37,89,.416,23,48,.479,14,41,.341,24,30,.800,112
579,LAL,2017-01-20,108,,IND,W 108-95,240,41,87,.471,27,54,.500,14,33,.424,12,15,.800,108,34,80,.425,25,57,.439,9,23,.391,18,25,.720,95
580,HOU,2017-01-20,108,,GSW,L 108-125,240,43,96,.448,36,61,.590,7,35,.200,15,18,.833,108,47,89,.528,32,51,.627,15,38,.395,16,21,.762,125
581,BOS,2017-01-16,108,,CHO,W 108-98,240,42,84,.500,27,45,.600,15,39,.385,9,10,.900,108,38,86,.442,30,61,.492,8,25,.320,14,17,.824,98
582,PHO,2017-01-14,108,,SAS,W 108-105,240,39,85,.459,31,64,.484,8,21,.381,22,24,.917,108,36,71,.507,27,51,.529,9,20,.450,24,34,.706,105
583,SAC,2017-01-13,108,,CLE,L 108-120,240,42,80,.525,33,55,.600,9,25,.360,15,19,.789,108,44,87,.506,29,50,.580,15,37,.405,17,22,.773,120
584,PHO,2017-01-12,108,,DAL,L 108-113,240,38,78,.487,28,60,.467,10,18,.556,22,27,.815,108,43,89,.483,28,55,.509,15,34,.441,12,17,.706,113
585,BRK,2017-01-06,108,,CLE,L 108-116,240,41,91,.451,32,61,.525,9,30,.300,17,19,.895,108,38,88,.432,29,55,.527,9,33,.273,31,43,.721,116
586,GSW,2016-12-30,108,,DAL,W 108-99,240,42,84,.500,31,51,.608,11,33,.333,13,15,.867,108,39,93,.419,31,61,.508,8,32,.250,13,15,.867,99
587,DEN,2016-12-23,108,,ATL,L 108-109,240,37,78,.474,29,53,.547,8,25,.320,26,35,.743,108,37,86,.430,29,61,.475,8,25,.320,27,33,.818,109
588,MIL,2016-12-20,108,,CLE,L 108-114 (OT),265,40,87,.460,33,60,.550,7,27,.259,21,29,.724,108,37,91,.407,20,51,.392,17,40,.425,23,27,.852,114
589,OKC,2016-12-19,108,,ATL,L 108-110,240,39,87,.448,29,52,.558,10,35,.286,20,26,.769,108,41,75,.547,32,52,.615,9,23,.391,19,24,.792,110
590,PHI,2016-12-18,108,,BRK,W 108-107,240,38,88,.432,26,60,.433,12,28,.429,20,23,.870,108,36,81,.444,24,47,.511,12,34,.353,23,31,.742,107
591,MIL,2016-12-15,108,,CHI,W 108-97,240,45,95,.474,34,75,.453,11,20,.550,7,13,.538,108,35,74,.473,30,54,.556,5,20,.250,22,29,.759,97
592,ORL,2016-12-14,108,,LAC,L 108-113,240,42,89,.472,28,56,.500,14,33,.424,10,20,.500,108,37,74,.500,24,49,.490,13,25,.520,26,37,.703,113
593,SAS,2016-12-14,108,,BOS,W 108-101,240,44,80,.550,36,58,.621,8,22,.364,12,14,.857,108,37,84,.440,27,53,.509,10,31,.323,17,20,.850,101
594,MIN,2016-12-11,108,,GSW,L 108-116,240,36,81,.444,27,57,.474,9,24,.375,27,36,.750,108,38,83,.458,25,51,.490,13,32,.406,27,30,.900,116
595,NOP,2016-12-05,108,,MEM,L 108-110 (2OT),290,39,99,.394,29,67,.433,10,32,.313,20,21,.952,108,42,104,.404,29,70,.414,13,34,.382,13,21,.619,110
596,PHI,2016-11-27,108,,CLE,L 108-112,240,43,92,.467,28,58,.483,15,34,.441,7,10,.700,108,38,92,.413,26,52,.500,12,40,.300,24,28,.857,112
597,DET,2016-11-25,108,,LAC,W 108-97,240,47,90,.522,38,71,.535,9,19,.474,5,7,.714,108,35,73,.479,28,52,.538,7,21,.333,20,26,.769,97
598,UTA,2016-11-23,108,,DEN,W 108-83,240,39,79,.494,31,53,.585,8,26,.308,22,31,.710,108,28,88,.318,19,61,.311,9,27,.333,18,31,.581,83
599,MIN,2016-11-15,108,,CHO,L 108-115,240,38,89,.427,23,54,.426,15,35,.429,17,21,.810,108,43,80,.538,32,56,.571,11,24,.458,18,22,.818,115
600,OKC,2016-11-11,108,,LAC,L 108-110,240,38,88,.432,22,60,.367,16,28,.571,16,19,.842,108,39,86,.453,28,59,.475,11,27,.407,21,35,.600,110
601,MEM,2016-11-08,108,,DEN,W 108-107,240,44,86,.512,37,62,.597,7,24,.292,13,19,.684,108,35,70,.500,25,46,.543,10,24,.417,27,34,.794,107
602,MIA,2016-11-01,108,,SAC,W 108-96 (OT),265,37,86,.430,24,57,.421,13,29,.448,21,29,.724,108,34,89,.382,29,66,.439,5,23,.217,23,27,.852,96
603,DET,2016-10-28,108,,ORL,W 108-82,240,48,95,.505,41,76,.539,7,19,.368,5,6,.833,108,33,95,.347,25,69,.362,8,26,.308,8,12,.667,82
604,BRK,2017-04-08,107,,CHI,W 107-106,240,39,92,.424,29,61,.475,10,31,.323,19,24,.792,107,40,90,.444,29,66,.439,11,24,.458,15,17,.882,106
605,GSW,2017-03-31,107,,HOU,W 107-98,240,43,95,.453,32,63,.508,11,32,.344,10,14,.714,107,34,91,.374,22,54,.407,12,37,.324,18,23,.783,98
606,IND,2017-03-26,107,,PHI,W 107-94,240,38,89,.427,31,72,.431,7,17,.412,24,29,.828,107,35,88,.398,21,47,.447,14,41,.341,10,14,.714,94
607,CHI,2017-03-24,107,,PHI,L 107-117,240,37,91,.407,27,67,.403,10,24,.417,23,31,.742,107,46,83,.554,38,58,.655,8,25,.320,17,23,.739,117
608,IND,2017-03-20,107,,UTA,W 107-100,240,38,87,.437,28,67,.418,10,20,.500,21,23,.913,107,40,88,.455,34,63,.540,6,25,.240,14,20,.700,100
609,WAS,2017-03-15,107,,DAL,L 107-112,240,40,82,.488,28,52,.538,12,30,.400,15,21,.714,107,40,79,.506,26,47,.553,14,32,.438,18,25,.720,112
610,SAS,2017-03-13,107,,ATL,W 107-99,240,39,81,.481,23,47,.489,16,34,.471,13,17,.765,107,37,81,.457,31,59,.525,6,22,.273,19,30,.633,99
611,SAS,2017-03-11,107,,GSW,W 107-85,240,40,77,.519,28,50,.560,12,27,.444,15,18,.833,107,33,92,.359,28,75,.373,5,17,.294,14,23,.609,85
612,MIN,2017-03-08,107,,LAC,W 107-91,240,42,86,.488,37,66,.561,5,20,.250,18,20,.900,107,35,83,.422,26,59,.441,9,24,.375,12,18,.667,91
613,CHI,2017-02-28,107,,DEN,L 107-125,240,44,96,.458,34,70,.486,10,26,.385,9,10,.900,107,45,80,.563,32,50,.640,13,30,.433,22,24,.917,125
614,TOR,2017-02-24,107,,BOS,W 107-97,240,40,81,.494,35,66,.530,5,15,.333,22,29,.759,107,33,78,.423,21,40,.525,12,38,.316,19,22,.864,97
615,MIA,2017-02-13,107,,ORL,L 107-116,240,39,83,.470,33,61,.541,6,22,.273,23,27,.852,107,44,90,.489,36,76,.474,8,14,.571,20,29,.690,116
616,MEM,2017-02-10,107,,GSW,L 107-122,240,34,87,.391,25,61,.410,9,26,.346,30,37,.811,107,39,77,.506,24,44,.545,15,33,.455,29,38,.763,122
617,NYK,2017-02-06,107,,LAL,L 107-121,240,37,82,.451,30,61,.492,7,21,.333,26,33,.788,107,44,102,.431,36,74,.486,8,28,.286,25,31,.806,121
618,SAC,2017-02-06,107,,CHI,L 107-112,240,41,79,.519,30,51,.588,11,28,.393,14,16,.875,107,43,81,.531,37,62,.597,6,19,.316,20,31,.645,112
619,BOS,2017-02-05,107,,LAC,W 107-102,240,37,88,.420,21,36,.583,16,52,.308,17,20,.850,107,35,84,.417,25,55,.455,10,29,.345,22,28,.786,102
620,CLE,2017-01-29,107,,OKC,W 107-91,240,41,92,.446,33,63,.524,8,29,.276,17,22,.773,107,37,100,.370,31,74,.419,6,26,.231,11,16,.688,91
621,MEM,2017-01-20,107,,SAC,W 107-91,240,38,83,.458,27,55,.491,11,28,.393,20,25,.800,107,31,76,.408,25,47,.532,6,29,.207,23,32,.719,91
622,DAL,2017-01-20,107,,UTA,L 107-112 (OT),265,39,87,.448,31,64,.484,8,23,.348,21,28,.750,107,38,83,.458,30,60,.500,8,23,.348,28,39,.718,112
623,CHO,2017-01-18,107,,POR,W 107-85,240,41,87,.471,30,61,.492,11,26,.423,14,17,.824,107,33,94,.351,25,63,.397,8,31,.258,11,11,1.000,85
624,NYK,2017-01-16,107,,ATL,L 107-108,240,42,85,.494,34,59,.576,8,26,.308,15,23,.652,107,40,87,.460,28,55,.509,12,32,.375,16,23,.696,108
625,CHI,2017-01-14,107,,NOP,W 107-99,240,43,101,.426,35,81,.432,8,20,.400,13,23,.565,107,39,84,.464,32,61,.525,7,23,.304,14,21,.667,99
626,SAS,2017-01-10,107,,MIL,L 107-109,240,42,88,.477,30,58,.517,12,30,.400,11,14,.786,107,44,84,.524,34,65,.523,10,19,.526,11,13,.846,109
627,GSW,2017-01-10,107,,MIA,W 107-95,240,39,86,.453,28,59,.475,11,27,.407,18,22,.818,107,38,90,.422,32,60,.533,6,30,.200,13,17,.765,95
628,DAL,2016-12-27,107,,HOU,L 107-123,240,36,87,.414,21,49,.429,15,38,.395,20,25,.800,107,41,78,.526,24,46,.522,17,32,.531,24,28,.857,123
629,WAS,2016-12-26,107,,MIL,W 107-102,240,40,79,.506,28,50,.560,12,29,.414,15,20,.750,107,40,87,.460,34,67,.507,6,20,.300,16,23,.696,102
630,IND,2016-12-19,107,,WAS,W 107-105,240,41,87,.471,34,66,.515,7,21,.333,18,21,.857,107,38,88,.432,30,55,.545,8,33,.242,21,26,.808,105
631,BRK,2016-12-14,107,,LAL,W 107-97,240,33,86,.384,22,51,.431,11,35,.314,30,40,.750,107,35,91,.385,29,64,.453,6,27,.222,21,34,.618,97
632,HOU,2016-12-05,107,,BOS,W 107-106,240,34,76,.447,22,38,.579,12,38,.316,27,31,.871,107,42,99,.424,31,67,.463,11,32,.344,11,12,.917,106
633,DAL,2016-12-03,107,,CHI,W 107-82,240,40,87,.460,27,56,.482,13,31,.419,14,18,.778,107,32,71,.451,29,58,.500,3,13,.231,15,21,.714,82
634,SAS,2016-12-02,107,,WAS,W 107-105,240,39,80,.488,31,60,.517,8,20,.400,21,33,.636,107,41,81,.506,34,70,.486,7,11,.636,16,18,.889,105
635,MIA,2016-11-26,107,,MEM,L 107-110,240,40,81,.494,29,50,.580,11,31,.355,16,24,.667,107,37,73,.507,28,48,.583,9,25,.360,27,33,.818,110
636,CHO,2016-11-26,107,,NYK,W 107-102,240,35,80,.438,27,58,.466,8,22,.364,29,42,.690,107,37,99,.374,25,67,.373,12,32,.375,16,20,.800,102
637,DET,2016-11-23,107,,MIA,W 107-84,240,40,81,.494,34,62,.548,6,19,.316,21,25,.840,107,27,75,.360,20,49,.408,7,26,.269,23,30,.767,84
638,NYK,2016-11-22,107,,POR,W 107-103,240,45,96,.469,36,67,.537,9,29,.310,8,8,1.000,107,38,86,.442,32,64,.500,6,22,.273,21,26,.808,103
639,LAL,2016-11-18,107,,SAS,L 107-116,240,39,87,.448,27,62,.435,12,25,.480,17,21,.810,107,44,78,.564,34,54,.630,10,24,.417,18,19,.947,116
640,ATL,2016-11-16,107,,MIL,W 107-100,240,35,72,.486,25,40,.625,10,32,.313,27,31,.871,107,39,98,.398,31,66,.470,8,32,.250,14,18,.778,100
641,LAC,2016-11-16,107,,MEM,L 107-111,240,37,81,.457,28,56,.500,9,25,.360,24,34,.706,107,40,82,.488,25,56,.446,15,26,.577,16,19,.842,111
642,ORL,2016-11-09,107,,MIN,L 107-123,240,38,85,.447,30,61,.492,8,24,.333,23,30,.767,107,45,87,.517,32,64,.500,13,23,.565,20,26,.769,123
643,PHO,2016-11-09,107,,DET,W 107-100,240,38,84,.452,30,62,.484,8,22,.364,23,30,.767,107,32,89,.360,23,67,.343,9,22,.409,27,32,.844,100
644,BOS,2016-11-06,107,,DEN,L 107-123,240,41,90,.456,33,65,.508,8,25,.320,17,21,.810,107,44,84,.524,33,61,.541,11,23,.478,24,31,.774,123
645,BOS,2016-11-02,107,,CHI,W 107-100,240,41,87,.471,27,55,.491,14,32,.438,11,17,.647,107,35,81,.432,28,61,.459,7,20,.350,23,31,.742,100
646,UTA,2017-04-04,106,,POR,W 106-87,240,39,74,.527,26,51,.510,13,23,.565,15,19,.789,106,33,83,.398,27,57,.474,6,26,.231,15,17,.882,87
647,CHI,2017-04-01,106,,ATL,W 106-104,240,40,85,.471,28,55,.509,12,30,.400,14,14,1.000,106,40,90,.444,29,62,.468,11,28,.393,13,17,.765,104
648,TOR,2017-03-29,106,,CHO,L 106-110,240,38,83,.458,27,52,.519,11,31,.355,19,24,.792,106,39,86,.453,23,54,.426,16,32,.500,16,21,.762,110
649,ORL,2017-03-29,106,,OKC,L 106-114 (OT),265,39,97,.402,30,67,.448,9,30,.300,19,27,.704,106,43,102,.422,33,69,.478,10,33,.303,18,28,.643,114
650,HOU,2017-03-28,106,,GSW,L 106-113,240,33,85,.388,28,54,.519,5,31,.161,35,39,.897,106,45,88,.511,34,47,.723,11,41,.268,12,16,.750,113
651,GSW,2017-03-26,106,,MEM,W 106-94,240,39,71,.549,22,40,.550,17,31,.548,11,15,.733,106,38,85,.447,30,56,.536,8,29,.276,10,15,.667,94
652,SAS,2017-03-25,106,,NYK,W 106-98,240,45,99,.455,35,74,.473,10,25,.400,6,8,.750,106,41,87,.471,38,77,.494,3,10,.300,13,15,.867,98
653,SAS,2017-03-15,106,,POR,L 106-110,240,42,88,.477,31,62,.500,11,26,.423,11,15,.733,106,38,80,.475,29,58,.500,9,22,.409,25,28,.893,110
654,GSW,2017-03-14,106,,PHI,W 106-104,240,32,88,.364,18,56,.321,14,32,.438,28,35,.800,106,39,89,.438,31,62,.500,8,27,.296,18,27,.667,104
655,DET,2017-03-09,106,,CLE,W 106-101,240,41,88,.466,32,62,.516,9,26,.346,15,19,.789,106,39,84,.464,28,45,.622,11,39,.282,12,19,.632,101
656,PHI,2017-03-04,106,,DET,L 106-136,240,43,88,.489,29,54,.537,14,34,.412,6,7,.857,106,54,95,.568,44,72,.611,10,23,.435,18,21,.857,136
657,WAS,2017-03-03,106,,TOR,L 106-114,240,34,92,.370,24,62,.387,10,30,.333,28,32,.875,106,41,81,.506,30,56,.536,11,25,.440,21,27,.778,114
658,IND,2017-02-13,106,,SAS,L 106-110,240,38,78,.487,29,58,.500,9,20,.450,21,30,.700,106,40,87,.460,33,72,.458,7,15,.467,23,27,.852,110
659,MIN,2017-02-10,106,,NOP,L 106-122,240,38,82,.463,32,55,.582,6,27,.222,24,32,.750,106,45,75,.600,33,50,.660,12,25,.480,20,27,.741,122
660,CHO,2017-01-28,106,,SAC,L 106-109,240,36,75,.480,24,38,.632,12,37,.324,22,24,.917,106,41,79,.519,30,52,.577,11,27,.407,16,26,.615,109
661,BRK,2017-01-25,106,,MIA,L 106-109,240,35,80,.438,22,45,.489,13,35,.371,23,26,.885,106,40,83,.482,29,60,.483,11,23,.478,18,25,.720,109
662,TOR,2017-01-24,106,,SAS,L 106-108,240,38,84,.452,32,59,.542,6,25,.240,24,28,.857,106,38,85,.447,31,61,.508,7,24,.292,25,33,.758,108
663,BOS,2017-01-18,106,,NYK,L 106-117,240,35,91,.385,26,58,.448,9,33,.273,27,29,.931,106,46,91,.505,36,66,.545,10,25,.400,15,18,.833,117
664,SAC,2017-01-08,106,,GSW,L 106-117,240,36,74,.486,25,46,.543,11,28,.393,23,29,.793,106,45,89,.506,35,60,.583,10,29,.345,17,20,.850,117
665,DET,2016-12-26,106,,CLE,W 106-90,240,41,92,.446,25,64,.391,16,28,.571,8,15,.533,106,30,79,.380,19,51,.373,11,28,.393,19,23,.826,90
666,NYK,2016-12-22,106,,ORL,W 106-95,240,41,96,.427,32,76,.421,9,20,.450,15,17,.882,106,39,90,.433,34,63,.540,5,27,.185,12,16,.750,95
667,LAC,2016-12-22,106,,SAS,W 106-101,240,39,83,.470,28,55,.509,11,28,.393,17,22,.773,106,37,92,.402,31,73,.425,6,19,.316,21,25,.840,101
668,NYK,2016-12-04,106,,SAC,W 106-98,240,39,88,.443,28,59,.475,11,29,.379,17,24,.708,106,31,97,.320,22,69,.319,9,28,.321,27,31,.871,98
669,PHI,2016-12-03,106,,BOS,L 106-107,240,35,76,.461,20,43,.465,15,33,.455,21,26,.808,106,38,76,.500,30,50,.600,8,26,.308,23,29,.793,107
670,OKC,2016-11-26,106,,DET,W 106-88,240,42,83,.506,34,60,.567,8,23,.348,14,26,.538,106,37,82,.451,36,63,.571,1,19,.053,13,17,.765,88
671,WAS,2016-11-21,106,,PHO,W 106-101,240,37,91,.407,27,63,.429,10,28,.357,22,34,.647,106,39,91,.429,28,64,.438,11,27,.407,12,15,.800,101
672,NOP,2016-11-14,106,,BOS,W 106-105,240,35,79,.443,29,58,.500,6,21,.286,30,36,.833,106,38,95,.400,26,54,.481,12,41,.293,17,20,.850,105
673,CHI,2016-11-12,106,,WAS,W 106-95,240,39,97,.402,34,82,.415,5,15,.333,23,25,.920,106,38,91,.418,34,78,.436,4,13,.308,15,18,.833,95
674,MIL,2016-11-12,106,,MEM,W 106-96,240,36,68,.529,29,50,.580,7,18,.389,27,36,.750,106,35,78,.449,29,48,.604,6,30,.200,20,21,.952,96
675,MIL,2016-11-10,106,,NOP,L 106-112,240,40,91,.440,34,73,.466,6,18,.333,20,25,.800,106,39,89,.438,30,64,.469,9,25,.360,25,27,.926,112
676,CLE,2016-11-08,106,,ATL,L 106-110,240,37,99,.374,26,57,.456,11,42,.262,21,25,.840,106,41,81,.506,30,52,.577,11,29,.379,17,24,.708,110
677,WAS,2016-11-07,106,,HOU,L 106-114,240,39,94,.415,29,67,.433,10,27,.370,18,20,.900,106,41,79,.519,24,42,.571,17,37,.459,15,18,.833,114
678,ATL,2016-10-31,106,,SAC,W 106-95,240,33,79,.418,22,49,.449,11,30,.367,29,47,.617,106,36,75,.480,26,52,.500,10,23,.435,13,19,.684,95
679,SAC,2016-10-29,106,,MIN,W 106-103,240,39,85,.459,30,59,.508,9,26,.346,19,25,.760,106,37,70,.529,30,48,.625,7,22,.318,22,31,.710,103
680,POR,2016-10-27,106,,LAC,L 106-114,240,39,85,.459,35,67,.522,4,18,.222,24,32,.750,106,37,91,.407,29,62,.468,8,29,.276,32,46,.696,114
681,OKC,2017-04-12,105,,DEN,L 105-111,240,43,101,.426,35,76,.461,8,25,.320,11,17,.647,105,39,85,.459,32,60,.533,7,25,.280,26,32,.813,111
682,DEN,2017-04-09,105,,OKC,L 105-106,240,40,84,.476,29,50,.580,11,34,.324,14,15,.933,105,40,96,.417,34,71,.479,6,25,.240,20,22,.909,106
683,POR,2017-04-06,105,,MIN,W 105-98,240,35,81,.432,21,48,.438,14,33,.424,21,26,.808,105,38,87,.437,34,69,.493,4,18,.222,18,20,.900,98
684,MIL,2017-04-02,105,,DAL,L 105-109,240,39,77,.506,27,43,.628,12,34,.353,15,18,.833,105,38,73,.521,24,37,.649,14,36,.389,19,20,.950,109
685,CHO,2017-03-24,105,,CLE,L 105-112,240,38,90,.422,28,52,.538,10,38,.263,19,24,.792,105,41,74,.554,32,49,.653,9,25,.360,21,24,.875,112
686,CHO,2017-03-20,105,,ATL,W 105-90,240,40,80,.500,28,50,.560,12,30,.400,13,20,.650,105,37,84,.440,25,47,.532,12,37,.324,4,10,.400,90
687,PHI,2017-03-19,105,,BOS,W 105-99,240,41,88,.466,29,55,.527,12,33,.364,11,15,.733,105,34,84,.405,28,55,.509,6,29,.207,25,29,.862,99
688,DEN,2017-03-18,105,,HOU,L 105-109,240,38,89,.427,28,58,.483,10,31,.323,19,30,.633,105,38,83,.458,33,59,.559,5,24,.208,28,35,.800,109
689,ATL,2017-03-10,105,,TOR,W 105-99,240,39,75,.520,31,53,.585,8,22,.364,19,29,.655,105,37,92,.402,33,67,.493,4,25,.160,21,27,.778,99
690,DAL,2017-03-10,105,,BRK,W 105-96,240,33,78,.423,19,45,.422,14,33,.424,25,28,.893,105,34,78,.436,25,47,.532,9,31,.290,19,23,.826,96
691,ORL,2017-03-06,105,,NYK,L 105-113,240,40,85,.471,31,53,.585,9,32,.281,16,24,.667,105,40,86,.465,34,72,.472,6,14,.429,27,28,.964,113
692,NYK,2017-03-05,105,,GSW,L 105-112,240,39,83,.470,32,61,.525,7,22,.318,20,25,.800,105,40,88,.455,27,53,.509,13,35,.371,19,23,.826,112
693,PHI,2017-03-03,105,,NYK,W 105-102,240,36,83,.434,27,55,.491,9,28,.321,24,31,.774,105,33,84,.393,26,63,.413,7,21,.333,29,33,.879,102
694,ORL,2017-02-25,105,,ATL,W 105-86,240,37,81,.457,29,54,.537,8,27,.296,23,24,.958,105,32,85,.376,24,60,.400,8,25,.320,14,26,.538,86
695,CHI,2017-02-14,105,,TOR,W 105-94,240,35,73,.479,28,56,.500,7,17,.412,28,35,.800,105,35,77,.455,30,57,.526,5,20,.250,19,24,.792,94
696,SAC,2017-02-12,105,,NOP,W 105-99,240,35,78,.449,24,47,.511,11,31,.355,24,27,.889,105,34,82,.415,21,51,.412,13,31,.419,18,21,.857,99
697,OKC,2017-02-05,105,,POR,W 105-99,240,40,98,.408,36,80,.450,4,18,.222,21,28,.750,105,35,87,.402,25,59,.424,10,28,.357,19,21,.905,99
698,WAS,2017-02-04,105,,NOP,W 105-91,240,38,83,.458,28,52,.538,10,31,.323,19,22,.864,105,37,84,.440,32,67,.478,5,17,.294,12,22,.545,91
699,UTA,2017-02-04,105,,CHO,W 105-98,240,38,81,.469,25,48,.521,13,33,.394,16,24,.667,105,35,82,.427,22,49,.449,13,33,.394,15,18,.833,98
700,IND,2017-02-04,105,,DET,W 105-84,240,44,91,.484,37,67,.552,7,24,.292,10,15,.667,105,31,75,.413,25,58,.431,6,17,.353,16,20,.800,84
701,HOU,2017-01-31,105,,SAC,W 105-83,240,38,85,.447,24,40,.600,14,45,.311,15,22,.682,105,30,86,.349,22,57,.386,8,29,.276,15,26,.577,83
702,POR,2017-01-25,105,,LAL,W 105-98,240,43,90,.478,39,75,.520,4,15,.267,15,20,.750,105,37,94,.394,26,64,.406,11,30,.367,13,14,.929,98
703,NOP,2017-01-25,105,,OKC,L 105-114,240,41,96,.427,30,69,.435,11,27,.407,12,19,.632,105,42,91,.462,32,64,.500,10,27,.370,20,28,.714,114
704,ATL,2017-01-23,105,,LAC,L 105-115,240,37,88,.420,28,59,.475,9,29,.310,22,26,.846,105,42,84,.500,28,60,.467,14,24,.583,17,22,.773,115
705,MIA,2017-01-23,105,,GSW,W 105-102,240,38,86,.442,25,56,.446,13,30,.433,16,27,.593,105,41,88,.466,33,58,.569,8,30,.267,12,20,.600,102
706,NYK,2017-01-21,105,,PHO,L 105-107,240,40,89,.449,29,68,.426,11,21,.524,14,16,.875,105,37,85,.435,28,61,.459,9,24,.375,24,27,.889,107
707,HOU,2017-01-13,105,,MEM,L 105-110,240,33,82,.402,23,41,.561,10,41,.244,29,36,.806,105,41,76,.539,31,49,.633,10,27,.370,18,27,.667,110
708,LAC,2017-01-11,105,,ORL,W 105-96,240,39,76,.513,30,50,.600,9,26,.346,18,26,.692,105,39,92,.424,33,65,.508,6,27,.222,12,18,.667,96
709,ATL,2016-12-30,105,,DET,W 105-98,240,39,88,.443,31,62,.500,8,26,.308,19,25,.760,105,35,84,.417,26,53,.491,9,31,.290,19,21,.905,98
710,DEN,2016-12-28,105,,MIN,W 105-103,240,42,81,.519,32,53,.604,10,28,.357,11,14,.786,105,42,94,.447,35,69,.507,7,25,.280,12,17,.706,103
711,MIN,2016-12-23,105,,SAC,L 105-109,240,36,79,.456,24,47,.511,12,32,.375,21,26,.808,105,42,80,.525,27,51,.529,15,29,.517,10,14,.714,109
712,CHI,2016-12-10,105,,MIA,W 105-100,240,38,84,.452,37,76,.487,1,8,.125,28,31,.903,105,42,91,.462,37,71,.521,5,20,.250,11,18,.611,100
713,UTA,2016-12-03,105,,DEN,W 105-98,240,35,78,.449,26,53,.491,9,25,.360,26,28,.929,105,37,83,.446,24,59,.407,13,24,.542,11,14,.786,98
714,NOP,2016-11-29,105,,LAL,W 105-88,240,38,88,.432,30,57,.526,8,31,.258,21,25,.840,105,37,87,.425,32,57,.561,5,30,.167,9,18,.500,88
715,GSW,2016-11-28,105,,ATL,W 105-100,240,37,85,.435,25,50,.500,12,35,.343,19,24,.792,105,36,85,.424,29,56,.518,7,29,.241,21,30,.700,100
716,BRK,2016-11-27,105,,SAC,L 105-122,240,38,87,.437,22,47,.468,16,40,.400,13,14,.929,105,46,86,.535,33,63,.524,13,23,.565,17,22,.773,122
717,DEN,2016-11-20,105,,UTA,W 105-91,240,42,86,.488,34,64,.531,8,22,.364,13,30,.433,105,33,85,.388,26,58,.448,7,27,.259,18,23,.783,91
718,NYK,2016-11-16,105,,DET,W 105-102,240,42,93,.452,33,68,.485,9,25,.360,12,19,.632,105,42,85,.494,34,62,.548,8,23,.348,10,12,.833,102
719,OKC,2016-11-16,105,,HOU,W 105-103,240,40,84,.476,28,59,.475,12,25,.480,13,14,.929,105,40,92,.435,26,52,.500,14,40,.350,9,14,.643,103
720,SAC,2016-11-16,105,,SAS,L 105-110,240,36,76,.474,27,56,.482,9,20,.450,24,31,.774,105,43,88,.489,32,58,.552,11,30,.367,13,17,.765,110
721,MIN,2016-11-12,105,,LAC,L 105-119,240,40,89,.449,32,67,.478,8,22,.364,17,21,.810,105,40,76,.526,29,52,.558,11,24,.458,28,37,.757,119
722,TOR,2016-10-31,105,,DEN,W 105-102,240,41,88,.466,37,72,.514,4,16,.250,19,25,.760,105,33,81,.407,24,59,.407,9,22,.409,27,35,.771,102
723,CLE,2016-10-29,105,,ORL,W 105-99,240,36,88,.409,25,51,.490,11,37,.297,22,30,.733,105,38,84,.452,30,56,.536,8,28,.286,15,26,.577,99
724,CHI,2016-10-27,105,,BOS,W 105-99,240,36,92,.391,25,67,.373,11,25,.440,22,30,.733,105,38,76,.500,30,53,.566,8,23,.348,15,24,.625,99
725,IND,2017-04-12,104,,ATL,W 104-86,240,39,82,.476,29,58,.500,10,24,.417,16,19,.842,104,30,72,.417,19,43,.442,11,29,.379,15,19,.789,86
726,IND,2017-04-06,104,,MIL,W 104-89,240,38,80,.475,30,55,.545,8,25,.320,20,26,.769,104,33,71,.465,22,47,.468,11,24,.458,12,14,.857,89
727,WAS,2017-03-22,104,,ATL,W 104-100,240,38,95,.400,27,61,.443,11,34,.324,17,23,.739,104,34,86,.395,26,61,.426,8,25,.320,24,29,.828,100
728,BRK,2017-03-19,104,,DAL,L 104-111,240,31,72,.431,18,41,.439,13,31,.419,29,38,.763,104,41,76,.539,31,51,.608,10,25,.400,19,25,.760,111
729,MIA,2017-03-19,104,,POR,L 104-115,240,41,88,.466,32,58,.552,9,30,.300,13,20,.650,104,42,83,.506,29,57,.509,13,26,.500,18,24,.750,115
730,MEM,2017-03-18,104,,SAS,W 104-96,240,32,76,.421,19,46,.413,13,30,.433,27,31,.871,104,33,75,.440,24,47,.511,9,28,.321,21,22,.955,96
731,BRK,2017-03-14,104,,OKC,L 104-122,240,33,71,.465,21,47,.447,12,24,.500,26,30,.867,104,44,89,.494,34,67,.507,10,22,.455,24,34,.706,122
732,ORL,2017-03-11,104,,CLE,L 104-116,240,38,96,.396,34,75,.453,4,21,.190,24,28,.857,104,43,86,.500,28,47,.596,15,39,.385,15,25,.600,116
733,MIA,2017-03-11,104,,TOR,W 104-89,240,35,72,.486,24,44,.545,11,28,.393,23,33,.697,104,33,88,.375,31,73,.425,2,15,.133,21,25,.840,89
734,MIL,2017-03-08,104,,NYK,W 104-93,240,37,86,.430,29,60,.483,8,26,.308,22,28,.786,104,39,84,.464,32,63,.508,7,21,.333,8,12,.667,93
735,DAL,2017-03-05,104,,OKC,W 104-89,240,42,86,.488,35,61,.574,7,25,.280,13,16,.813,104,33,82,.402,31,60,.517,2,22,.091,21,30,.700,89
736,DAL,2017-03-03,104,,MEM,W 104-100,240,39,82,.476,34,55,.618,5,27,.185,21,27,.778,104,38,82,.463,29,54,.537,9,28,.321,15,22,.682,100
737,LAL,2017-02-28,104,,CHO,L 104-109,240,41,84,.488,29,52,.558,12,32,.375,10,13,.769,104,38,85,.447,22,46,.478,16,39,.410,17,24,.708,109
738,CHI,2017-02-16,104,,BOS,W 104-103,240,38,90,.422,32,65,.492,6,25,.240,22,22,1.000,104,36,77,.468,22,40,.550,14,37,.378,17,20,.850,103
739,POR,2017-02-13,104,,ATL,L 104-109 (OT),265,37,103,.359,21,61,.344,16,42,.381,14,25,.560,104,32,83,.386,24,55,.436,8,28,.286,37,48,.771,109
740,UTA,2017-02-11,104,,BOS,L 104-112,240,35,86,.407,27,55,.491,8,31,.258,26,30,.867,104,42,71,.592,29,41,.707,13,30,.433,15,23,.652,112
741,NYK,2017-02-04,104,,CLE,L 104-111,240,39,86,.453,27,55,.491,12,31,.387,14,28,.500,104,41,84,.488,25,44,.568,16,40,.400,13,18,.722,111
742,POR,2017-02-03,104,,DAL,L 104-108,240,40,88,.455,31,58,.534,9,30,.300,15,20,.750,104,36,76,.474,19,45,.422,17,31,.548,19,23,.826,108
743,UTA,2017-02-01,104,,MIL,W 104-88,240,36,78,.462,25,49,.510,11,29,.379,21,27,.778,104,32,73,.438,23,50,.460,9,23,.391,15,25,.600,88
744,DAL,2017-01-30,104,,CLE,W 104-97,240,39,86,.453,30,54,.556,9,32,.281,17,18,.944,104,35,75,.467,23,43,.535,12,32,.375,15,21,.714,97
745,MIA,2017-01-30,104,,BRK,W 104-96,240,39,82,.476,28,56,.500,11,26,.423,15,23,.652,104,37,87,.425,33,61,.541,4,26,.154,18,22,.818,96
746,DET,2017-01-23,104,,SAC,L 104-109,240,41,82,.500,31,54,.574,10,28,.357,12,17,.706,104,40,82,.488,31,61,.508,9,21,.429,20,26,.769,109
747,WAS,2017-01-18,104,,MEM,W 104-101,240,36,80,.450,28,51,.549,8,29,.276,24,26,.923,104,33,83,.398,25,58,.431,8,25,.320,27,34,.794,101
748,MIL,2017-01-16,104,,PHI,L 104-113,240,42,89,.472,37,75,.493,5,14,.357,15,22,.682,104,35,78,.449,21,41,.512,14,37,.378,29,36,.806,113
749,MEM,2017-01-15,104,,CHI,L 104-108,240,40,95,.421,29,63,.460,11,32,.344,13,13,1.000,104,40,78,.513,36,61,.590,4,17,.235,24,35,.686,108
750,NYK,2017-01-12,104,,CHI,W 104-89,240,44,92,.478,37,69,.536,7,23,.304,9,11,.818,104,35,89,.393,32,71,.451,3,18,.167,16,21,.762,89
751,NYK,2017-01-04,104,,MIL,L 104-105,240,42,94,.447,29,66,.439,13,28,.464,7,12,.583,104,37,78,.474,28,50,.560,9,28,.321,22,31,.710,105
752,NOP,2016-12-30,104,,NYK,W 104-92,240,38,85,.447,26,56,.464,12,29,.414,16,17,.941,104,35,93,.376,28,70,.400,7,23,.304,15,16,.938,92
753,MIN,2016-12-26,104,,ATL,W 104-90,240,37,82,.451,22,51,.431,15,31,.484,15,18,.833,104,35,83,.422,27,51,.529,8,32,.250,12,17,.706,90
754,GSW,2016-12-20,104,,UTA,W 104-74,240,40,90,.444,31,67,.463,9,23,.391,15,17,.882,104,27,76,.355,18,46,.391,9,30,.300,11,20,.550,74
755,UTA,2016-12-10,104,,SAC,W 104-84,240,37,77,.481,24,48,.500,13,29,.448,17,18,.944,104,34,90,.378,25,64,.391,9,26,.346,7,13,.538,84
756,MIN,2016-11-30,104,,NYK,L 104-106,240,34,77,.442,30,58,.517,4,19,.211,32,39,.821,104,41,91,.451,28,59,.475,13,32,.406,11,15,.733,106
757,MIA,2016-11-28,104,,BOS,L 104-112,240,38,80,.475,32,50,.640,6,30,.200,22,32,.688,104,40,83,.482,29,56,.518,11,27,.407,21,26,.808,112
758,SAC,2016-11-25,104,,HOU,L 104-117,240,39,80,.488,30,48,.625,9,32,.281,17,21,.810,104,40,85,.471,19,35,.543,21,50,.420,16,20,.800,117
759,DAL,2016-11-23,104,,LAC,L 104-124,240,38,84,.452,27,60,.450,11,24,.458,17,18,.944,104,43,85,.506,28,53,.528,15,32,.469,23,31,.742,124
760,NYK,2016-11-20,104,,ATL,W 104-94,240,42,88,.477,32,61,.525,10,27,.370,10,14,.714,104,34,85,.400,28,64,.438,6,21,.286,20,29,.690,94
761,CLE,2016-11-18,104,,DET,W 104-81,240,40,83,.482,29,58,.500,11,25,.440,13,14,.929,104,29,93,.312,23,74,.311,6,19,.316,17,20,.850,81
762,DET,2016-11-14,104,,OKC,W 104-88,240,43,92,.467,38,76,.500,5,16,.313,13,16,.813,104,33,88,.375,28,61,.459,5,27,.185,17,22,.773,88
763,PHO,2016-11-12,104,,BRK,L 104-122,240,40,107,.374,32,74,.432,8,33,.242,16,21,.762,104,40,84,.476,24,47,.511,16,37,.432,26,30,.867,122
764,CHO,2016-11-09,104,,UTA,W 104-98,240,38,82,.463,30,56,.536,8,26,.308,20,29,.690,104,38,82,.463,30,48,.625,8,34,.235,14,18,.778,98
765,CHI,2016-11-04,104,,NYK,L 104-117,240,37,84,.440,29,61,.475,8,23,.348,22,27,.815,104,46,89,.517,37,68,.544,9,21,.429,16,21,.762,117
766,POR,2016-11-01,104,,GSW,L 104-127,240,37,86,.430,23,47,.489,14,39,.359,16,21,.762,104,50,89,.562,40,63,.635,10,26,.385,17,23,.739,127
767,ATL,2017-04-11,103,,CHO,W 103-76,240,41,79,.519,34,52,.654,7,27,.259,14,18,.778,103,29,88,.330,26,65,.400,3,23,.130,15,19,.789,76
768,WAS,2017-04-08,103,,MIA,L 103-106,240,39,81,.481,31,59,.525,8,22,.364,17,22,.773,103,37,80,.463,30,62,.484,7,18,.389,25,36,.694,106
769,NYK,2017-04-06,103,,WAS,L 103-106,240,40,95,.421,33,75,.440,7,20,.350,16,21,.762,103,36,74,.486,22,40,.550,14,34,.412,20,28,.714,106
770,SAS,2017-03-27,103,,CLE,W 103-74,240,41,86,.477,34,60,.567,7,26,.269,14,17,.824,103,31,83,.373,27,57,.474,4,26,.154,8,13,.615,74
771,PHO,2017-03-17,103,,ORL,L 103-109,240,38,87,.437,36,73,.493,2,14,.143,25,30,.833,103,42,96,.438,35,73,.479,7,23,.304,18,21,.857,109
772,LAL,2017-03-17,103,,MIL,L 103-107,240,38,84,.452,27,55,.491,11,29,.379,16,26,.615,103,40,82,.488,36,58,.621,4,24,.167,23,30,.767,107
773,MIN,2017-03-10,103,,GSW,W 103-102,240,39,88,.443,35,74,.473,4,14,.286,21,27,.778,103,41,88,.466,34,64,.531,7,24,.292,13,17,.765,102
774,LAC,2017-03-01,103,,HOU,L 103-122,240,42,94,.447,30,60,.500,12,34,.353,7,13,.538,103,37,87,.425,17,35,.486,20,52,.385,28,33,.848,122
775,BOS,2017-03-01,103,,CLE,W 103-99,240,36,78,.462,23,47,.489,13,31,.419,18,23,.783,103,37,91,.407,27,58,.466,10,33,.303,15,22,.682,99
776,ORL,2017-02-23,103,,POR,L 103-112,240,34,86,.395,27,64,.422,7,22,.318,28,39,.718,103,41,81,.506,32,63,.508,9,18,.500,21,27,.778,112
777,BRK,2017-02-13,103,,MEM,L 103-112,240,38,82,.463,26,45,.578,12,37,.324,15,18,.833,103,39,77,.506,30,55,.545,9,22,.409,25,27,.926,112
778,PHI,2017-02-08,103,,SAS,L 103-111,240,34,84,.405,21,50,.420,13,34,.382,22,29,.759,103,39,74,.527,28,52,.538,11,22,.500,22,25,.880,111
779,SAC,2017-02-03,103,,PHO,L 103-105,240,38,85,.447,28,58,.483,10,27,.370,17,22,.773,103,32,77,.416,20,48,.417,12,29,.414,29,35,.829,105
780,MIN,2017-01-26,103,,IND,L 103-109,240,36,81,.444,26,54,.481,10,27,.370,21,27,.778,103,42,81,.519,32,63,.508,10,18,.556,15,17,.882,109
781,DAL,2017-01-25,103,,NYK,W 103-95,240,39,83,.470,33,57,.579,6,26,.231,19,24,.792,103,39,92,.424,32,69,.464,7,23,.304,10,12,.833,95
782,CHO,2017-01-25,103,,GSW,L 103-113,240,38,92,.413,31,69,.449,7,23,.304,20,21,.952,103,39,82,.476,28,54,.519,11,28,.393,24,27,.889,113
783,DEN,2017-01-24,103,,UTA,W 103-93,240,35,76,.461,25,50,.500,10,26,.385,23,31,.742,103,35,85,.412,28,63,.444,7,22,.318,16,21,.762,93
784,IND,2017-01-23,103,,NYK,L 103-109,240,38,86,.442,31,60,.517,7,26,.269,20,25,.800,103,35,76,.461,27,54,.500,8,22,.364,31,35,.886,109
785,TOR,2017-01-22,103,,PHO,L 103-115,240,33,83,.398,26,56,.464,7,27,.259,30,35,.857,103,40,79,.506,31,57,.544,9,22,.409,26,28,.929,115
786,OKC,2017-01-11,103,,MEM,W 103-95,240,36,81,.444,28,55,.509,8,26,.308,23,29,.793,103,38,92,.413,31,68,.456,7,24,.292,12,21,.571,95
787,NYK,2017-01-02,103,,ORL,L 103-115,240,39,83,.470,31,62,.500,8,21,.381,17,24,.708,103,45,91,.495,30,60,.500,15,31,.484,10,14,.714,115
788,CHO,2016-12-23,103,,CHI,W 103-91,240,37,84,.440,32,66,.485,5,18,.278,24,28,.857,103,38,96,.396,31,74,.419,7,22,.318,8,10,.800,91
789,UTA,2016-12-16,103,,DAL,W 103-100,240,37,65,.569,29,43,.674,8,22,.364,21,27,.778,103,35,77,.455,23,49,.469,12,28,.429,18,21,.857,100
790,GSW,2016-12-15,103,,NYK,W 103-90,240,45,96,.469,36,64,.563,9,32,.281,4,8,.500,103,38,93,.409,33,72,.458,5,21,.238,9,19,.474,90
791,CLE,2016-12-13,103,,MEM,W 103-86,240,37,81,.457,25,50,.500,12,31,.387,17,23,.739,103,35,86,.407,31,64,.484,4,22,.182,12,15,.800,86
792,ATL,2016-12-07,103,,MIA,W 103-95,240,43,88,.489,39,69,.565,4,19,.211,13,15,.867,103,34,80,.425,23,53,.434,11,27,.407,16,20,.800,95
793,MIA,2016-12-06,103,,NYK,L 103-114,240,38,89,.427,27,64,.422,11,25,.440,16,27,.593,103,48,98,.490,41,73,.562,7,25,.280,11,16,.688,114
794,MEM,2016-12-03,103,,LAL,W 103-100,240,41,88,.466,31,58,.534,10,30,.333,11,15,.733,103,35,81,.432,28,60,.467,7,21,.333,23,29,.793,100
795,NYK,2016-11-28,103,,OKC,L 103-112,240,36,91,.396,30,72,.417,6,19,.316,25,28,.893,103,46,92,.500,38,70,.543,8,22,.364,12,18,.667,112
796,MIN,2016-11-28,103,,UTA,L 103-112,240,36,81,.444,29,62,.468,7,19,.368,24,25,.960,103,40,79,.506,36,61,.590,4,18,.222,28,34,.824,112
797,BOS,2016-11-25,103,,SAS,L 103-109,240,42,91,.462,30,57,.526,12,34,.353,7,9,.778,103,38,81,.469,27,57,.474,11,24,.458,22,25,.880,109
798,IND,2016-11-16,103,,CLE,W 103-93,240,43,86,.500,33,58,.569,10,28,.357,7,11,.636,103,35,86,.407,24,56,.429,11,30,.367,12,20,.600,93
799,DET,2016-11-05,103,,DEN,W 103-86,240,40,84,.476,33,64,.516,7,20,.350,16,22,.727,103,31,94,.330,24,69,.348,7,25,.280,17,20,.850,86
800,WAS,2016-11-02,103,,TOR,L 103-113,240,42,72,.583,39,62,.629,3,10,.300,16,24,.667,103,43,77,.558,33,52,.635,10,25,.400,17,25,.680,113
801,BRK,2016-10-28,103,,IND,W 103-94,240,38,87,.437,28,54,.519,10,33,.303,17,20,.850,103,37,98,.378,30,74,.405,7,24,.292,13,20,.650,94
802,DET,2017-04-05,102,,TOR,L 102-105,240,42,81,.519,35,60,.583,7,21,.333,11,18,.611,102,41,87,.471,31,57,.544,10,30,.333,13,15,.867,105
803,ORL,2017-03-22,102,,CHO,L 102-109,240,40,88,.455,26,48,.542,14,40,.350,8,10,.800,102,42,90,.467,33,63,.524,9,27,.333,16,18,.889,109
804,TOR,2017-03-16,102,,OKC,L 102-123,240,37,81,.457,32,61,.525,5,20,.250,23,30,.767,102,47,88,.534,33,63,.524,14,25,.560,15,19,.789,123
805,IND,2017-03-12,102,,MIA,W 102-98,240,35,82,.427,30,67,.448,5,15,.333,27,32,.844,102,39,94,.415,30,62,.484,9,32,.281,11,16,.688,98
806,MIL,2017-03-11,102,,MIN,W 102-95,240,37,80,.463,29,60,.483,8,20,.400,20,23,.870,102,37,81,.457,32,68,.471,5,13,.385,16,21,.762,95
807,OKC,2017-03-09,102,,SAS,W 102-92,240,41,89,.461,35,69,.507,6,20,.300,14,21,.667,102,35,84,.417,29,65,.446,6,19,.316,16,20,.800,92
808,DEN,2017-03-04,102,,CHO,L 102-112,240,36,80,.450,27,50,.540,9,30,.300,21,25,.840,102,41,90,.456,25,63,.397,16,27,.593,14,17,.824,112
809,CLE,2017-02-27,102,,MIL,W 102-95,240,35,70,.500,25,42,.595,10,28,.357,22,26,.846,102,37,83,.446,26,53,.491,11,30,.367,10,16,.625,95
810,IND,2017-02-24,102,,MEM,W 102-92,240,40,78,.513,29,52,.558,11,26,.423,11,11,1.000,102,35,84,.417,26,57,.456,9,27,.333,13,23,.565,92
811,MIL,2017-02-13,102,,DET,W 102-89,240,40,79,.506,34,58,.586,6,21,.286,16,16,1.000,102,34,78,.436,27,57,.474,7,21,.333,14,19,.737,89
812,CHO,2017-02-11,102,,LAC,L 102-107,240,37,85,.435,24,48,.500,13,37,.351,15,20,.750,102,40,85,.471,26,51,.510,14,34,.412,13,20,.650,107
813,ORL,2017-02-03,102,,TOR,W 102-94,240,37,80,.463,32,66,.485,5,14,.357,23,32,.719,102,34,87,.391,24,59,.407,10,28,.357,16,21,.762,94
814,SAS,2017-02-02,102,,PHI,W 102-86,240,38,89,.427,32,68,.471,6,21,.286,20,27,.741,102,30,88,.341,21,63,.333,9,25,.360,17,23,.739,86
815,TOR,2017-01-27,102,,MIL,W 102-86,240,37,84,.440,27,59,.458,10,25,.400,18,23,.783,102,31,80,.388,24,57,.421,7,23,.304,17,24,.708,86
816,CHI,2017-01-21,102,,SAC,W 102-99,240,34,83,.410,28,66,.424,6,17,.353,28,33,.848,102,37,84,.440,28,58,.483,9,26,.346,16,21,.762,99
817,ATL,2017-01-20,102,,CHI,W 102-93,240,39,82,.476,30,60,.500,9,22,.409,15,19,.789,102,34,81,.420,27,53,.509,7,28,.250,18,19,.947,93
818,PHI,2017-01-13,102,,CHO,W 102-93,240,36,76,.474,22,38,.579,14,38,.368,16,20,.800,102,28,85,.329,22,62,.355,6,23,.261,31,32,.969,93
819,POR,2017-01-11,102,,CLE,W 102-86,240,40,93,.430,30,63,.476,10,30,.333,12,16,.750,102,28,82,.341,19,52,.365,9,30,.300,21,28,.750,86
820,SAS,2017-01-07,102,,CHO,W 102-85,240,36,89,.404,23,55,.418,13,34,.382,17,20,.850,102,30,75,.400,26,54,.481,4,21,.190,21,25,.840,85
821,SAC,2017-01-04,102,,MIA,L 102-107,240,40,78,.513,32,58,.552,8,20,.400,14,17,.824,102,35,72,.486,23,44,.523,12,28,.429,25,29,.862,107
822,ATL,2016-12-28,102,,NYK,W 102-98 (OT),265,37,101,.366,30,74,.405,7,27,.259,21,27,.778,102,35,93,.376,28,66,.424,7,27,.259,21,26,.808,98
823,POR,2016-12-28,102,,SAC,W 102-89,240,35,74,.473,23,49,.469,12,25,.480,20,22,.909,102,31,79,.392,22,51,.431,9,28,.321,18,23,.783,89
824,NOP,2016-12-28,102,,LAC,W 102-98,240,40,87,.460,30,58,.517,10,29,.345,12,21,.571,102,37,94,.394,26,57,.456,11,37,.297,13,18,.722,98
825,LAC,2016-12-26,102,,DEN,L 102-106,240,39,84,.464,30,59,.508,9,25,.360,15,20,.750,102,36,82,.439,25,51,.490,11,31,.355,23,28,.821,106
826,SAC,2016-12-26,102,,PHI,W 102-100,240,39,87,.448,32,62,.516,7,25,.280,17,21,.810,102,39,79,.494,30,54,.556,9,25,.360,13,18,.722,100
827,IND,2016-12-22,102,,BOS,L 102-109,240,35,82,.427,28,59,.475,7,23,.304,25,29,.862,102,38,92,.413,28,53,.528,10,39,.256,23,27,.852,109
828,NOP,2016-12-15,102,,IND,W 102-95,240,36,85,.424,26,58,.448,10,27,.370,20,28,.714,102,36,87,.414,33,66,.500,3,21,.143,20,24,.833,95
829,DET,2016-12-06,102,,CHI,W 102-91,240,40,88,.455,32,67,.478,8,21,.381,14,21,.667,102,33,75,.440,31,60,.517,2,15,.133,23,32,.719,91
830,LAC,2016-12-04,102,,IND,L 102-111,240,36,81,.444,26,51,.510,10,30,.333,20,28,.714,102,39,79,.494,34,65,.523,5,14,.357,28,35,.800,111
831,HOU,2016-11-23,102,,TOR,L 102-115,240,38,78,.487,24,36,.667,14,42,.333,12,12,1.000,102,43,88,.489,31,65,.477,12,23,.522,17,21,.810,115
832,SAC,2016-11-20,102,,TOR,W 102-99,240,36,81,.444,25,54,.463,11,27,.407,19,25,.760,102,34,85,.400,25,61,.410,9,24,.375,22,24,.917,99
833,LAC,2016-11-19,102,,CHI,W 102-95,240,36,77,.468,25,50,.500,11,27,.407,19,23,.826,102,33,77,.429,24,47,.511,9,30,.300,20,24,.833,95
834,OKC,2016-11-09,102,,TOR,L 102-112,240,31,74,.419,19,40,.475,12,34,.353,28,31,.903,102,43,83,.518,32,57,.561,11,26,.423,15,22,.682,112
835,SAC,2016-11-08,102,,NOP,W 102-94,240,39,81,.481,31,56,.554,8,25,.320,16,20,.800,102,38,84,.452,33,63,.524,5,21,.238,13,18,.722,94
836,ORL,2016-11-03,102,,SAC,W 102-94,240,38,84,.452,28,54,.519,10,30,.333,16,23,.696,102,38,80,.475,31,62,.500,7,18,.389,11,17,.647,94
837,DET,2016-11-01,102,,NYK,W 102-89,240,41,89,.461,33,76,.434,8,13,.615,12,21,.571,102,35,86,.407,28,64,.438,7,22,.318,12,15,.800,89
838,MEM,2016-10-26,102,,MIN,W 102-98,240,36,80,.450,25,56,.446,11,24,.458,19,27,.704,102,36,86,.419,30,68,.441,6,18,.333,20,29,.690,98
839,NOP,2016-10-26,102,,DEN,L 102-107,240,38,92,.413,35,73,.479,3,19,.158,23,26,.885,102,37,83,.446,29,59,.492,8,24,.333,25,33,.758,107
840,UTA,2017-04-12,101,,SAS,W 101-97,240,39,77,.506,29,51,.569,10,26,.385,13,20,.650,101,39,86,.453,31,65,.477,8,21,.381,11,13,.846,97
841,DET,2017-04-10,101,,WAS,L 101-105,240,43,94,.457,33,68,.485,10,26,.385,5,5,1.000,101,42,83,.506,35,64,.547,7,19,.368,14,16,.875,105
842,POR,2017-04-08,101,,UTA,W 101-86,240,37,91,.407,24,61,.393,13,30,.433,14,16,.875,101,31,78,.397,25,59,.424,6,19,.316,18,24,.750,86
843,MEM,2017-04-07,101,,NYK,W 101-88,240,38,75,.507,23,48,.479,15,27,.556,10,12,.833,101,38,88,.432,32,60,.533,6,28,.214,6,13,.462,88
844,OKC,2017-04-02,101,,CHO,L 101-113,240,39,84,.464,27,53,.509,12,31,.387,11,12,.917,101,37,77,.481,26,47,.553,11,30,.367,28,32,.875,113
845,BRK,2017-03-28,101,,PHI,L 101-106,240,38,94,.404,29,62,.468,9,32,.281,16,24,.667,101,39,91,.429,29,58,.500,10,33,.303,18,21,.857,106
846,PHO,2017-03-15,101,,SAC,L 101-107,240,43,107,.402,37,82,.451,6,25,.240,9,14,.643,101,38,79,.481,32,65,.492,6,14,.429,25,34,.735,107
847,PHO,2017-03-12,101,,POR,L 101-110,240,41,93,.441,36,79,.456,5,14,.357,14,20,.700,101,43,86,.500,36,64,.563,7,22,.318,17,25,.680,110
848,MIL,2017-03-04,101,,TOR,W 101-94,240,38,87,.437,32,60,.533,6,27,.222,19,23,.826,101,35,75,.467,28,54,.519,7,21,.333,17,20,.850,94
849,TOR,2017-02-12,101,,DET,L 101-102,240,38,75,.507,30,59,.508,8,16,.500,17,25,.680,101,36,84,.429,28,53,.528,8,31,.258,22,29,.759,102
850,SAS,2017-01-29,101,,DAL,L 101-105,240,39,83,.470,31,61,.508,8,22,.364,15,23,.652,101,39,87,.448,27,53,.509,12,34,.353,15,16,.938,105
851,MEM,2017-01-25,101,,TOR,W 101-99,240,36,78,.462,26,56,.464,10,22,.455,19,25,.760,101,39,92,.424,29,58,.500,10,34,.294,11,19,.579,99
852,LAC,2017-01-19,101,,MIN,L 101-104,240,42,87,.483,38,65,.585,4,22,.182,13,24,.542,101,40,84,.476,35,68,.515,5,16,.313,19,25,.760,104
853,PHO,2017-01-16,101,,UTA,L 101-106,240,40,81,.494,35,59,.593,5,22,.227,16,17,.941,101,41,89,.461,33,66,.500,8,23,.348,16,24,.667,106
854,ATL,2017-01-13,101,,BOS,L 101-103,240,36,84,.429,25,54,.463,11,30,.367,18,21,.857,101,36,83,.434,19,39,.487,17,44,.386,14,19,.737,103
855,WAS,2017-01-10,101,,CHI,W 101-99,240,42,83,.506,31,61,.508,11,22,.500,6,9,.667,101,35,88,.398,25,61,.410,10,27,.370,19,21,.905,99
856,MIN,2017-01-09,101,,DAL,W 101-92,240,40,71,.563,34,55,.618,6,16,.375,15,21,.714,101,36,78,.462,23,50,.460,13,28,.464,7,9,.778,92
857,MIL,2017-01-08,101,,WAS,L 101-107,240,37,80,.463,28,57,.491,9,23,.391,18,20,.900,101,41,84,.488,31,52,.596,10,32,.313,15,18,.833,107
858,TOR,2017-01-05,101,,UTA,W 101-93,240,36,91,.396,28,70,.400,8,21,.381,21,28,.750,101,34,73,.466,27,53,.509,7,20,.350,18,21,.857,93
859,HOU,2017-01-02,101,,WAS,W 101-91,240,37,86,.430,25,47,.532,12,39,.308,15,21,.714,101,38,87,.437,32,61,.525,6,26,.231,9,12,.750,91
860,ORL,2016-12-28,101,,CHO,L 101-120,240,42,86,.488,33,52,.635,9,34,.265,8,10,.800,101,46,84,.548,36,60,.600,10,24,.417,18,19,.947,120
861,CHI,2016-12-28,101,,BRK,W 101-99,240,35,88,.398,32,75,.427,3,13,.231,28,29,.966,101,37,86,.430,24,54,.444,13,32,.406,12,16,.750,99
862,BRK,2016-12-22,101,,GSW,L 101-117,240,38,86,.442,25,51,.490,13,35,.371,12,16,.750,101,47,104,.452,35,67,.522,12,37,.324,11,14,.786,117
863,LAL,2016-12-05,101,,UTA,L 101-107,240,39,87,.448,34,73,.466,5,14,.357,18,23,.783,101,38,80,.475,25,48,.521,13,32,.406,18,29,.621,107
864,DAL,2016-12-05,101,,CHO,L 101-109,240,37,89,.416,24,53,.453,13,36,.361,14,18,.778,101,40,79,.506,37,61,.607,3,18,.167,26,28,.929,109
865,OKC,2016-12-04,101,,NOP,W 101-92,240,41,89,.461,35,61,.574,6,28,.214,13,26,.500,101,36,98,.367,30,70,.429,6,28,.214,14,19,.737,92
866,WAS,2016-11-28,101,,SAC,W 101-95 (OT),265,35,85,.412,25,60,.417,10,25,.400,21,26,.808,101,38,93,.409,35,72,.486,3,21,.143,16,26,.615,95
867,PHI,2016-11-21,101,,MIA,W 101-94,240,37,78,.474,26,52,.500,11,26,.423,16,20,.800,101,34,88,.386,27,57,.474,7,31,.226,19,28,.679,94
868,DEN,2016-11-10,101,,GSW,L 101-125,240,38,94,.404,25,58,.431,13,36,.361,12,17,.706,101,46,85,.541,32,55,.582,14,30,.467,19,20,.950,125
869,PHI,2016-11-05,101,,CLE,L 101-102,240,40,87,.460,26,49,.531,14,38,.368,7,12,.583,101,37,91,.407,23,53,.434,14,38,.368,14,18,.778,102
870,PHI,2016-11-01,101,,ORL,L 101-103,240,40,81,.494,31,61,.508,9,20,.450,12,16,.750,101,42,93,.452,36,68,.529,6,25,.240,13,17,.765,103
871,POR,2017-04-12,100,,NOP,L 100-103,240,41,85,.482,28,55,.509,13,30,.433,5,13,.385,100,40,90,.444,32,66,.485,8,24,.333,15,21,.714,103
872,CLE,2017-04-07,100,,ATL,L 100-114,240,39,81,.481,30,45,.667,9,36,.250,13,17,.765,100,45,89,.506,29,52,.558,16,37,.432,8,8,1.000,114
873,MEM,2017-04-05,100,,OKC,L 100-103,240,37,78,.474,28,52,.538,9,26,.346,17,21,.810,100,37,85,.435,23,54,.426,14,31,.452,15,24,.625,103
874,NYK,2017-04-04,100,,CHI,W 100-91,240,42,89,.472,36,66,.545,6,23,.261,10,16,.625,100,32,85,.376,26,58,.448,6,27,.222,21,23,.913,91
875,BOS,2017-03-29,100,,MIL,L 100-103,240,35,88,.398,23,51,.451,12,37,.324,18,23,.783,100,41,78,.526,33,56,.589,8,22,.364,13,17,.765,103
876,MIL,2017-03-24,100,,ATL,W 100-97,240,39,88,.443,31,61,.508,8,27,.296,14,16,.875,100,34,83,.410,26,61,.426,8,22,.364,21,24,.875,97
877,NOP,2017-03-14,100,,POR,W 100-77,240,38,80,.475,32,59,.542,6,21,.286,18,30,.600,100,23,76,.303,12,44,.273,11,32,.344,20,26,.769,77
878,TOR,2017-03-13,100,,DAL,W 100-78,240,37,78,.474,28,53,.528,9,25,.360,17,18,.944,100,31,85,.365,24,60,.400,7,25,.280,9,13,.692,78
879,BOS,2017-03-12,100,,CHI,W 100-80,240,40,86,.465,24,49,.490,16,37,.432,4,4,1.000,100,33,87,.379,26,62,.419,7,25,.280,7,9,.778,80
880,CHO,2017-03-06,100,,IND,W 100-88,240,35,86,.407,24,55,.436,11,31,.355,19,21,.905,100,37,81,.457,25,51,.490,12,30,.400,2,3,.667,88
881,ATL,2017-03-01,100,,DAL,W 100-95,240,36,64,.563,26,43,.605,10,21,.476,18,24,.750,100,35,77,.455,21,44,.477,14,33,.424,11,13,.846,95
882,SAS,2017-03-01,100,,IND,W 100-99,240,35,74,.473,26,45,.578,9,29,.310,21,24,.875,100,37,81,.457,30,58,.517,7,23,.304,18,25,.720,99
883,SAC,2017-03-01,100,,BRK,L 100-109,240,35,81,.432,24,59,.407,11,22,.500,19,22,.864,100,34,74,.459,23,46,.500,11,28,.393,30,36,.833,109
884,MIL,2017-02-26,100,,PHO,W 100-96,240,39,76,.513,33,56,.589,6,20,.300,16,18,.889,100,40,83,.482,35,69,.507,5,14,.357,11,16,.688,96
885,IND,2017-02-11,100,,MIL,L 100-116,240,35,73,.479,25,51,.490,10,22,.455,20,24,.833,100,35,73,.479,18,42,.429,17,31,.548,29,37,.784,116
886,OKC,2017-02-01,100,,CHI,L 100-128,240,38,100,.380,28,63,.444,10,37,.270,14,17,.824,100,49,81,.605,43,66,.652,6,15,.400,24,30,.800,128
887,SAC,2017-01-18,100,,IND,L 100-106,240,35,72,.486,26,51,.510,9,21,.429,21,27,.778,100,39,75,.520,32,54,.593,7,21,.333,21,25,.840,106
888,SAC,2017-01-10,100,,DET,W 100-94,240,32,73,.438,19,50,.380,13,23,.565,23,29,.793,100,36,82,.439,24,55,.436,12,27,.444,10,16,.625,94
889,UTA,2017-01-10,100,,CLE,W 100-92,240,38,79,.481,25,45,.556,13,34,.382,11,19,.579,100,31,85,.365,22,54,.407,9,31,.290,21,25,.840,92
890,UTA,2016-12-29,100,,PHI,W 100-83,240,35,73,.479,20,47,.426,15,26,.577,15,28,.536,100,35,87,.402,29,63,.460,6,24,.250,7,8,.875,83
891,LAL,2016-12-27,100,,UTA,L 100-102,240,39,83,.470,35,67,.522,4,16,.250,18,22,.818,100,38,75,.507,29,49,.592,9,26,.346,17,24,.708,102
892,HOU,2016-12-20,100,,SAS,L 100-102,240,35,92,.380,29,54,.537,6,38,.158,24,27,.889,100,36,77,.468,24,54,.444,12,23,.522,18,25,.720,102
893,SAC,2016-12-09,100,,NYK,L 100-103,240,35,87,.402,28,59,.475,7,28,.250,23,27,.852,100,36,84,.429,26,55,.473,10,29,.345,21,25,.840,103
894,WAS,2016-11-26,100,,SAS,L 100-112,240,42,88,.477,36,66,.545,6,22,.273,10,14,.714,100,40,75,.533,31,51,.608,9,24,.375,23,29,.793,112
895,CHO,2016-11-18,100,,ATL,W 100-96,240,37,90,.411,27,61,.443,10,29,.345,16,24,.667,100,39,84,.464,32,56,.571,7,28,.250,11,17,.647,96
896,CLE,2016-11-13,100,,CHO,W 100-93,240,39,92,.424,25,54,.463,14,38,.368,8,15,.533,100,36,95,.379,25,66,.379,11,29,.379,10,12,.833,93
897,HOU,2016-11-12,100,,SAS,L 100-106,240,34,89,.382,19,42,.452,15,47,.319,17,21,.810,100,41,76,.539,36,58,.621,5,18,.278,19,24,.792,106
898,PHO,2016-10-30,100,,GSW,L 100-106,240,37,90,.411,29,67,.433,8,23,.348,18,25,.720,100,35,83,.422,27,54,.500,8,29,.276,28,33,.848,106
899,GSW,2016-10-25,100,,SAS,L 100-129,240,40,85,.471,33,52,.635,7,33,.212,13,18,.722,100,47,98,.480,35,74,.473,12,24,.500,23,26,.885,129
900,POR,2017-04-10,99,,SAS,W 99-98,240,37,89,.416,25,62,.403,12,27,.444,13,15,.867,99,38,83,.458,30,62,.484,8,21,.381,14,20,.700,98
901,GSW,2017-04-10,99,,UTA,L 99-105,240,39,80,.488,30,55,.545,9,25,.360,12,17,.706,99,41,92,.446,28,57,.491,13,35,.371,10,15,.667,105
902,CHO,2017-04-05,99,,MIA,L 99-112,240,35,78,.449,27,53,.509,8,25,.320,21,24,.875,99,40,84,.476,19,44,.432,21,40,.525,11,12,.917,112
903,MEM,2017-03-31,99,,DAL,W 99-90,240,35,75,.467,24,48,.500,11,27,.407,18,20,.900,99,29,76,.382,17,42,.405,12,34,.353,20,25,.800,90
904,CHI,2017-03-30,99,,CLE,W 99-93,240,38,90,.422,26,65,.400,12,25,.480,11,18,.611,99,37,83,.446,27,56,.482,10,27,.370,9,16,.563,93
905,MIL,2017-03-10,99,,IND,W 99-85,240,33,64,.516,26,47,.553,7,17,.412,26,30,.867,99,33,75,.440,31,57,.544,2,18,.111,17,22,.773,85
906,CLE,2017-02-25,99,,CHI,L 99-117,240,37,80,.463,23,43,.535,14,37,.378,11,15,.733,99,46,93,.495,31,63,.492,15,30,.500,10,16,.625,117
907,NOP,2017-02-23,99,,HOU,L 99-129,240,36,86,.419,30,55,.545,6,31,.194,21,26,.808,99,45,91,.495,25,40,.625,20,51,.392,19,24,.792,129
908,DEN,2017-02-15,99,,MIN,L 99-112,240,38,94,.404,27,60,.450,11,34,.324,12,18,.667,99,41,86,.477,35,68,.515,6,18,.333,24,28,.857,112
909,LAC,2017-02-15,99,,ATL,W 99-84,240,37,79,.468,23,42,.548,14,37,.378,11,12,.917,99,32,79,.405,25,53,.472,7,26,.269,13,19,.684,84
910,CHO,2017-02-13,99,,PHI,L 99-105,240,34,78,.436,23,47,.489,11,31,.355,20,26,.769,99,41,86,.477,29,53,.547,12,33,.364,11,17,.647,105
911,BRK,2017-02-10,99,,MIA,L 99-108,240,35,81,.432,27,61,.443,8,20,.400,21,28,.750,99,41,92,.446,34,69,.493,7,23,.304,19,21,.905,108
912,MIN,2017-02-04,99,,MEM,L 99-107,240,35,84,.417,25,58,.431,10,26,.385,19,24,.792,99,32,77,.416,22,49,.449,10,28,.357,33,39,.846,107
913,DEN,2017-02-01,99,,MEM,L 99-119,240,32,80,.400,23,55,.418,9,25,.360,26,35,.743,99,45,92,.489,31,62,.500,14,30,.467,15,20,.750,119
914,CHO,2017-01-23,99,,WAS,L 99-109,240,35,90,.389,27,58,.466,8,32,.250,21,25,.840,99,43,80,.538,33,55,.600,10,25,.400,13,17,.765,109
915,MIA,2017-01-19,99,,DAL,W 99-95,240,35,73,.479,26,53,.491,9,20,.450,20,29,.690,99,37,82,.451,23,46,.500,14,36,.389,7,11,.636,95
916,DEN,2017-01-05,99,,SAS,L 99-127,240,39,86,.453,32,61,.525,7,25,.280,14,17,.824,99,51,90,.567,39,66,.591,12,24,.500,13,17,.765,127
917,PHO,2017-01-03,99,,MIA,W 99-90,240,36,77,.468,27,54,.500,9,23,.391,18,22,.818,99,36,91,.396,30,68,.441,6,23,.261,12,16,.750,90
918,PHO,2016-12-29,99,,TOR,W 99-91,240,37,83,.446,28,62,.452,9,21,.429,16,23,.696,99,30,75,.400,23,48,.479,7,27,.259,24,29,.828,91
919,DAL,2016-12-18,99,,SAC,W 99-79,240,34,77,.442,21,44,.477,13,33,.394,18,22,.818,99,30,76,.395,22,45,.489,8,31,.258,11,17,.647,79
920,ATL,2016-12-17,99,,CHO,L 99-107,240,40,86,.465,30,60,.500,10,26,.385,9,16,.563,99,43,88,.489,31,61,.508,12,27,.444,9,13,.692,107
921,OKC,2016-12-11,99,,BOS,W 99-96,240,41,83,.494,38,62,.613,3,21,.143,14,27,.519,99,40,90,.444,29,58,.500,11,32,.344,5,8,.625,96
922,OKC,2016-12-09,99,,HOU,L 99-102,240,34,81,.420,27,53,.509,7,28,.250,24,31,.774,99,36,92,.391,25,50,.500,11,42,.262,19,30,.633,102
923,UTA,2016-12-08,99,,GSW,L 99-106,240,37,89,.416,27,51,.529,10,38,.263,15,21,.714,99,39,80,.488,27,51,.529,12,29,.414,16,23,.696,106
924,ATL,2016-12-05,99,,OKC,L 99-102,240,34,77,.442,27,55,.491,7,22,.318,24,32,.750,99,37,80,.463,27,49,.551,10,31,.323,18,28,.643,102
925,POR,2016-12-03,99,,MIA,W 99-92,240,36,89,.404,27,65,.415,9,24,.375,18,24,.750,99,38,86,.442,32,64,.500,6,22,.273,10,15,.667,92
926,MIL,2016-11-25,99,,TOR,L 99-105,240,40,79,.506,28,50,.560,12,29,.414,7,12,.583,99,38,82,.463,24,50,.480,14,32,.438,15,19,.789,105
927,PHI,2016-11-23,99,,MEM,L 99-104 (2OT),290,35,93,.376,23,57,.404,12,36,.333,17,23,.739,99,38,99,.384,28,70,.400,10,29,.345,18,24,.750,104
928,IND,2016-11-12,99,,BOS,L 99-105,240,36,86,.419,30,59,.508,6,27,.222,21,28,.750,99,35,80,.438,27,55,.491,8,25,.320,27,33,.818,105
929,NOP,2016-11-12,99,,LAL,L 99-126,240,39,90,.433,33,70,.471,6,20,.300,15,19,.789,99,52,94,.553,36,64,.563,16,30,.533,6,7,.857,126
930,SAS,2016-11-09,99,,HOU,L 99-101,240,33,84,.393,26,61,.426,7,23,.304,26,30,.867,99,37,78,.474,27,48,.563,10,30,.333,17,22,.773,101
931,MIN,2016-11-03,99,,DEN,L 99-102,240,35,88,.398,26,66,.394,9,22,.409,20,25,.800,99,39,81,.481,33,59,.559,6,22,.273,18,25,.720,102
932,NYK,2016-11-02,99,,HOU,L 99-118,240,37,85,.435,29,65,.446,8,20,.400,17,25,.680,99,42,89,.472,27,49,.551,15,40,.375,19,27,.704,118
933,MIA,2016-10-30,99,,SAS,L 99-106,240,37,80,.463,30,60,.500,7,20,.350,18,26,.692,99,37,82,.451,27,64,.422,10,18,.556,22,26,.846,106
934,MIN,2017-04-11,98,,OKC,L 98-100,240,38,86,.442,33,66,.500,5,20,.250,17,25,.680,98,37,86,.430,30,64,.469,7,22,.318,19,25,.760,100
935,LAL,2017-04-07,98,,SAC,W 98-94,240,38,86,.442,34,62,.548,4,24,.167,18,25,.720,98,38,75,.507,30,55,.545,8,20,.400,10,13,.769,94
936,SAC,2017-04-04,98,,DAL,W 98-87,240,36,81,.444,24,59,.407,12,22,.545,14,17,.824,98,32,80,.400,20,37,.541,12,43,.279,11,14,.786,87
937,SAS,2017-03-29,98,,GSW,L 98-110,240,34,83,.410,25,59,.424,9,24,.375,21,26,.808,98,43,85,.506,30,59,.508,13,26,.500,11,11,1.000,110
938,SAC,2017-03-22,98,,MIL,L 98-116,240,41,84,.488,31,58,.534,10,26,.385,6,10,.600,98,43,81,.531,27,46,.587,16,35,.457,14,19,.737,116
939,BRK,2017-03-21,98,,DET,W 98-96,240,38,88,.432,28,59,.475,10,29,.345,12,19,.632,98,40,92,.435,35,69,.507,5,23,.217,11,16,.688,96
940,CHO,2017-03-18,98,,WAS,W 98-93,240,35,82,.427,26,58,.448,9,24,.375,19,27,.704,98,29,79,.367,18,46,.391,11,33,.333,24,31,.774,93
941,IND,2017-03-15,98,,CHO,W 98-77,240,39,73,.534,27,45,.600,12,28,.429,8,9,.889,98,32,80,.400,29,57,.509,3,23,.130,10,13,.769,77
942,DAL,2017-03-11,98,,PHO,L 98-100,240,28,74,.378,19,48,.396,9,26,.346,33,36,.917,98,38,83,.458,32,62,.516,6,21,.286,18,20,.900,100
943,MEM,2017-03-09,98,,LAC,L 98-114,240,37,83,.446,30,63,.476,7,20,.350,17,22,.773,98,40,78,.513,29,48,.604,11,30,.367,23,28,.821,114
944,ORL,2017-03-08,98,,CHI,W 98-91,240,37,89,.416,30,64,.469,7,25,.280,17,21,.810,98,36,81,.444,24,53,.453,12,28,.429,7,11,.636,91
945,CLE,2017-03-06,98,,MIA,L 98-106,240,35,78,.449,26,51,.510,9,27,.333,19,29,.655,98,39,91,.429,23,56,.411,16,35,.457,12,14,.857,106
946,PHI,2017-03-06,98,,MIL,L 98-112,240,39,89,.438,31,59,.525,8,30,.267,12,19,.632,98,41,83,.494,27,50,.540,14,33,.424,16,20,.800,112
947,NOP,2017-03-03,98,,SAS,L 98-101 (OT),265,35,91,.385,27,66,.409,8,25,.320,20,24,.833,98,40,95,.421,34,68,.500,6,27,.222,15,25,.600,101
948,MIL,2017-03-01,98,,DEN,L 98-110,240,38,83,.458,29,65,.446,9,18,.500,13,15,.867,98,41,84,.488,31,51,.608,10,33,.303,18,20,.900,110
949,BOS,2017-02-27,98,,ATL,L 98-114,240,34,87,.391,24,53,.453,10,34,.294,20,25,.800,98,46,95,.484,40,70,.571,6,25,.240,16,20,.800,114
950,LAL,2017-02-26,98,,SAS,L 98-119,240,40,87,.460,33,65,.508,7,22,.318,11,18,.611,98,49,94,.521,39,73,.534,10,21,.476,11,13,.846,119
951,DEN,2017-02-26,98,,MEM,L 98-105,240,37,84,.440,26,50,.520,11,34,.324,13,17,.765,98,36,80,.450,25,47,.532,11,33,.333,22,25,.880,105
952,DET,2017-02-26,98,,BOS,L 98-104,240,35,81,.432,23,48,.479,12,33,.364,16,35,.457,98,34,85,.400,22,50,.440,12,35,.343,24,30,.800,104
953,IND,2017-02-16,98,,WAS,L 98-111,240,40,80,.500,36,62,.581,4,18,.222,14,18,.778,98,43,83,.518,28,54,.519,15,29,.517,10,15,.667,111
954,DET,2017-02-15,98,,DAL,W 98-91,240,36,82,.439,30,63,.476,6,19,.316,20,22,.909,98,35,92,.380,25,55,.455,10,37,.270,11,11,1.000,91
955,DAL,2017-02-13,98,,BOS,L 98-111,240,35,77,.455,26,50,.520,9,27,.333,19,25,.760,98,40,81,.494,24,47,.511,16,34,.471,15,18,.833,111
956,ORL,2017-01-22,98,,GSW,L 98-118,240,42,96,.438,35,68,.515,7,28,.250,7,16,.438,98,42,89,.472,23,47,.489,19,42,.452,15,19,.789,118
957,CHI,2017-01-17,98,,DAL,L 98-99,240,37,82,.451,31,68,.456,6,14,.429,18,22,.818,98,37,78,.474,26,50,.520,11,28,.393,14,18,.778,99
958,IND,2017-01-16,98,,NOP,W 98-95,240,41,81,.506,36,62,.581,5,19,.263,11,16,.688,98,36,83,.434,26,58,.448,10,25,.400,13,18,.722,95
959,DAL,2017-01-15,98,,MIN,W 98-87,240,36,77,.468,24,48,.500,12,29,.414,14,19,.737,98,35,80,.438,30,59,.508,5,21,.238,12,18,.667,87
960,PHI,2017-01-11,98,,NYK,W 98-97,240,37,95,.389,30,67,.448,7,28,.250,17,21,.810,98,42,86,.488,38,64,.594,4,22,.182,9,10,.900,97
961,LAC,2017-01-08,98,,MIA,W 98-86,240,36,86,.419,27,56,.482,9,30,.300,17,25,.680,98,31,84,.369,24,57,.421,7,27,.259,17,21,.810,86
962,SAC,2017-01-06,98,,LAC,L 98-106,240,36,87,.414,27,57,.474,9,30,.300,17,22,.773,98,39,84,.464,26,53,.491,13,31,.419,15,21,.714,106
963,MIL,2017-01-02,98,,OKC,W 98-94,240,38,79,.481,31,60,.517,7,19,.368,15,24,.625,98,36,78,.462,27,51,.529,9,27,.333,13,19,.684,94
964,MIA,2017-01-01,98,,DET,L 98-107,240,35,77,.455,21,51,.412,14,26,.538,14,18,.778,98,42,86,.488,33,64,.516,9,22,.409,14,22,.636,107
965,SAC,2016-12-31,98,,MEM,L 98-112,240,31,72,.431,20,44,.455,11,28,.393,25,28,.893,98,44,87,.506,27,52,.519,17,35,.486,7,9,.778,112
966,UTA,2016-12-23,98,,TOR,L 98-104,240,35,79,.443,25,52,.481,10,27,.370,18,21,.857,98,43,81,.531,35,60,.583,8,21,.381,10,15,.667,104
967,MIA,2016-12-16,98,,LAC,L 98-102,240,38,93,.409,32,66,.485,6,27,.222,16,25,.640,98,36,83,.434,29,58,.500,7,25,.280,23,29,.793,102
968,LAC,2016-12-07,98,,GSW,L 98-115,240,36,92,.391,28,66,.424,8,26,.308,18,24,.750,98,42,89,.472,35,58,.603,7,31,.226,24,29,.828,115
969,PHI,2016-12-05,98,,DEN,L 98-106,240,35,86,.407,24,55,.436,11,31,.355,17,23,.739,98,35,76,.461,25,49,.510,10,27,.370,26,34,.765,106
970,DEN,2016-11-30,98,,MIA,L 98-106,240,38,91,.418,31,69,.449,7,22,.318,15,24,.625,98,41,93,.441,32,69,.464,9,24,.375,15,26,.577,106
971,DET,2016-10-30,98,,MIL,W 98-83,240,39,88,.443,34,68,.500,5,20,.250,15,20,.750,98,34,87,.391,30,70,.429,4,17,.235,11,14,.786,83
972,CHO,2016-10-29,98,,BOS,L 98-104,240,32,79,.405,23,47,.489,9,32,.281,25,33,.758,98,39,81,.481,24,50,.480,15,31,.484,11,17,.647,104
973,SAS,2016-10-29,98,,NOP,W 98-79,240,35,83,.422,25,59,.424,10,24,.417,18,23,.783,98,32,86,.372,28,64,.438,4,22,.182,11,15,.733,79
974,DAL,2016-10-28,98,,HOU,L 98-106,240,35,80,.438,27,51,.529,8,29,.276,20,24,.833,98,33,70,.471,18,38,.474,15,32,.469,25,31,.806,106
975,NYK,2017-04-09,97,,TOR,L 97-110,240,37,82,.451,28,54,.519,9,28,.321,14,15,.933,97,40,77,.519,30,46,.652,10,31,.323,20,23,.870,110
976,LAC,2017-03-26,97,,SAC,L 97-98,240,32,78,.410,22,49,.449,10,29,.345,23,28,.821,97,38,84,.452,25,56,.446,13,28,.464,9,13,.692,98
977,SAS,2017-03-23,97,,MEM,W 97-90,240,37,77,.481,29,51,.569,8,26,.308,15,23,.652,97,34,78,.436,24,49,.490,10,29,.345,12,15,.800,90
978,DAL,2017-03-23,97,,LAC,W 97-95,240,38,82,.463,29,56,.518,9,26,.346,12,18,.667,97,36,80,.450,27,53,.509,9,27,.333,14,21,.667,95
979,ATL,2017-03-18,97,,POR,L 97-113,240,32,88,.364,25,62,.403,7,26,.269,26,32,.813,97,44,87,.506,36,69,.522,8,18,.444,17,19,.895,113
980,LAL,2017-03-05,97,,NOP,L 97-105,240,38,83,.458,28,55,.509,10,28,.357,11,15,.733,97,36,89,.404,27,65,.415,9,24,.375,24,35,.686,105
981,SAS,2017-03-04,97,,MIN,W 97-90 (OT),265,38,94,.404,32,70,.457,6,24,.250,15,24,.625,97,35,89,.393,31,73,.425,4,16,.250,16,22,.727,90
982,LAC,2017-02-24,97,,SAS,L 97-105,240,35,79,.443,28,56,.500,7,23,.304,20,24,.833,97,35,82,.427,26,56,.464,9,26,.346,26,30,.867,105
983,MIN,2017-02-24,97,,DAL,W 97-84,240,41,78,.526,36,65,.554,5,13,.385,10,14,.714,97,35,83,.422,27,50,.540,8,33,.242,6,9,.667,84
984,BRK,2017-02-03,97,,IND,L 97-106,240,32,86,.372,21,58,.362,11,28,.393,22,23,.957,97,37,86,.430,29,66,.439,8,20,.400,24,31,.774,106
985,LAL,2017-01-15,97,,DET,L 97-102,240,36,83,.434,30,57,.526,6,26,.231,19,24,.792,97,41,95,.432,32,70,.457,9,25,.360,11,16,.688,102
986,BRK,2017-01-10,97,,ATL,L 97-117,240,35,87,.402,25,58,.431,10,29,.345,17,23,.739,97,44,92,.478,37,69,.536,7,23,.304,22,38,.579,117
987,CHI,2016-12-21,97,,WAS,L 97-107,240,38,95,.400,32,74,.432,6,21,.286,15,19,.789,97,43,82,.524,40,64,.625,3,18,.167,18,25,.720,107
988,BOS,2016-12-02,97,,SAC,W 97-92,240,36,88,.409,25,60,.417,11,28,.393,14,15,.933,97,33,88,.375,27,62,.435,6,26,.231,20,25,.800,92
989,CHO,2016-12-01,97,,DAL,W 97-87,240,35,74,.473,30,56,.536,5,18,.278,22,31,.710,97,32,86,.372,23,55,.418,9,31,.290,14,18,.778,87
990,LAL,2016-11-08,97,,DAL,L 97-109,240,38,78,.487,28,52,.538,10,26,.385,11,14,.786,97,43,82,.524,33,59,.559,10,23,.435,13,15,.867,109
991,OKC,2016-11-07,97,,MIA,W 97-85,240,37,85,.435,28,57,.491,9,28,.321,14,17,.824,97,31,84,.369,27,67,.403,4,17,.235,19,22,.864,85
992,UTA,2016-11-02,97,,DAL,W 97-81,240,35,77,.455,23,52,.442,12,25,.480,15,26,.577,97,33,77,.429,26,51,.510,7,26,.269,8,10,.800,81
993,PHI,2016-10-26,97,,OKC,L 97-103,240,36,84,.429,29,60,.483,7,24,.292,18,25,.720,97,39,94,.415,33,72,.458,6,22,.273,19,26,.731,103
994,TOR,2017-04-07,96,,MIA,W 96-94,240,35,85,.412,26,65,.400,9,20,.450,17,24,.708,96,33,83,.398,25,60,.417,8,23,.348,20,29,.690,94
995,DET,2017-03-28,96,,MIA,L 96-97,240,36,85,.424,28,58,.483,8,27,.296,16,21,.762,96,36,79,.456,31,58,.534,5,21,.238,20,28,.714,97
996,LAC,2017-03-15,96,,MIL,L 96-97,240,35,75,.467,30,51,.588,5,24,.208,21,29,.724,96,34,76,.447,24,47,.511,10,29,.345,19,25,.760,97
997,ATL,2017-03-05,96,,IND,L 96-97,240,34,77,.442,25,50,.500,9,27,.333,19,31,.613,96,35,78,.449,20,45,.444,15,33,.455,12,21,.571,97
998,TOR,2017-03-01,96,,WAS,L 96-105,240,33,90,.367,26,70,.371,7,20,.350,23,26,.885,96,40,84,.476,31,59,.525,9,25,.360,16,19,.842,105
999,DAL,2017-02-27,96,,MIA,W 96-89,240,33,76,.434,24,58,.414,9,18,.500,21,23,.913,96,37,83,.446,28,57,.491,9,26,.346,6,13,.462,89
1000,DAL,2017-02-25,96,,NOP,W 96-83,240,36,78,.462,24,52,.462,12,26,.462,12,16,.750,96,31,78,.397,26,54,.481,5,24,.208,16,25,.640,83
1001,LAL,2017-02-14,96,,SAC,L 96-97,240,38,83,.458,26,54,.481,12,29,.414,8,15,.533,96,36,73,.493,29,49,.592,7,24,.292,18,25,.720,97
1002,PHO,2017-01-30,96,,MEM,L 96-115,240,31,74,.419,26,55,.473,5,19,.263,29,39,.744,96,39,80,.488,23,52,.442,16,28,.571,21,24,.875,115
1003,UTA,2017-01-26,96,,LAL,W 96-88,240,33,81,.407,27,55,.491,6,26,.231,24,28,.857,96,36,84,.429,32,70,.457,4,14,.286,12,13,.923,88
1004,MIN,2017-01-13,96,,OKC,W 96-86,240,39,86,.453,34,68,.500,5,18,.278,13,14,.929,96,33,85,.388,30,65,.462,3,20,.150,17,21,.810,86
1005,NYK,2017-01-09,96,,NOP,L 96-110,240,36,85,.424,25,56,.446,11,29,.379,13,16,.813,96,41,84,.488,29,57,.509,12,27,.444,16,19,.842,110
1006,CHI,2016-12-31,96,,MIL,L 96-116,240,33,83,.398,23,56,.411,10,27,.370,20,28,.714,96,43,76,.566,34,61,.557,9,15,.600,21,27,.778,116
1007,BOS,2016-12-16,96,,CHO,W 96-88,240,34,78,.436,25,50,.500,9,28,.321,19,26,.731,96,32,97,.330,24,67,.358,8,30,.267,16,19,.842,88
1008,MEM,2016-12-06,96,,PHI,W 96-91,240,33,86,.384,31,69,.449,2,17,.118,28,35,.800,96,32,82,.390,18,41,.439,14,41,.341,13,26,.500,91
1009,MIL,2016-12-05,96,,SAS,L 96-97,240,30,73,.411,24,49,.490,6,24,.250,30,34,.882,96,40,93,.430,32,65,.492,8,28,.286,9,14,.643,97
1010,NOP,2016-12-02,96,,LAC,L 96-114,240,39,85,.459,34,65,.523,5,20,.250,13,21,.619,96,45,88,.511,35,64,.547,10,24,.417,14,16,.875,114
1011,ORL,2016-11-27,96,,MIL,L 96-104,240,38,92,.413,31,64,.484,7,28,.250,13,17,.765,96,41,86,.477,33,62,.532,8,24,.333,14,20,.700,104
1012,SAS,2016-11-21,96,,DAL,W 96-91,240,35,75,.467,27,55,.491,8,20,.400,18,25,.720,96,35,74,.473,27,47,.574,8,27,.296,13,20,.650,91
1013,DET,2016-11-21,96,,HOU,L 96-99,240,36,87,.414,29,70,.414,7,17,.412,17,24,.708,96,35,78,.449,25,47,.532,10,31,.323,19,27,.704,99
1014,IND,2016-11-18,96,,PHO,L 96-116,240,36,76,.474,35,69,.507,1,7,.143,23,29,.793,96,46,97,.474,37,71,.521,9,26,.346,15,18,.833,116
1015,MIA,2016-11-17,96,,MIL,W 96-73,240,39,97,.402,32,67,.478,7,30,.233,11,21,.524,96,28,85,.329,21,62,.339,7,23,.304,10,13,.769,73
1016,UTA,2016-11-14,96,,MEM,L 96-102,240,35,73,.479,27,45,.600,8,28,.286,18,22,.818,96,36,76,.474,28,55,.509,8,21,.381,22,26,.846,102
1017,SAS,2016-11-11,96,,DET,W 96-86,240,36,81,.444,27,61,.443,9,20,.450,15,19,.789,96,32,76,.421,27,51,.529,5,25,.200,17,21,.810,86
1018,TOR,2016-11-04,96,,MIA,W 96-87,240,37,84,.440,31,59,.525,6,25,.240,16,18,.889,96,34,88,.386,25,60,.417,9,28,.321,10,15,.667,87
1019,UTA,2016-10-28,96,,LAL,W 96-89,240,31,75,.413,25,50,.500,6,25,.240,28,40,.700,96,32,84,.381,23,61,.377,9,23,.391,16,21,.762,89
1020,MIL,2016-10-26,96,,CHO,L 96-107,240,39,92,.424,36,76,.474,3,16,.188,15,20,.750,96,40,89,.449,33,66,.500,7,23,.304,20,24,.833,107
1021,ORL,2016-10-26,96,,MIA,L 96-108,240,34,89,.382,28,71,.394,6,18,.333,22,28,.786,96,47,97,.485,43,81,.531,4,16,.250,10,16,.625,108
1022,SAS,2017-04-05,95,,LAL,L 95-102,240,39,89,.438,26,54,.481,13,35,.371,4,6,.667,95,42,86,.488,35,72,.486,7,14,.500,11,14,.786,102
1023,SAS,2017-04-04,95,,MEM,W 95-89 (OT),265,35,80,.438,24,59,.407,11,21,.524,14,18,.778,95,35,89,.393,27,64,.422,8,25,.320,11,18,.611,89
1024,OKC,2017-03-31,95,,SAS,L 95-100,240,33,81,.407,27,60,.450,6,21,.286,23,27,.852,95,37,85,.435,28,58,.483,9,27,.333,17,27,.630,100
1025,UTA,2017-03-31,95,,WAS,W 95-88,240,33,72,.458,23,47,.489,10,25,.400,19,31,.613,95,35,87,.402,30,70,.429,5,17,.294,13,16,.813,88
1026,ATL,2017-03-28,95,,PHO,W 95-91,240,34,85,.400,28,58,.483,6,27,.222,21,29,.724,95,35,96,.365,28,65,.431,7,31,.226,14,24,.583,91
1027,NOP,2017-03-21,95,,MEM,W 95-82,240,35,88,.398,26,59,.441,9,29,.310,16,19,.842,95,32,79,.405,23,44,.523,9,35,.257,9,13,.692,82
1028,OKC,2017-03-20,95,,GSW,L 95-111,240,37,87,.425,33,66,.500,4,21,.190,17,31,.548,95,40,83,.482,25,50,.500,15,33,.455,16,21,.762,111
1029,CHI,2017-03-18,95,,UTA,W 95-86,240,38,80,.475,31,61,.508,7,19,.368,12,14,.857,95,31,81,.383,24,56,.429,7,25,.280,17,25,.680,86
1030,BRK,2017-03-17,95,,BOS,L 95-98,240,30,83,.361,19,48,.396,11,35,.314,24,30,.800,95,34,85,.400,27,56,.482,7,29,.241,23,29,.793,98
1031,LAL,2017-03-03,95,,BOS,L 95-115,240,37,87,.425,31,63,.492,6,24,.250,15,20,.750,95,43,84,.512,33,51,.647,10,33,.303,19,25,.760,115
1032,MIL,2017-02-24,95,,UTA,L 95-109,240,32,74,.432,25,56,.446,7,18,.389,24,29,.828,95,37,74,.500,29,51,.569,8,23,.348,27,30,.900,109
1033,CHO,2017-02-09,95,,HOU,L 95-107,240,37,85,.435,29,59,.492,8,26,.308,13,14,.929,95,39,87,.448,26,47,.553,13,40,.325,16,20,.800,107
1034,ATL,2017-02-06,95,,UTA,L 95-120,240,33,74,.446,27,57,.474,6,17,.353,23,32,.719,95,49,80,.613,39,54,.722,10,26,.385,12,18,.667,120
1035,BRK,2017-02-05,95,,TOR,L 95-103,240,32,76,.421,19,42,.452,13,34,.382,18,21,.857,95,40,87,.460,35,68,.515,5,19,.263,18,20,.900,103
1036,UTA,2017-01-28,95,,MEM,L 95-102,240,29,62,.468,19,37,.514,10,25,.400,27,29,.931,95,41,80,.513,30,54,.556,11,26,.423,9,10,.900,102
1037,UTA,2017-01-23,95,,OKC,L 95-97,240,36,84,.429,31,63,.492,5,21,.238,18,26,.692,95,36,83,.434,30,63,.476,6,20,.300,19,25,.760,97
1038,MEM,2017-01-21,95,,HOU,L 95-119,240,33,89,.371,24,55,.436,9,34,.265,20,28,.714,95,41,80,.513,25,38,.658,16,42,.381,21,25,.840,119
1039,BRK,2017-01-12,95,,NOP,L 95-104,240,40,97,.412,31,55,.564,9,42,.214,6,11,.545,95,38,90,.422,27,58,.466,11,32,.344,17,25,.680,104
1040,BRK,2017-01-08,95,,PHI,L 95-105,240,36,78,.462,26,51,.510,10,27,.370,13,17,.765,95,37,94,.394,29,67,.433,8,27,.296,23,27,.852,105
1041,DAL,2017-01-05,95,,PHO,L 95-102,240,36,79,.456,27,50,.540,9,29,.310,14,17,.824,95,38,85,.447,31,68,.456,7,17,.412,19,22,.864,102
1042,POR,2016-12-21,95,,DAL,L 95-96,240,32,72,.444,22,45,.489,10,27,.370,21,28,.750,95,35,83,.422,28,52,.538,7,31,.226,19,23,.826,96
1043,MIA,2016-12-18,95,,BOS,L 95-105,240,36,69,.522,27,45,.600,9,24,.375,14,25,.560,95,41,90,.456,32,62,.516,9,28,.321,14,19,.737,105
1044,MIA,2016-12-14,95,,IND,W 95-89,240,37,82,.451,30,57,.526,7,25,.280,14,25,.560,95,33,89,.371,24,62,.387,9,27,.333,14,17,.824,89
1045,CHI,2016-12-08,95,,SAS,W 95-91,240,35,80,.438,31,63,.492,4,17,.235,21,27,.778,95,39,97,.402,30,69,.435,9,28,.321,4,5,.800,91
1046,MEM,2016-12-01,95,,ORL,W 95-94,240,33,79,.418,26,61,.426,7,18,.389,22,28,.786,95,33,74,.446,27,50,.540,6,24,.250,22,31,.710,94
1047,UTA,2016-11-25,95,,ATL,W 95-68,240,35,80,.438,25,46,.543,10,34,.294,15,18,.833,95,26,83,.313,18,58,.310,8,25,.320,8,12,.667,68
1048,ORL,2016-11-19,95,,DAL,W 95-87,240,34,78,.436,26,57,.456,8,21,.381,19,22,.864,95,26,77,.338,13,49,.265,13,28,.464,22,27,.815,87
1049,DEN,2016-11-12,95,,DET,L 95-106,240,36,84,.429,27,59,.458,9,25,.360,14,19,.737,95,46,90,.511,42,72,.583,4,18,.222,10,14,.714,106
1050,MIA,2016-11-10,95,,CHI,L 95-98,240,36,88,.409,23,59,.390,13,29,.448,10,15,.667,95,37,89,.416,31,73,.425,6,16,.375,18,20,.900,98
1051,WAS,2016-11-04,95,,ATL,W 95-92,240,31,80,.388,26,60,.433,5,20,.250,28,35,.800,95,32,83,.386,27,58,.466,5,25,.200,23,36,.639,92
1052,DAL,2016-11-04,95,,POR,L 95-105,240,34,83,.410,24,55,.436,10,28,.357,17,20,.850,95,36,80,.450,24,49,.490,12,31,.387,21,26,.808,105
1053,BRK,2016-11-04,95,,CHO,L 95-99,240,35,87,.402,26,51,.510,9,36,.250,16,21,.762,95,36,86,.419,26,56,.464,10,30,.333,17,24,.708,99
1054,NYK,2017-04-02,94,,BOS,L 94-110,240,33,85,.388,26,60,.433,7,25,.280,21,25,.840,94,40,72,.556,28,35,.800,12,37,.324,18,26,.692,110
1055,MIA,2017-03-31,94,,NYK,L 94-98,240,34,83,.410,26,50,.520,8,33,.242,18,25,.720,94,38,80,.475,32,64,.500,6,16,.375,16,17,.941,98
1056,MIL,2017-03-26,94,,CHI,L 94-109,240,37,84,.440,30,61,.492,7,23,.304,13,17,.765,94,46,85,.541,36,64,.563,10,21,.476,7,10,.700,109
1057,CHI,2017-03-10,94,,HOU,L 94-115,240,38,98,.388,29,59,.492,9,39,.231,9,12,.750,94,37,89,.416,22,42,.524,15,47,.319,26,32,.813,115
1058,CHI,2017-03-02,94,,GSW,W 94-87,240,36,82,.439,31,63,.492,5,19,.263,17,21,.810,94,34,88,.386,28,58,.483,6,30,.200,13,14,.929,87
1059,NYK,2017-02-12,94,,SAS,W 94-90,240,34,68,.500,25,54,.463,9,14,.643,17,21,.810,94,33,91,.363,27,62,.435,6,29,.207,18,22,.818,90
1060,NOP,2017-02-08,94,,UTA,L 94-127,240,35,77,.455,30,53,.566,5,24,.208,19,25,.760,94,48,88,.545,34,56,.607,14,32,.438,17,21,.810,127
1061,NOP,2017-01-29,94,,WAS,L 94-107,240,38,84,.452,28,52,.538,10,32,.313,8,15,.533,94,45,89,.506,35,68,.515,10,21,.476,7,10,.700,107
1062,PHI,2017-01-18,94,,TOR,W 94-89,240,31,69,.449,23,45,.511,8,24,.333,24,32,.750,94,34,86,.395,28,62,.452,6,24,.250,15,23,.652,89
1063,CHI,2017-01-09,94,,OKC,L 94-109,240,34,83,.410,27,64,.422,7,19,.368,19,22,.864,94,47,83,.566,40,59,.678,7,24,.292,8,11,.727,109
1064,NOP,2017-01-05,94,,ATL,L 94-99,240,34,93,.366,19,58,.328,15,35,.429,11,14,.786,94,38,90,.422,29,67,.433,9,23,.391,14,17,.824,99
1065,CLE,2017-01-04,94,,CHI,L 94-106,240,34,83,.410,26,58,.448,8,25,.320,18,24,.750,94,41,85,.482,28,55,.509,13,30,.433,11,15,.733,106
1066,DET,2016-12-28,94,,MIL,L 94-119,240,39,88,.443,33,64,.516,6,24,.250,10,16,.625,94,48,84,.571,37,62,.597,11,22,.500,12,16,.750,119
1067,MIA,2016-12-27,94,,OKC,L 94-106,240,36,82,.439,29,60,.483,7,22,.318,15,21,.714,94,42,82,.512,37,63,.587,5,19,.263,17,25,.680,106
1068,CHI,2016-12-13,94,,MIN,L 94-99,240,38,87,.437,34,72,.472,4,15,.267,14,19,.737,94,38,86,.442,32,65,.492,6,21,.286,17,22,.773,99
1069,BOS,2016-12-09,94,,TOR,L 94-101,240,31,83,.373,14,41,.341,17,42,.405,15,22,.682,94,34,82,.415,25,62,.403,9,20,.450,24,27,.889,101
1070,PHO,2016-12-07,94,,IND,L 94-109,240,34,85,.400,25,52,.481,9,33,.273,17,18,.944,94,35,78,.449,28,55,.509,7,23,.304,32,41,.780,109
1071,NYK,2016-12-07,94,,CLE,L 94-126,240,35,87,.402,24,56,.429,11,31,.355,13,15,.867,94,39,80,.488,17,40,.425,22,40,.550,26,31,.839,126
1072,CLE,2016-12-01,94,,LAC,L 94-113,240,28,69,.406,19,45,.422,9,24,.375,29,39,.744,94,42,89,.472,29,58,.500,13,31,.419,16,24,.667,113
1073,ATL,2016-11-22,94,,NOP,L 94-112,240,39,85,.459,29,56,.518,10,29,.345,6,10,.600,94,45,86,.523,34,61,.557,11,25,.440,11,12,.917,112
1074,SAS,2016-11-14,94,,MIA,W 94-90,240,33,82,.402,25,67,.373,8,15,.533,20,27,.741,94,37,84,.440,33,69,.478,4,15,.267,12,21,.571,90
1075,WAS,2016-11-11,94,,CLE,L 94-105,240,38,87,.437,35,72,.486,3,15,.200,15,19,.789,94,36,86,.419,22,53,.415,14,33,.424,19,26,.731,105
1076,MEM,2016-11-06,94,,POR,L 94-100,240,31,81,.383,25,55,.455,6,26,.231,26,32,.813,94,32,71,.451,18,38,.474,14,33,.424,22,27,.815,100
1077,SAC,2016-10-27,94,,SAS,L 94-102,240,28,70,.400,22,50,.440,6,20,.300,32,38,.842,94,36,79,.456,30,61,.492,6,18,.333,24,27,.889,102
1078,PHO,2016-10-26,94,,SAC,L 94-113,240,36,77,.468,32,61,.525,4,16,.250,18,27,.667,94,44,86,.512,38,65,.585,6,21,.286,19,26,.731,113
1079,MEM,2017-04-12,93,,DAL,L 93-100,240,33,84,.393,25,59,.424,8,25,.320,19,22,.864,93,33,75,.440,24,41,.585,9,34,.265,25,31,.806,100
1080,MIN,2017-03-21,93,,SAS,L 93-100,240,32,72,.444,25,57,.439,7,15,.467,22,25,.880,93,37,77,.481,29,53,.547,8,24,.333,18,22,.818,100
1081,IND,2017-02-06,93,,OKC,W 93-90,240,33,87,.379,25,61,.410,8,26,.308,19,29,.655,93,34,88,.386,27,60,.450,7,28,.250,15,21,.714,90
1082,PHI,2017-01-20,93,,POR,W 93-92,240,36,92,.391,24,63,.381,12,29,.414,9,16,.563,93,33,89,.371,27,70,.386,6,19,.316,20,28,.714,92
1083,ORL,2017-01-06,93,,HOU,L 93-100,240,38,91,.418,30,68,.441,8,23,.348,9,13,.692,93,39,86,.453,24,37,.649,15,49,.306,7,12,.583,100
1084,PHI,2017-01-03,93,,MIN,W 93-91,240,33,85,.388,26,53,.491,7,32,.219,20,25,.800,93,33,82,.402,26,58,.448,7,24,.292,18,20,.900,91
1085,UTA,2016-12-21,93,,SAC,L 93-94,240,33,74,.446,24,47,.511,9,27,.333,18,22,.818,93,34,74,.459,24,53,.453,10,21,.476,16,24,.667,94
1086,PHI,2016-12-20,93,,NOP,L 93-108,240,33,82,.402,22,49,.449,11,33,.333,16,21,.762,93,40,93,.430,30,76,.395,10,17,.588,18,26,.692,108
1087,MEM,2016-12-14,93,,CLE,W 93-85,240,35,81,.432,23,58,.397,12,23,.522,11,16,.688,93,28,75,.373,19,50,.380,9,25,.360,20,31,.645,85
1088,BRK,2016-12-01,93,,MIL,L 93-111,240,34,89,.382,22,49,.449,12,40,.300,13,16,.813,93,36,80,.450,21,46,.457,15,34,.441,24,29,.828,111
1089,MIN,2016-11-21,93,,BOS,L 93-99,240,36,86,.419,32,62,.516,4,24,.167,17,25,.680,93,38,84,.452,26,46,.565,12,38,.316,11,14,.786,99
1090,MIL,2016-11-21,93,,ORL,W 93-89,240,35,86,.407,27,57,.474,8,29,.276,15,21,.714,93,32,77,.416,25,52,.481,7,25,.280,18,24,.750,89
1091,MEM,2016-11-19,93,,MIN,W 93-71,240,29,76,.382,27,58,.466,2,18,.111,33,38,.868,93,25,64,.391,18,42,.429,7,22,.318,14,22,.636,71
1092,NYK,2016-11-14,93,,DAL,W 93-77,240,34,78,.436,25,53,.472,9,25,.360,16,18,.889,93,32,84,.381,27,57,.474,5,27,.185,8,11,.727,77
1093,HOU,2016-10-30,93,,DAL,W 93-92,240,34,81,.420,23,50,.460,11,31,.355,14,21,.667,93,32,86,.372,21,55,.382,11,31,.355,17,20,.850,92
1094,PHI,2017-03-29,92,,ATL,L 92-99,240,36,87,.414,25,48,.521,11,39,.282,9,11,.818,92,34,80,.425,25,62,.403,9,18,.500,22,26,.846,99
1095,ATL,2017-03-26,92,,BRK,L 92-107,240,34,98,.347,29,71,.408,5,27,.185,19,32,.594,92,38,86,.442,32,64,.500,6,22,.273,25,30,.833,107
1096,SAC,2017-03-11,92,,DEN,L 92-105,240,36,82,.439,28,59,.475,8,23,.348,12,20,.600,92,40,85,.471,31,51,.608,9,34,.265,16,18,.889,105
1097,WAS,2017-02-26,92,,UTA,L 92-102,240,37,87,.425,29,65,.446,8,22,.364,10,13,.769,92,34,72,.472,23,48,.479,11,24,.458,23,32,.719,102
1098,DET,2017-02-10,92,,SAS,L 92-103,240,39,92,.424,34,75,.453,5,17,.294,9,13,.692,92,41,82,.500,32,63,.508,9,19,.474,12,15,.800,103
1099,ORL,2017-01-24,92,,CHI,L 92-100,240,35,85,.412,28,63,.444,7,22,.318,15,20,.750,92,35,77,.455,28,55,.509,7,22,.318,23,30,.767,100
1100,MIN,2017-01-07,92,,UTA,L 92-94,240,35,80,.438,28,60,.467,7,20,.350,15,21,.714,92,32,77,.416,24,54,.444,8,23,.348,22,28,.786,94
1101,ORL,2017-01-04,92,,ATL,L 92-111,240,37,86,.430,28,58,.483,9,28,.321,9,10,.900,92,44,81,.543,34,62,.548,10,19,.526,13,18,.722,111
1102,MEM,2016-12-16,92,,SAC,L 92-96,240,29,77,.377,24,52,.462,5,25,.200,29,36,.806,92,31,80,.388,24,56,.429,7,24,.292,27,37,.730,96
1103,PHO,2016-12-15,92,,SAS,L 92-107,240,34,85,.400,24,58,.414,10,27,.370,14,18,.778,92,39,74,.527,34,58,.586,5,16,.313,24,26,.923,107
1104,WAS,2016-12-08,92,,DEN,W 92-85,240,35,78,.449,29,59,.492,6,19,.316,16,17,.941,92,31,76,.408,24,44,.545,7,32,.219,16,24,.667,85
1105,DET,2016-12-04,92,,ORL,L 92-98,240,38,86,.442,28,59,.475,10,27,.370,6,13,.462,92,42,79,.532,35,56,.625,7,23,.304,7,14,.500,98
1106,BRK,2016-11-23,92,,BOS,L 92-111,240,34,86,.395,24,55,.436,10,31,.323,14,22,.636,92,45,98,.459,30,60,.500,15,38,.395,6,8,.750,111
1107,DET,2016-11-19,92,,BOS,L 92-94,240,37,86,.430,30,66,.455,7,20,.350,11,16,.688,92,33,82,.402,21,51,.412,12,31,.387,16,17,.941,94
1108,SAS,2016-11-05,92,,LAC,L 92-116,240,30,74,.405,20,49,.408,10,25,.400,22,25,.880,92,47,91,.516,38,68,.559,9,23,.391,13,14,.929,116
1109,DAL,2017-04-11,91,,DEN,L 91-109,240,35,88,.398,23,48,.479,12,40,.300,9,11,.818,91,41,84,.488,23,42,.548,18,42,.429,9,14,.643,109
1110,BOS,2017-04-05,91,,CLE,L 91-114,240,33,81,.407,26,48,.542,7,33,.212,18,29,.621,91,43,92,.467,32,56,.571,11,36,.306,17,18,.944,114
1111,BRK,2017-04-02,91,,ATL,W 91-82,240,32,82,.390,22,49,.449,10,33,.303,17,20,.850,91,30,80,.375,23,56,.411,7,24,.292,15,23,.652,82
1112,DAL,2017-03-27,91,,OKC,L 91-92,240,33,80,.413,23,51,.451,10,29,.345,15,19,.789,91,37,85,.435,31,62,.500,6,23,.261,12,14,.857,92
1113,SAC,2017-03-27,91,,MEM,W 91-90,240,31,67,.463,25,42,.595,6,25,.240,23,30,.767,91,31,90,.344,26,64,.406,5,26,.192,23,29,.793,90
1114,CLE,2017-03-16,91,,UTA,W 91-83,240,36,86,.419,27,53,.509,9,33,.273,10,19,.526,91,34,82,.415,29,61,.475,5,21,.238,10,14,.714,83
1115,ATL,2017-03-16,91,,MEM,L 91-103,240,29,71,.408,21,44,.477,8,27,.296,25,34,.735,91,39,92,.424,29,64,.453,10,28,.357,15,18,.833,103
1116,CHI,2017-03-15,91,,MEM,L 91-98,240,34,91,.374,23,63,.365,11,28,.393,12,15,.800,91,36,85,.424,25,54,.463,11,31,.355,15,18,.833,98
1117,CHI,2017-03-04,91,,LAC,L 91-101,240,35,83,.422,29,66,.439,6,17,.353,15,20,.750,91,41,85,.482,35,60,.583,6,25,.240,13,16,.813,101
1118,NYK,2017-02-27,91,,TOR,L 91-92,240,33,73,.452,24,49,.490,9,24,.375,16,19,.842,91,33,78,.423,26,52,.500,7,26,.269,19,23,.826,92
1119,MEM,2017-02-15,91,,NOP,L 91-95,240,33,89,.371,27,56,.482,6,33,.182,19,25,.760,91,37,75,.493,29,57,.509,8,18,.444,13,22,.591,95
1120,UTA,2016-12-31,91,,PHO,W 91-86,240,35,73,.479,27,53,.509,8,20,.400,13,20,.650,91,36,87,.414,29,70,.414,7,17,.412,7,10,.700,86
1121,CHO,2016-12-29,91,,MIA,W 91-82,240,36,93,.387,31,67,.463,5,26,.192,14,18,.778,91,33,82,.402,23,54,.426,10,28,.357,6,13,.462,82
1122,POR,2016-12-26,91,,TOR,L 91-95,240,35,83,.422,27,60,.450,8,23,.348,13,18,.722,91,32,95,.337,20,61,.328,12,34,.353,19,24,.792,95
1123,NOP,2016-12-23,91,,MIA,W 91-87,240,33,89,.371,22,61,.361,11,28,.393,14,21,.667,91,36,87,.414,28,67,.418,8,20,.400,7,13,.538,87
1124,MIN,2016-12-06,91,,SAS,L 91-105,240,36,82,.439,29,62,.468,7,20,.350,12,18,.667,91,39,74,.527,28,50,.560,11,24,.458,16,19,.842,105
1125,DAL,2016-11-27,91,,NOP,W 91-81,240,32,77,.416,22,50,.440,10,27,.370,17,20,.850,91,30,77,.390,25,57,.439,5,20,.250,16,18,.889,81
1126,IND,2016-11-27,91,,LAC,W 91-70,240,40,92,.435,35,73,.479,5,19,.263,6,7,.857,91,22,70,.314,18,46,.391,4,24,.167,22,27,.815,70
1127,ORL,2016-11-25,91,,WAS,L 91-94,240,35,80,.438,28,57,.491,7,23,.304,14,20,.700,91,40,88,.455,34,59,.576,6,29,.207,8,10,.800,94
1128,MIA,2016-11-12,91,,UTA,L 91-102,240,38,81,.469,33,64,.516,5,17,.294,10,19,.526,91,40,81,.494,34,61,.557,6,20,.300,16,19,.842,102
1129,SAC,2016-11-10,91,,LAL,L 91-101,240,34,85,.400,26,64,.406,8,21,.381,15,20,.750,91,38,74,.514,29,47,.617,9,27,.333,16,22,.727,101
1130,TOR,2016-11-06,91,,SAC,L 91-96,240,30,84,.357,23,54,.426,7,30,.233,24,31,.774,91,34,78,.436,29,62,.468,5,16,.313,23,31,.742,96
1131,SAS,2016-11-01,91,,UTA,L 91-106,240,33,76,.434,27,56,.482,6,20,.300,19,21,.905,91,38,76,.500,23,45,.511,15,31,.484,15,18,.833,106
1132,TOR,2016-10-28,91,,CLE,L 91-94,240,35,90,.389,31,74,.419,4,16,.250,17,18,.944,91,33,79,.418,21,47,.447,12,32,.375,16,22,.727,94
1133,MIA,2016-10-28,91,,CHO,L 91-97,240,32,86,.372,18,52,.346,14,34,.412,13,20,.650,91,35,92,.380,28,70,.400,7,22,.318,20,24,.833,97
1134,MEM,2017-04-09,90,,DET,L 90-103,240,36,75,.480,27,54,.500,9,21,.429,9,13,.692,90,39,82,.476,25,54,.463,14,28,.500,11,16,.688,103
1135,PHI,2017-04-06,90,,CHI,L 90-102,240,33,91,.363,26,58,.448,7,33,.212,17,22,.773,90,39,91,.429,31,66,.470,8,25,.320,16,17,.941,102
1136,DET,2017-03-30,90,,BRK,W 90-89,240,36,86,.419,29,68,.426,7,18,.389,11,17,.647,90,35,92,.380,25,61,.410,10,31,.323,9,12,.750,89
1137,DEN,2017-03-26,90,,NOP,L 90-115,240,36,95,.379,30,70,.429,6,25,.240,12,14,.857,90,48,97,.495,39,70,.557,9,27,.333,10,12,.833,115
1138,POR,2017-03-21,90,,MIL,L 90-93,240,35,83,.422,31,62,.500,4,21,.190,16,26,.615,90,38,90,.422,31,74,.419,7,16,.438,10,12,.833,93
1139,MEM,2017-03-11,90,,ATL,L 90-107,240,34,90,.378,29,61,.475,5,29,.172,17,23,.739,90,36,72,.500,21,42,.500,15,30,.500,20,26,.769,107
1140,ORL,2017-03-01,90,,NYK,L 90-101,240,34,83,.410,29,58,.500,5,25,.200,17,22,.773,90,34,81,.420,26,52,.500,8,29,.276,25,31,.806,101
1141,ATL,2017-02-24,90,,MIA,L 90-108,240,30,79,.380,24,59,.407,6,20,.300,24,36,.667,90,40,99,.404,23,62,.371,17,37,.459,11,13,.846,108
1142,TOR,2017-02-15,90,,CHO,W 90-85,240,32,84,.381,20,52,.385,12,32,.375,14,19,.737,90,32,76,.421,19,38,.500,13,38,.342,8,9,.889,85
1143,BRK,2017-02-01,90,,NYK,L 90-95,240,37,88,.420,32,63,.508,5,25,.200,11,16,.688,90,35,99,.354,29,72,.403,6,27,.222,19,31,.613,95
1144,CLE,2017-01-02,90,,NOP,W 90-82,240,34,90,.378,28,59,.475,6,31,.194,16,22,.727,90,32,88,.364,21,62,.339,11,26,.423,7,10,.700,82
1145,CHI,2016-12-26,90,,IND,W 90-85,240,32,83,.386,26,58,.448,6,25,.240,20,28,.714,90,34,81,.420,25,56,.446,9,25,.360,8,10,.800,85
1146,POR,2016-12-23,90,,SAS,L 90-110,240,35,79,.443,23,49,.469,12,30,.400,8,16,.500,90,39,78,.500,27,58,.466,12,20,.600,20,21,.952,110
1147,DET,2016-12-17,90,,IND,L 90-105,240,32,84,.381,22,54,.407,10,30,.333,16,22,.727,90,40,83,.482,34,64,.531,6,19,.316,19,25,.760,105
1148,MIN,2016-12-09,90,,DET,L 90-117,240,37,78,.474,34,62,.548,3,16,.188,13,20,.650,90,42,84,.500,28,55,.509,14,29,.483,19,23,.826,117
1149,CHI,2016-11-30,90,,LAL,L 90-96,240,32,91,.352,28,70,.400,4,21,.190,22,29,.759,90,33,81,.407,31,73,.425,2,8,.250,28,41,.683,96
1150,CHO,2016-11-21,90,,MEM,L 90-105,240,30,73,.411,21,42,.500,9,31,.290,21,33,.636,90,40,84,.476,28,58,.483,12,26,.462,13,17,.765,105
1151,BOS,2016-11-16,90,,DAL,W 90-83,240,33,76,.434,26,55,.473,7,21,.333,17,23,.739,90,34,83,.410,26,60,.433,8,23,.348,7,10,.700,83
1152,MIA,2016-11-15,90,,ATL,L 90-93,240,36,89,.404,29,66,.439,7,23,.304,11,14,.786,90,37,80,.463,31,63,.492,6,17,.353,13,19,.684,93
1153,MIL,2017-04-10,89,,CHO,W 89-79,240,35,78,.449,19,51,.373,16,27,.593,3,5,.600,89,33,81,.407,28,63,.444,5,18,.278,8,13,.615,79
1154,DAL,2017-04-07,89,,SAS,L 89-102,240,38,88,.432,30,62,.484,8,26,.308,5,8,.625,89,40,96,.417,31,68,.456,9,28,.321,13,22,.591,102
1155,MEM,2017-02-06,89,,SAS,W 89-74,240,32,81,.395,28,62,.452,4,19,.211,21,25,.840,89,30,82,.366,26,63,.413,4,19,.211,10,18,.556,74
1156,BRK,2017-01-02,89,,UTA,L 89-101,240,33,78,.423,27,51,.529,6,27,.222,17,23,.739,89,39,93,.419,32,69,.464,7,24,.292,16,20,.800,101
1157,MIN,2017-01-01,89,,POR,L 89-95,240,35,87,.402,28,64,.438,7,23,.304,12,18,.667,89,36,73,.493,30,51,.588,6,22,.273,17,28,.607,95
1158,LAL,2016-12-29,89,,DAL,L 89-101,240,32,68,.471,25,49,.510,7,19,.368,18,25,.720,89,38,77,.494,24,46,.522,14,31,.452,11,14,.786,101
1159,PHI,2016-12-16,89,,LAL,L 89-100,240,32,88,.364,26,57,.456,6,31,.194,19,24,.792,89,36,79,.456,27,49,.551,9,30,.300,19,22,.864,100
1160,DAL,2016-12-07,89,,SAC,L 89-120,240,32,78,.410,22,48,.458,10,30,.333,15,20,.750,89,47,84,.560,37,62,.597,10,22,.455,16,21,.762,120
1161,CHO,2016-11-29,89,,DET,L 89-112,240,31,78,.397,22,51,.431,9,27,.333,18,21,.857,89,45,92,.489,33,64,.516,12,28,.429,10,11,.909,112
1162,PHI,2016-11-25,89,,CHI,L 89-105,240,31,78,.397,22,56,.393,9,22,.409,18,22,.818,89,40,90,.444,34,69,.493,6,21,.286,19,26,.731,105
1163,ORL,2016-11-16,89,,NOP,W 89-82,240,34,88,.386,24,61,.393,10,27,.370,11,19,.579,89,30,82,.366,23,61,.377,7,21,.333,15,19,.789,82
1164,MEM,2016-11-02,89,,NOP,W 89-83 (OT),265,33,94,.351,25,67,.373,8,27,.296,15,20,.750,89,30,81,.370,19,47,.404,11,34,.324,12,16,.750,83
1165,NYK,2017-03-29,88,,MIA,L 88-105,240,33,89,.371,28,64,.438,5,25,.200,17,21,.810,88,40,84,.476,28,59,.475,12,25,.480,13,17,.765,105
1166,UTA,2017-03-06,88,,NOP,W 88-83,240,33,81,.407,23,54,.426,10,27,.370,12,15,.800,88,30,84,.357,20,51,.392,10,33,.303,13,18,.722,83
1167,SAC,2017-02-27,88,,MIN,L 88-102,240,36,82,.439,30,65,.462,6,17,.353,10,15,.667,88,40,95,.421,32,72,.444,8,23,.348,14,20,.700,102
1168,MIL,2017-02-08,88,,MIA,L 88-106,240,33,71,.465,27,56,.482,6,15,.400,16,28,.571,88,41,86,.477,30,53,.566,11,33,.333,13,18,.722,106
1169,ORL,2017-02-01,88,,IND,L 88-98,240,31,77,.403,25,53,.472,6,24,.250,20,28,.714,88,33,69,.478,24,49,.490,9,20,.450,23,26,.885,98
1170,CHI,2017-01-27,88,,MIA,L 88-100,240,33,78,.423,30,65,.462,3,13,.231,19,25,.760,88,41,89,.461,32,65,.492,9,24,.375,9,11,.818,100
1171,MEM,2017-01-08,88,,UTA,W 88-79,240,34,78,.436,25,54,.463,9,24,.375,11,14,.786,88,28,72,.389,19,49,.388,9,23,.391,14,23,.609,79
1172,LAC,2016-12-23,88,,DAL,L 88-90,240,34,74,.459,21,45,.467,13,29,.448,7,11,.636,88,37,87,.425,30,58,.517,7,29,.241,9,15,.600,90
1173,MEM,2016-12-08,88,,POR,W 88-86,240,31,87,.356,25,67,.373,6,20,.300,20,30,.667,88,25,82,.305,18,54,.333,7,28,.250,29,40,.725,86
1174,NOP,2016-12-08,88,,PHI,L 88-99,240,33,84,.393,26,59,.441,7,25,.280,15,22,.682,88,39,91,.429,27,51,.529,12,40,.300,9,13,.692,99
1175,PHI,2016-12-02,88,,ORL,L 88-105,240,36,95,.379,27,63,.429,9,32,.281,7,10,.700,88,37,78,.474,24,52,.462,13,26,.500,18,26,.692,105
1176,BOS,2016-11-18,88,,GSW,L 88-104,240,31,83,.373,20,51,.392,11,32,.344,15,19,.789,88,44,90,.489,35,62,.565,9,28,.321,7,12,.583,104
1177,POR,2016-11-15,88,,CHI,L 88-113,240,34,95,.358,25,61,.410,9,34,.265,11,18,.611,88,41,98,.418,34,78,.436,7,20,.350,24,28,.857,113
1178,IND,2016-11-14,88,,ORL,W 88-69,240,35,90,.389,27,65,.415,8,25,.320,10,10,1.000,88,27,84,.321,22,59,.373,5,25,.200,10,13,.769,69
1179,ORL,2016-11-05,88,,WAS,W 88-86,240,31,78,.397,22,50,.440,9,28,.321,17,27,.630,88,34,86,.395,28,69,.406,6,17,.353,12,17,.706,86
1180,MEM,2016-11-04,88,,LAC,L 88-99,240,31,84,.369,22,58,.379,9,26,.346,17,22,.773,88,32,85,.376,24,58,.414,8,27,.296,27,33,.818,99
1181,BRK,2016-10-31,88,,CHI,L 88-118,240,33,96,.344,28,65,.431,5,31,.161,17,21,.810,88,45,89,.506,34,62,.548,11,27,.407,17,18,.944,118
1182,LAC,2016-10-30,88,,UTA,W 88-75,240,34,83,.410,28,56,.500,6,27,.222,14,20,.700,88,29,73,.397,22,54,.407,7,19,.368,10,13,.769,75
1183,SAS,2017-04-08,87,,LAC,L 87-98,240,34,80,.425,26,58,.448,8,22,.364,11,14,.786,87,42,84,.500,36,62,.581,6,22,.273,8,14,.571,98
1184,DAL,2017-03-21,87,,GSW,L 87-112,240,33,92,.359,22,58,.379,11,34,.324,10,12,.833,87,43,78,.551,30,48,.625,13,30,.433,13,16,.813,112
1185,NYK,2017-03-14,87,,IND,W 87-81,240,35,83,.422,26,55,.473,9,28,.321,8,13,.615,87,32,87,.368,24,58,.414,8,29,.276,9,15,.600,81
1186,NOP,2017-03-08,87,,TOR,L 87-94,240,34,80,.425,25,51,.490,9,29,.310,10,13,.769,87,36,76,.474,28,55,.509,8,21,.381,14,23,.609,94
1187,LAL,2017-01-10,87,,POR,L 87-108,240,32,83,.386,23,59,.390,9,24,.375,14,26,.538,87,43,85,.506,36,64,.563,7,21,.333,15,20,.750,108
1188,CHO,2016-12-07,87,,DET,W 87-77,240,30,88,.341,24,67,.358,6,21,.286,21,29,.724,87,34,89,.382,30,62,.484,4,27,.148,5,8,.625,77
1189,ORL,2016-12-07,87,,BOS,L 87-117,240,30,81,.370,19,55,.345,11,26,.423,16,24,.667,87,43,84,.512,36,58,.621,7,26,.269,24,29,.828,117
1190,DAL,2016-11-30,87,,SAS,L 87-94,240,33,77,.429,23,47,.489,10,30,.333,11,14,.786,87,33,71,.465,22,52,.423,11,19,.579,17,24,.708,94
1191,ORL,2016-11-23,87,,PHO,L 87-92,240,33,91,.363,26,66,.394,7,25,.280,14,23,.609,87,33,73,.452,24,51,.471,9,22,.409,17,22,.773,92
1192,DAL,2017-03-25,86,,TOR,L 86-94,240,31,82,.378,24,54,.444,7,28,.250,17,20,.850,86,39,81,.481,30,60,.500,9,21,.429,7,9,.778,94
1193,GSW,2017-03-08,86,,BOS,L 86-99,240,37,84,.440,31,54,.574,6,30,.200,6,9,.667,86,37,84,.440,27,55,.491,10,29,.345,15,19,.789,99
1194,ATL,2017-01-27,86,,WAS,L 86-112,240,30,83,.361,21,52,.404,9,31,.290,17,25,.680,86,43,89,.483,30,58,.517,13,31,.419,13,19,.684,112
1195,BRK,2017-01-23,86,,SAS,L 86-112,240,32,81,.395,27,56,.482,5,25,.200,17,18,.944,86,45,95,.474,36,73,.493,9,22,.409,13,16,.813,112
1196,DET,2016-12-21,86,,MEM,L 86-98,240,26,72,.361,20,49,.408,6,23,.261,28,37,.757,86,35,82,.427,23,52,.442,12,30,.400,16,19,.842,98
1197,DAL,2016-11-06,86,,MIL,W 86-75 (OT),265,33,88,.375,24,50,.480,9,38,.237,11,12,.917,86,30,82,.366,24,53,.453,6,29,.207,9,12,.750,75
1198,UTA,2016-11-04,86,,SAS,L 86-100,240,30,80,.375,19,54,.352,11,26,.423,15,24,.625,86,37,83,.446,31,63,.492,6,20,.300,20,22,.909,100
1199,SAC,2017-02-25,85,,CHO,L 85-99,240,31,79,.392,20,51,.392,11,28,.393,12,15,.800,85,34,85,.400,20,47,.426,14,38,.368,17,18,.944,99
1200,DAL,2016-12-14,85,,DET,L 85-95,240,32,78,.410,24,53,.453,8,25,.320,13,16,.813,85,36,71,.507,31,54,.574,5,17,.294,18,22,.818,95
1201,ATL,2016-12-02,85,,DET,L 85-121,240,32,88,.364,26,64,.406,6,24,.250,15,20,.750,85,48,89,.539,31,60,.517,17,29,.586,8,12,.667,121
1202,MEM,2016-11-28,85,,CHO,L 85-104,240,36,89,.404,29,60,.483,7,29,.241,6,13,.462,85,36,82,.439,27,56,.482,9,26,.346,23,31,.742,104
1203,LAL,2016-11-25,85,,GSW,L 85-109,240,32,90,.356,27,68,.397,5,22,.227,16,23,.696,85,43,83,.518,32,55,.582,11,28,.393,12,17,.706,109
1204,PHO,2016-11-25,85,,MIN,L 85-98,240,32,79,.405,26,53,.491,6,26,.231,15,21,.714,85,34,85,.400,27,63,.429,7,22,.318,23,25,.920,98
1205,IND,2016-11-23,85,,ATL,L 85-96,240,34,84,.405,27,57,.474,7,27,.259,10,14,.714,85,36,85,.424,31,65,.477,5,20,.250,19,22,.864,96
1206,MIA,2017-03-23,84,,TOR,L 84-101,240,32,82,.390,26,59,.441,6,23,.261,14,23,.609,84,35,79,.443,29,56,.518,6,23,.261,25,32,.781,101
1207,ATL,2016-12-21,84,,MIN,L 84-92,240,34,82,.415,27,56,.482,7,26,.269,9,13,.692,84,35,83,.422,26,54,.481,9,29,.310,13,14,.929,92
1208,PHI,2016-11-07,84,,UTA,L 84-109,240,31,77,.403,24,56,.429,7,21,.333,15,22,.682,84,43,85,.506,32,66,.485,11,19,.579,12,20,.600,109
1209,CLE,2017-04-12,83,,TOR,L 83-98,240,28,76,.368,18,39,.462,10,37,.270,17,24,.708,83,40,86,.465,32,60,.533,8,26,.308,10,16,.625,98
1210,DET,2017-03-15,83,,UTA,L 83-97,240,36,86,.419,33,73,.452,3,13,.231,8,12,.667,83,36,77,.468,23,49,.469,13,28,.464,12,16,.750,97
1211,SAS,2016-11-29,83,,ORL,L 83-95,240,28,76,.368,23,56,.411,5,20,.250,22,26,.846,83,39,86,.453,33,71,.465,6,15,.400,11,12,.917,95
1212,IND,2016-11-21,83,,GSW,L 83-120,240,33,103,.320,27,80,.338,6,23,.261,11,12,.917,83,40,90,.444,27,54,.500,13,36,.361,27,32,.844,120
1213,LAC,2016-11-02,83,,OKC,L 83-85,240,34,87,.391,27,65,.415,7,22,.318,8,18,.444,83,34,84,.405,29,64,.453,5,20,.250,12,20,.600,85
1214,PHI,2017-04-08,82,,MIL,L 82-90,240,27,77,.351,19,46,.413,8,31,.258,20,23,.870,82,35,79,.443,29,52,.558,6,27,.222,14,20,.700,90
1215,SAC,2017-03-29,82,,UTA,L 82-112,240,34,75,.453,32,60,.533,2,15,.133,12,18,.667,82,42,79,.532,29,48,.604,13,31,.419,15,19,.789,112
1216,DAL,2017-01-07,82,,ATL,L 82-97,240,32,82,.390,23,46,.500,9,36,.250,9,10,.900,82,30,74,.405,19,52,.365,11,22,.500,26,32,.813,97
1217,LAL,2017-03-26,81,,POR,L 81-97,240,33,84,.393,28,63,.444,5,21,.238,10,17,.588,81,36,89,.404,24,61,.393,12,28,.429,13,18,.722,97
1218,MEM,2016-11-25,81,,MIA,L 81-90,240,29,82,.354,25,63,.397,4,19,.211,19,23,.826,81,33,85,.388,21,54,.389,12,31,.387,12,18,.667,90
1219,UTA,2017-03-01,80,,MIN,L 80-107,240,35,90,.389,31,71,.437,4,19,.211,6,11,.545,80,39,78,.500,31,62,.500,8,16,.500,21,26,.808,107
1220,ORL,2017-02-15,79,,SAS,L 79-107,240,30,76,.395,26,58,.448,4,18,.222,15,19,.789,79,42,89,.472,34,58,.586,8,31,.258,15,19,.789,107
1221,ORL,2016-12-18,79,,TOR,L 79-109,240,34,83,.410,31,62,.500,3,21,.143,8,9,.889,79,43,87,.494,36,60,.600,7,27,.259,16,21,.762,109
1222,DET,2016-12-11,79,,PHI,L 79-97,240,32,82,.390,27,63,.429,5,19,.263,10,14,.714,79,38,68,.559,31,51,.608,7,17,.412,14,17,.824,97
1223,UTA,2016-11-17,77,,CHI,L 77-85,240,30,78,.385,25,53,.472,5,25,.200,12,14,.857,77,33,90,.367,28,73,.384,5,17,.294,14,16,.875,85
1224,DET,2017-03-17,75,,TOR,L 75-87,240,29,83,.349,26,63,.413,3,20,.150,14,21,.667,75,30,78,.385,21,51,.412,9,27,.333,18,20,.900,87
1225,ORL,2016-11-11,74,,UTA,L 74-87,240,26,78,.333,18,58,.310,8,20,.400,14,19,.737,74,33,81,.407,26,53,.491,7,28,.250,14,16,.875,87
1226,MEM,2016-12-18,73,,UTA,L 73-82,240,28,93,.301,26,70,.371,2,23,.087,15,18,.833,73,30,66,.455,22,39,.564,8,27,.296,14,25,.560,82
1227,UTA,2017-02-13,72,,LAC,L 72-88,240,28,87,.322,24,64,.375,4,23,.174,12,18,.667,72,36,81,.444,27,56,.482,9,25,.360,7,11,.636,88
1228,PHI,2016-10-29,72,,ATL,L 72-104,240,28,80,.350,23,62,.371,5,18,.278,11,15,.733,72,42,85,.494,37,65,.569,5,20,.250,15,23,.652,104
1229,CHI,2016-12-16,69,,MIL,L 69-95,240,28,92,.304,23,71,.324,5,21,.238,8,15,.533,69,38,82,.463,28,57,.491,10,25,.400,9,13,.692,95
1230,DAL,2016-11-18,64,,MEM,L 64-80,240,21,73,.288,16,48,.333,5,25,.200,17,22,.773,64,31,77,.403,22,52,.423,9,25,.360,9,12,.750,80