Rk,Team,Date,PTS,,Opp,Result,MP,FG,FGA,FG%,2P,2PA,2P%,3P,3PA,3P%,FT,FTA,FT%,PTS,FG,FGA,FG%,2P,2PA,2P%,3P,3PA,3P%,FT,FTA,FT%,PTS
1,WAS,2022-02-25,153,,SAS,L 153-157 (2OT),290,59,108,.546,43,70,.614,16,38,.421,19,24,.792,153,57,105,.543,48,76,.632,9,29,.310,34,43,.791,157
2,MEM,2021-12-02,152,,OKC,W 152-79,240,60,96,.625,41,60,.683,19,36,.528,13,18,.722,152,25,76,.329,14,38,.368,11,38,.289,18,22,.818,79
3,HOU,2021-11-27,146,,CHO,W 146-143 (OT),265,51,95,.537,28,46,.609,23,49,.469,21,31,.677,146,48,103,.466,28,53,.528,20,50,.400,27,30,.900,143
4,MIA,2022-04-05,144,,CHO,W 144-115,240,48,84,.571,25,42,.595,23,42,.548,25,29,.862,144,45,85,.529,33,47,.702,12,38,.316,13,18,.722,115
5,BOS,2022-04-03,144,,WAS,W 144-102,240,56,91,.615,33,47,.702,23,44,.523,9,13,.692,144,38,82,.463,30,61,.492,8,21,.381,18,20,.900,102
6,PHI,2022-04-02,144,,CHO,W 144-114,240,53,87,.609,32,44,.727,21,43,.488,17,21,.810,144,42,87,.483,31,57,.544,11,30,.367,19,24,.792,114
7,SAS,2021-12-26,144,,DET,W 144-109,240,51,91,.560,38,64,.594,13,27,.481,29,37,.784,144,38,98,.388,30,66,.455,8,32,.250,25,34,.735,109
8,CLE,2021-12-26,144,,TOR,W 144-99,240,56,106,.528,34,54,.630,22,52,.423,10,12,.833,144,37,89,.416,28,53,.528,9,36,.250,16,23,.696,99
9,LAC,2022-02-17,142,,HOU,W 142-111,240,51,92,.554,33,57,.579,18,35,.514,22,26,.846,142,42,91,.462,29,54,.537,13,37,.351,14,19,.737,111
10,SAC,2021-12-08,142,,ORL,W 142-130,240,53,97,.546,38,63,.603,15,34,.441,21,25,.840,142,48,97,.495,32,63,.508,16,34,.471,18,23,.783,130
11,DEN,2022-04-10,141,,LAL,L 141-146 (OT),265,49,100,.490,34,53,.642,15,47,.319,28,36,.778,141,44,94,.468,28,51,.549,16,43,.372,42,47,.894,146
12,MEM,2022-04-09,141,,NOP,W 141-114,240,53,90,.589,35,55,.636,18,35,.514,17,23,.739,141,41,91,.451,35,61,.574,6,30,.200,26,35,.743,114
13,PHO,2022-03-13,140,,LAL,W 140-111,240,58,102,.569,46,69,.667,12,33,.364,12,14,.857,140,36,81,.444,20,41,.488,16,40,.400,23,31,.742,111
14,DEN,2022-01-13,140,,POR,W 140-108,240,52,83,.627,31,41,.756,21,42,.500,15,20,.750,140,39,86,.453,26,46,.565,13,40,.325,17,28,.607,108
15,CHO,2022-01-05,140,,DET,W 140-111,240,48,81,.593,24,39,.615,24,42,.571,20,29,.690,140,43,92,.467,29,50,.580,14,42,.333,11,20,.550,111
16,SAC,2021-11-05,140,,CHO,W 140-110,240,48,87,.552,26,43,.605,22,44,.500,22,26,.846,140,43,92,.467,32,57,.561,11,35,.314,13,21,.619,110
17,SAS,2022-03-14,139,,MIN,L 139-149,240,52,97,.536,39,62,.629,13,35,.371,22,26,.846,139,52,90,.578,35,57,.614,17,33,.515,28,32,.875,149
18,HOU,2022-03-09,139,,LAL,W 139-130 (OT),265,52,102,.510,35,62,.565,17,40,.425,18,19,.947,139,47,101,.465,29,54,.537,18,47,.383,18,26,.692,130
19,LAC,2022-01-17,139,,IND,W 139-133,240,45,82,.549,27,46,.587,18,36,.500,31,36,.861,139,50,97,.515,37,64,.578,13,33,.394,20,23,.870,133
20,LAL,2021-12-31,139,,POR,W 139-106,240,47,85,.553,28,44,.636,19,41,.463,26,30,.867,139,36,102,.353,24,60,.400,12,42,.286,22,27,.815,106
21,LAC,2022-04-10,138,,OKC,W 138-88,240,54,97,.557,36,62,.581,18,35,.514,12,14,.857,138,37,98,.378,28,64,.438,9,34,.265,5,9,.556,88
22,MIN,2022-03-19,138,,MIL,W 138-119,240,47,92,.511,25,45,.556,22,47,.468,22,26,.846,138,43,97,.443,24,45,.533,19,52,.365,14,17,.824,119
23,DEN,2022-03-06,138,,NOP,W 138-130 (OT),265,47,87,.540,37,54,.685,10,33,.303,34,43,.791,138,48,101,.475,34,68,.500,14,33,.424,20,29,.690,130
24,MIN,2021-11-20,138,,MEM,W 138-95,240,49,91,.538,29,50,.580,20,41,.488,20,28,.714,138,29,83,.349,20,51,.392,9,32,.281,28,35,.800,95
25,NYK,2021-10-20,138,,BOS,W 138-134 (2OT),290,51,105,.486,34,60,.567,17,45,.378,19,27,.704,138,48,117,.410,27,60,.450,21,57,.368,17,23,.739,134
26,UTA,2022-04-06,137,,OKC,W 137-101,240,49,84,.583,34,48,.708,15,36,.417,24,32,.750,137,37,90,.411,21,53,.396,16,37,.432,11,17,.647,101
27,PHO,2021-12-19,137,,CHO,W 137-106,240,54,95,.568,34,54,.630,20,41,.488,9,13,.692,137,36,100,.360,26,55,.473,10,45,.222,24,28,.857,106
28,UTA,2021-12-03,137,,BOS,W 137-130,240,45,81,.556,18,30,.600,27,51,.529,20,23,.870,137,47,91,.516,33,52,.635,14,39,.359,22,22,1.000,130
29,LAL,2021-11-26,137,,SAC,L 137-141 (3OT),315,51,102,.500,36,58,.621,15,44,.341,20,28,.714,137,54,120,.450,40,75,.533,14,45,.311,19,29,.655,141
30,MIA,2021-10-21,137,,MIL,W 137-95,240,51,96,.531,36,61,.590,15,35,.429,20,31,.645,137,32,84,.381,20,42,.476,12,42,.286,19,29,.655,95
31,MIN,2022-01-23,136,,BRK,W 136-125,240,48,92,.522,34,60,.567,14,32,.438,26,31,.839,136,48,95,.505,33,57,.579,15,38,.395,14,15,.933,125
32,POR,2022-01-03,136,,ATL,W 136-131,240,47,89,.528,29,48,.604,18,41,.439,24,28,.857,136,48,88,.545,34,47,.723,14,41,.341,21,24,.875,131
33,MIL,2022-01-01,136,,NOP,W 136-113,240,49,92,.533,26,44,.591,23,48,.479,15,18,.833,136,39,95,.411,23,44,.523,16,51,.314,19,30,.633,113
34,MEM,2021-11-15,136,,HOU,W 136-102,240,52,96,.542,36,55,.655,16,41,.390,16,20,.800,136,36,95,.379,25,57,.439,11,38,.289,19,26,.731,102
35,SAS,2021-11-10,136,,SAC,W 136-117,240,49,92,.533,31,60,.517,18,32,.563,20,31,.645,136,47,91,.516,37,55,.673,10,36,.278,13,16,.813,117
36,WAS,2022-04-01,135,,DAL,W 135-103,240,49,90,.544,32,57,.561,17,33,.515,20,22,.909,135,34,78,.436,23,40,.575,11,38,.289,24,26,.923,103
37,CHI,2022-03-31,135,,LAC,W 135-130 (OT),265,50,102,.490,40,73,.548,10,29,.345,25,32,.781,135,45,90,.500,29,54,.537,16,36,.444,24,26,.923,130
38,MIN,2022-03-05,135,,POR,W 135-121,240,48,85,.565,33,48,.688,15,37,.405,24,29,.828,135,40,85,.471,24,47,.511,16,38,.421,25,30,.833,121
39,UTA,2022-02-14,135,,HOU,W 135-101,240,49,89,.551,31,49,.633,18,40,.450,19,22,.864,135,35,83,.422,23,46,.500,12,37,.324,19,28,.679,101
40,MEM,2022-02-08,135,,LAC,W 135-109,240,53,103,.515,44,77,.571,9,26,.346,20,25,.800,135,40,89,.449,29,58,.500,11,31,.355,18,24,.750,109
41,WAS,2021-10-22,135,,IND,W 135-134 (OT),265,49,94,.521,30,56,.536,19,38,.500,18,19,.947,135,52,97,.536,37,63,.587,15,34,.441,15,20,.750,134
42,BRK,2022-04-10,134,,IND,W 134-126,240,52,81,.642,44,59,.746,8,22,.364,22,25,.880,134,47,104,.452,28,58,.483,19,46,.413,13,19,.684,126
43,BOS,2022-03-27,134,,MIN,W 134-112,240,49,87,.563,32,48,.667,17,39,.436,19,21,.905,134,45,84,.536,31,52,.596,14,32,.438,8,12,.667,112
44,UTA,2022-03-12,134,,SAC,W 134-125,240,48,86,.558,32,45,.711,16,41,.390,22,31,.710,134,47,94,.500,34,61,.557,13,33,.394,18,21,.857,125
45,CHI,2022-02-11,134,,MIN,W 134-122,240,55,87,.632,41,56,.732,14,31,.452,10,13,.769,134,48,96,.500,35,56,.625,13,40,.325,13,16,.813,122
46,PHO,2022-01-28,134,,MIN,W 134-124,240,43,84,.512,23,45,.511,20,39,.513,28,37,.757,134,44,90,.489,30,51,.588,14,39,.359,22,27,.815,124
47,ATL,2022-01-19,134,,MIN,W 134-122,240,45,86,.523,30,48,.625,15,38,.395,29,33,.879,134,42,97,.433,25,51,.490,17,46,.370,21,29,.724,122
48,LAL,2022-01-07,134,,ATL,W 134-118,240,50,101,.495,33,60,.550,17,41,.415,17,19,.895,134,43,96,.448,30,60,.500,13,36,.361,19,27,.704,118
49,POR,2021-10-23,134,,PHO,W 134-105,240,51,94,.543,30,44,.682,21,50,.420,11,17,.647,134,43,89,.483,34,61,.557,9,28,.321,10,15,.667,105
50,CLE,2022-04-10,133,,MIL,W 133-115,240,51,94,.543,32,56,.571,19,38,.500,12,17,.706,133,39,88,.443,27,58,.466,12,30,.400,25,32,.781,115
51,PHI,2022-04-09,133,,IND,W 133-120,240,50,90,.556,38,56,.679,12,34,.353,21,27,.778,133,41,78,.526,31,55,.564,10,23,.435,28,36,.778,120
52,MEM,2022-03-24,133,,IND,W 133-103,240,50,93,.538,29,51,.569,21,42,.500,12,17,.706,133,39,92,.424,30,59,.508,9,33,.273,16,23,.696,103
53,WAS,2022-03-06,133,,IND,W 133-123,240,45,86,.523,28,44,.636,17,42,.405,26,32,.813,133,44,85,.518,34,54,.630,10,31,.323,25,29,.862,123
54,MIA,2022-02-26,133,,SAS,W 133-129,240,47,83,.566,35,55,.636,12,28,.429,27,38,.711,133,50,90,.556,36,59,.610,14,31,.452,15,19,.789,129
55,ATL,2022-02-08,133,,IND,W 133-112,240,52,90,.578,35,57,.614,17,33,.515,12,16,.750,133,37,93,.398,27,62,.435,10,31,.323,28,33,.848,112
56,MIL,2022-01-22,133,,SAC,W 133-127,240,45,91,.495,24,49,.490,21,42,.500,22,25,.880,133,51,97,.526,36,60,.600,15,37,.405,10,16,.625,127
57,DEN,2022-01-15,133,,LAL,W 133-96,240,47,91,.516,24,51,.471,23,40,.575,16,17,.941,133,36,82,.439,26,52,.500,10,30,.333,14,19,.737,96
58,CHI,2022-01-11,133,,DET,W 133-87,240,50,92,.543,32,58,.552,18,34,.529,15,19,.789,133,30,89,.337,24,54,.444,6,35,.171,21,27,.778,87
59,PHI,2022-01-03,133,,HOU,W 133-113,240,50,96,.521,33,56,.589,17,40,.425,16,17,.941,133,37,89,.416,22,45,.489,15,44,.341,24,33,.727,113
60,CHI,2021-12-20,133,,HOU,W 133-118,240,47,88,.534,31,53,.585,16,35,.457,23,24,.958,133,44,78,.564,32,45,.711,12,33,.364,18,24,.750,118
61,CHI,2021-11-29,133,,CHO,W 133-119,240,53,89,.596,39,59,.661,14,30,.467,13,19,.684,133,42,88,.477,24,49,.490,18,39,.462,17,21,.810,119
62,CHO,2021-11-26,133,,MIN,W 133-115,240,49,88,.557,26,48,.542,23,40,.575,12,15,.800,133,45,100,.450,34,65,.523,11,35,.314,14,19,.737,115
63,HOU,2022-04-03,132,,MIN,L 132-139,240,48,85,.565,32,45,.711,16,40,.400,20,29,.690,132,51,86,.593,34,45,.756,17,41,.415,20,25,.800,139
64,MEM,2022-03-23,132,,BRK,W 132-120,240,47,101,.465,28,63,.444,19,38,.500,19,22,.864,132,43,87,.494,34,62,.548,9,25,.360,25,27,.926,120
65,MIN,2022-03-09,132,,OKC,W 132-102,240,45,86,.523,23,34,.676,22,52,.423,20,26,.769,132,36,87,.414,22,44,.500,14,43,.326,16,24,.667,102
66,MEM,2022-03-08,132,,NOP,W 132-111,240,48,101,.475,32,57,.561,16,44,.364,20,24,.833,132,41,88,.466,30,54,.556,11,34,.324,18,27,.667,111
67,MIL,2022-03-06,132,,PHO,W 132-122,240,47,87,.540,32,55,.582,15,32,.469,23,29,.793,132,50,93,.538,36,62,.581,14,31,.452,8,11,.727,122
68,LAC,2022-03-03,132,,LAL,W 132-111,240,51,93,.548,34,66,.515,17,27,.630,13,15,.867,132,41,84,.488,29,49,.592,12,35,.343,17,22,.773,111
69,PHO,2022-02-12,132,,ORL,W 132-105,240,55,105,.524,40,71,.563,15,34,.441,7,10,.700,132,37,87,.425,22,46,.478,15,41,.366,16,24,.667,105
70,SAC,2022-02-09,132,,MIN,W 132-119,240,48,93,.516,36,63,.571,12,30,.400,24,27,.889,132,44,98,.449,28,52,.538,16,46,.348,15,18,.833,119
71,DEN,2022-02-08,132,,NYK,W 132-115,240,46,85,.541,30,46,.652,16,39,.410,24,31,.774,132,45,101,.446,30,58,.517,15,43,.349,10,12,.833,115
72,DAL,2022-01-29,132,,IND,W 132-105,240,51,96,.531,35,62,.565,16,34,.471,14,22,.636,132,40,91,.440,31,58,.534,9,33,.273,16,23,.696,105
73,MEM,2021-10-20,132,,CLE,W 132-121,240,53,100,.530,39,67,.582,14,33,.424,12,12,1.000,132,47,93,.505,33,55,.600,14,38,.368,13,18,.722,121
74,ATL,2022-03-31,131,,CLE,W 131-107,240,45,91,.495,28,52,.538,17,39,.436,24,28,.857,131,39,90,.433,32,60,.533,7,30,.233,22,28,.786,107
75,POR,2022-03-28,131,,OKC,L 131-134 (OT),265,51,112,.455,31,62,.500,20,50,.400,9,13,.692,131,48,90,.533,28,45,.622,20,45,.444,18,25,.720,134
76,TOR,2022-03-26,131,,IND,W 131-91,240,51,84,.607,36,52,.692,15,32,.469,14,19,.737,131,33,79,.418,22,43,.512,11,36,.306,14,20,.700,91
77,ATL,2022-03-13,131,,IND,W 131-128,240,46,84,.548,29,46,.630,17,38,.447,22,24,.917,131,46,89,.517,31,54,.574,15,35,.429,21,26,.808,128
78,DEN,2022-03-07,131,,GSW,W 131-124,240,46,84,.548,36,52,.692,10,32,.313,29,41,.707,131,45,88,.511,28,48,.583,17,40,.425,17,23,.739,124
79,PHO,2022-02-10,131,,MIL,W 131-107,240,51,90,.567,42,60,.700,9,30,.300,20,29,.690,131,40,88,.455,30,50,.600,10,38,.263,17,25,.680,107
80,SAS,2022-02-04,131,,HOU,W 131-106,240,51,89,.573,38,61,.623,13,28,.464,16,20,.800,131,36,83,.434,25,50,.500,11,33,.333,23,29,.793,106
81,SAS,2022-01-28,131,,CHI,W 131-122,240,50,95,.526,34,58,.586,16,37,.432,15,18,.833,131,46,88,.523,38,58,.655,8,30,.267,22,26,.846,122
82,SAC,2022-01-19,131,,DET,L 131-133,240,44,84,.524,32,57,.561,12,27,.444,31,44,.705,131,46,91,.505,31,55,.564,15,36,.417,26,30,.867,133
83,CHI,2021-12-29,131,,ATL,W 131-117,240,52,84,.619,42,62,.677,10,22,.455,17,22,.773,131,44,92,.478,33,66,.500,11,26,.423,18,26,.692,117
84,BRK,2021-12-14,131,,TOR,W 131-129 (OT),265,50,103,.485,36,64,.563,14,39,.359,17,23,.739,131,48,105,.457,30,53,.566,18,52,.346,15,19,.789,129
85,IND,2021-11-01,131,,SAS,W 131-118,240,52,91,.571,34,53,.642,18,38,.474,9,12,.750,131,47,89,.528,33,61,.541,14,28,.500,10,14,.714,118
86,DAL,2022-04-10,130,,SAS,W 130-120,240,46,85,.541,26,49,.531,20,36,.556,18,23,.783,130,43,89,.483,32,58,.552,11,31,.355,23,23,1.000,120
87,DEN,2022-04-01,130,,MIN,L 130-136,240,46,86,.535,34,51,.667,12,35,.343,26,29,.897,130,43,86,.500,24,46,.522,19,40,.475,31,36,.861,136
88,SAS,2022-04-01,130,,POR,W 130-111,240,46,81,.568,30,44,.682,16,37,.432,22,28,.786,130,41,92,.446,26,57,.456,15,35,.429,14,20,.700,111
89,BRK,2022-03-29,130,,DET,W 130-123,240,42,76,.553,27,48,.563,15,28,.536,31,34,.912,130,48,99,.485,32,61,.525,16,38,.421,11,13,.846,123
90,DEN,2022-03-24,130,,PHO,L 130-140,240,48,81,.593,33,49,.673,15,32,.469,19,27,.704,130,52,86,.605,39,59,.661,13,27,.481,23,29,.793,140
91,NOP,2022-03-13,130,,HOU,W 130-105,240,48,93,.516,38,61,.623,10,32,.313,24,34,.706,130,39,77,.506,27,46,.587,12,31,.387,15,25,.600,105
92,ATL,2022-03-03,130,,CHI,W 130-124,240,44,84,.524,26,44,.591,18,40,.450,24,28,.857,130,52,88,.591,38,62,.613,14,26,.538,6,7,.857,124
93,MIL,2022-02-28,130,,CHO,W 130-106,240,40,91,.440,22,46,.478,18,45,.400,32,37,.865,130,36,93,.387,22,54,.407,14,39,.359,20,32,.625,106
94,MIN,2022-02-01,130,,DEN,W 130-115,240,46,93,.495,27,48,.563,19,45,.422,19,25,.760,130,38,89,.427,24,45,.533,14,44,.318,25,28,.893,115
95,CHI,2022-01-30,130,,POR,W 130-116,240,50,90,.556,37,58,.638,13,32,.406,17,18,.944,130,43,83,.518,25,44,.568,18,39,.462,12,16,.750,116
96,GSW,2022-01-25,130,,DAL,W 130-92,240,49,92,.533,32,49,.653,17,43,.395,15,18,.833,130,32,91,.352,22,51,.431,10,40,.250,18,18,1.000,92
97,DEN,2022-01-19,130,,LAC,W 130-128 (OT),265,48,98,.490,35,60,.583,13,38,.342,21,25,.840,130,52,97,.536,37,58,.638,15,39,.385,9,12,.750,128
98,CHI,2022-01-07,130,,WAS,W 130-122,240,48,91,.527,33,58,.569,15,33,.455,19,21,.905,130,45,88,.511,38,64,.594,7,24,.292,25,26,.962,122
99,BOS,2021-11-19,130,,LAL,W 130-108,240,44,88,.500,33,58,.569,11,30,.367,31,38,.816,130,39,84,.464,27,54,.500,12,30,.400,18,24,.750,108
100,IND,2022-03-20,129,,POR,W 129-98,240,48,84,.571,33,49,.673,15,35,.429,18,21,.857,129,38,81,.469,29,48,.604,9,33,.273,13,18,.722,98
101,CHO,2022-03-19,129,,DAL,W 129-108,240,44,88,.500,24,46,.522,20,42,.476,21,27,.778,129,39,89,.438,25,51,.490,14,38,.368,16,20,.800,108
102,PHO,2022-03-18,129,,CHI,W 129-102,240,47,84,.560,36,59,.610,11,25,.440,24,26,.923,129,35,85,.412,28,58,.483,7,27,.259,25,31,.806,102
103,MIN,2022-03-01,129,,GSW,W 129-114,240,47,89,.528,31,49,.633,16,40,.400,19,23,.826,129,41,90,.456,28,45,.622,13,45,.289,19,22,.864,114
104,ATL,2022-01-30,129,,LAL,W 129-121,240,49,84,.583,39,53,.736,10,31,.323,21,32,.656,129,47,87,.540,32,52,.615,15,35,.429,12,23,.522,121
105,TOR,2022-01-04,129,,SAS,W 129-104,240,45,96,.469,27,52,.519,18,44,.409,21,29,.724,129,41,95,.432,32,60,.533,9,35,.257,13,19,.684,104
106,UTA,2021-11-29,129,,POR,W 129-107,240,47,89,.528,28,43,.651,19,46,.413,16,23,.696,129,42,91,.462,31,60,.517,11,31,.355,12,17,.706,107
107,ATL,2021-11-15,129,,ORL,W 129-111,240,47,85,.553,33,55,.600,14,30,.467,21,32,.656,129,43,95,.453,27,52,.519,16,43,.372,9,14,.643,111
108,LAC,2021-11-13,129,,MIN,W 129-102,240,53,99,.535,37,59,.627,16,40,.400,7,9,.778,129,40,102,.392,29,66,.439,11,36,.306,11,16,.688,102
109,CHO,2021-10-25,129,,BOS,L 129-140 (OT),265,46,103,.447,27,59,.458,19,44,.432,18,28,.643,129,50,101,.495,31,51,.608,19,50,.380,21,25,.840,140
110,DAL,2022-04-08,128,,POR,W 128-78,240,42,79,.532,22,34,.647,20,45,.444,24,31,.774,128,31,83,.373,24,51,.471,7,32,.219,9,12,.750,78
111,GSW,2022-04-07,128,,LAL,W 128-112,240,51,97,.526,35,65,.538,16,32,.500,10,10,1.000,128,37,83,.446,28,51,.549,9,32,.281,29,38,.763,112
112,CHO,2022-04-07,128,,ORL,W 128-101,240,48,92,.522,36,58,.621,12,34,.353,20,27,.741,128,38,95,.400,23,47,.489,15,48,.313,10,13,.769,101
113,BOS,2022-04-01,128,,IND,W 128-123,240,45,83,.542,33,50,.660,12,33,.364,26,28,.929,128,42,81,.519,25,45,.556,17,36,.472,22,23,.957,123
114,DAL,2022-03-29,128,,LAL,W 128-110,240,45,87,.517,25,41,.610,20,46,.435,18,23,.783,128,40,89,.449,28,45,.622,12,44,.273,18,22,.818,110
115,BRK,2022-03-18,128,,POR,W 128-123,240,45,77,.584,35,52,.673,10,25,.400,28,33,.848,128,48,96,.500,35,61,.574,13,35,.371,14,24,.583,123
116,NYK,2022-03-16,128,,POR,W 128-98,240,40,80,.500,24,42,.571,16,38,.421,32,39,.821,128,40,91,.440,29,57,.509,11,34,.324,7,14,.500,98
117,IND,2022-02-27,128,,BOS,W 128-107,240,47,90,.522,30,57,.526,17,33,.515,17,20,.850,128,39,91,.429,27,48,.563,12,43,.279,17,20,.850,107
118,MIL,2022-02-15,128,,IND,W 128-119,240,48,86,.558,38,57,.667,10,29,.345,22,30,.733,128,47,93,.505,30,52,.577,17,41,.415,8,19,.421,119
119,BOS,2022-01-25,128,,SAC,W 128-75,240,51,103,.495,31,58,.534,20,45,.444,6,7,.857,128,29,95,.305,23,62,.371,6,33,.182,11,15,.733,75
120,NOP,2022-01-11,128,,MIN,W 128-125,240,42,76,.553,26,43,.605,16,33,.485,28,37,.757,128,42,86,.488,24,47,.511,18,39,.462,23,31,.742,125
121,UTA,2021-12-23,128,,MIN,W 128-116,240,48,90,.533,32,51,.627,16,39,.410,16,22,.727,128,45,101,.446,28,56,.500,17,45,.378,9,12,.750,116
122,MEM,2021-11-28,128,,SAC,W 128-101,240,50,104,.481,37,65,.569,13,39,.333,15,20,.750,128,33,97,.340,24,55,.436,9,42,.214,26,37,.703,101
123,CHI,2021-10-22,128,,NOP,W 128-112,240,47,89,.528,33,61,.541,14,28,.500,20,25,.800,128,42,87,.483,27,58,.466,15,29,.517,13,16,.813,112
124,NOP,2022-04-07,127,,POR,W 127-94,240,44,93,.473,31,56,.554,13,37,.351,26,31,.839,127,36,69,.522,25,38,.658,11,31,.355,11,13,.846,94
125,MIN,2022-04-07,127,,SAS,W 127-121,240,41,96,.427,21,43,.488,20,53,.377,25,31,.806,127,43,89,.483,33,61,.541,10,28,.357,25,34,.735,121
126,MIL,2022-04-07,127,,BOS,W 127-121,240,49,97,.505,35,59,.593,14,38,.368,15,21,.714,127,43,87,.494,22,37,.595,21,50,.420,14,19,.737,121
127,WAS,2022-03-30,127,,ORL,W 127-110,240,47,92,.511,34,56,.607,13,36,.361,20,26,.769,127,40,96,.417,29,62,.468,11,34,.324,19,22,.864,110
128,MEM,2022-03-26,127,,MIL,W 127-102,240,49,102,.480,36,65,.554,13,37,.351,16,23,.696,127,37,93,.398,30,61,.492,7,32,.219,21,26,.808,102
129,DEN,2022-03-22,127,,LAC,W 127-115,240,45,83,.542,29,51,.569,16,32,.500,21,23,.913,127,42,86,.488,32,54,.593,10,32,.313,21,26,.808,115
130,WAS,2022-03-19,127,,LAL,W 127-119,240,44,85,.518,31,54,.574,13,31,.419,26,31,.839,127,48,91,.527,35,56,.625,13,35,.371,10,11,.909,119
131,POR,2022-03-12,127,,WAS,W 127-118,240,48,93,.516,37,63,.587,11,30,.367,20,22,.909,127,39,83,.470,25,49,.510,14,34,.412,26,27,.963,118
132,HOU,2022-03-02,127,,UTA,L 127-132 (OT),265,43,86,.500,22,35,.629,21,51,.412,20,30,.667,127,50,91,.549,35,49,.714,15,42,.357,17,24,.708,132
133,ATL,2022-02-26,127,,TOR,W 127-100,240,48,83,.578,35,52,.673,13,31,.419,18,22,.818,127,38,95,.400,28,63,.444,10,32,.313,14,19,.737,100
134,TOR,2022-02-03,127,,CHI,W 127-120 (OT),265,48,113,.425,34,77,.442,14,36,.389,17,19,.895,127,43,90,.478,31,61,.508,12,29,.414,22,24,.917,120
135,ATL,2021-12-05,127,,CHO,L 127-130,240,48,93,.516,31,56,.554,17,37,.459,14,18,.778,127,46,86,.535,29,49,.592,17,37,.459,21,28,.750,130
136,MIL,2021-12-01,127,,CHO,W 127-125,240,46,94,.489,32,58,.552,14,36,.389,21,26,.808,127,43,87,.494,22,36,.611,21,51,.412,18,21,.857,125
137,UTA,2021-11-27,127,,NOP,W 127-105,240,45,80,.563,25,45,.556,20,35,.571,17,22,.773,127,40,93,.430,32,58,.552,8,35,.229,17,21,.810,105
138,NOP,2021-11-24,127,,WAS,W 127-102,240,44,96,.458,32,67,.478,12,29,.414,27,32,.844,127,36,84,.429,29,53,.547,7,31,.226,23,36,.639,102
139,GSW,2021-11-08,127,,ATL,W 127-113,240,44,92,.478,26,48,.542,18,44,.409,21,22,.955,127,38,82,.463,21,39,.538,17,43,.395,20,26,.769,113
140,MIL,2021-10-19,127,,BRK,W 127-104,240,48,105,.457,31,60,.517,17,45,.378,14,18,.778,127,37,84,.440,20,52,.385,17,32,.531,13,23,.565,104
141,NOP,2022-03-24,126,,CHI,W 126-109,240,41,83,.494,29,54,.537,12,29,.414,32,34,.941,126,40,78,.513,26,44,.591,14,34,.412,15,19,.789,109
142,MIL,2022-03-22,126,,CHI,W 126-98,240,50,82,.610,38,54,.704,12,28,.429,14,20,.700,126,39,92,.424,26,59,.441,13,33,.394,7,13,.538,98
143,SAC,2022-03-16,126,,MIL,L 126-135,240,46,94,.489,30,51,.588,16,43,.372,18,21,.857,126,47,89,.528,29,54,.537,18,35,.514,23,32,.719,135
144,GSW,2022-03-14,126,,WAS,W 126-112,240,45,84,.536,27,39,.692,18,45,.400,18,22,.818,126,42,82,.512,32,56,.571,10,26,.385,18,23,.783,112
145,BOS,2022-03-06,126,,BRK,W 126-120,240,40,83,.482,23,47,.489,17,36,.472,29,38,.763,126,45,89,.506,33,62,.532,12,27,.444,18,20,.900,120
146,CHO,2022-02-27,126,,DET,L 126-127 (OT),265,45,89,.506,32,58,.552,13,31,.419,23,34,.676,126,50,110,.455,36,70,.514,14,40,.350,13,18,.722,127
147,MIN,2022-02-15,126,,CHO,W 126-120 (OT),265,43,109,.394,30,54,.556,13,55,.236,27,43,.628,126,42,102,.412,34,69,.493,8,33,.242,28,37,.757,120
148,GSW,2022-02-03,126,,SAC,W 126-114,240,47,84,.560,27,42,.643,20,42,.476,12,16,.750,126,42,80,.525,31,49,.633,11,31,.355,19,23,.826,114
149,CHI,2022-02-01,126,,ORL,W 126-115,240,46,90,.511,35,60,.583,11,30,.367,23,29,.793,126,46,93,.495,32,54,.593,14,39,.359,9,11,.818,115
150,MIN,2022-01-30,126,,UTA,W 126-106,240,49,89,.551,36,58,.621,13,31,.419,15,18,.833,126,38,81,.469,23,41,.561,15,40,.375,15,21,.714,106
151,IND,2022-01-26,126,,CHO,L 126-158,240,44,92,.478,34,58,.586,10,34,.294,28,34,.824,126,54,93,.581,30,48,.625,24,45,.533,26,33,.788,158
152,MIL,2022-01-19,126,,MEM,W 126-114,240,46,97,.474,33,60,.550,13,37,.351,21,22,.955,126,44,106,.415,35,66,.530,9,40,.225,17,25,.680,114
153,SAC,2022-01-14,126,,HOU,W 126-114,240,48,96,.500,35,59,.593,13,37,.351,17,24,.708,126,44,101,.436,31,58,.534,13,43,.302,13,16,.813,114
154,DET,2022-01-10,126,,UTA,W 126-116,240,48,93,.516,29,56,.518,19,37,.514,11,12,.917,126,44,86,.512,33,53,.623,11,33,.333,17,22,.773,116
155,MIL,2021-12-22,126,,HOU,W 126-106,240,45,103,.437,28,57,.491,17,46,.370,19,21,.905,126,36,86,.419,23,41,.561,13,45,.289,21,31,.677,106
156,UTA,2021-12-17,126,,SAS,L 126-128,240,46,93,.495,33,56,.589,13,37,.351,21,26,.808,126,50,100,.500,35,59,.593,15,41,.366,13,18,.722,128
157,ATL,2021-12-13,126,,HOU,L 126-132,240,42,85,.494,27,46,.587,15,39,.385,27,31,.871,126,46,96,.479,27,50,.540,19,46,.413,21,27,.778,132
158,MEM,2021-12-13,126,,PHI,W 126-91,240,47,89,.528,33,55,.600,14,34,.412,18,23,.783,126,37,83,.446,33,61,.541,4,22,.182,13,19,.684,91
159,GSW,2021-12-06,126,,ORL,W 126-95,240,43,87,.494,23,47,.489,20,40,.500,20,29,.690,126,33,76,.434,22,38,.579,11,38,.289,18,22,.818,95
160,PHO,2021-11-21,126,,DEN,W 126-97,240,46,87,.529,35,51,.686,11,36,.306,23,26,.885,126,33,90,.367,22,52,.423,11,38,.289,20,28,.714,97
161,LAL,2021-11-08,126,,CHO,W 126-123 (OT),265,44,91,.484,31,59,.525,13,32,.406,25,35,.714,126,43,99,.434,29,57,.509,14,42,.333,23,28,.821,123
162,GSW,2021-11-05,126,,NOP,W 126-85,240,47,91,.516,27,41,.659,20,50,.400,12,14,.857,126,31,88,.352,20,44,.455,11,44,.250,12,16,.750,85
163,ORL,2022-04-10,125,,MIA,W 125-111,240,45,91,.495,22,33,.667,23,58,.397,12,14,.857,125,40,94,.426,21,44,.477,19,50,.380,12,16,.750,111
164,TOR,2022-03-30,125,,MIN,W 125-102,240,48,96,.500,30,60,.500,18,36,.500,11,15,.733,125,37,92,.402,26,55,.473,11,37,.297,17,23,.739,102
165,BOS,2022-03-23,125,,UTA,W 125-97,240,50,84,.595,31,48,.646,19,36,.528,6,7,.857,125,35,88,.398,27,52,.519,8,36,.222,19,21,.905,97
166,UTA,2022-03-16,125,,CHI,W 125-110,240,42,83,.506,23,44,.523,19,39,.487,22,29,.759,125,43,91,.473,31,57,.544,12,34,.353,12,17,.706,110
167,PHI,2022-03-04,125,,CLE,W 125-119,240,41,75,.547,27,42,.643,14,33,.424,29,32,.906,125,44,82,.537,34,54,.630,10,28,.357,21,24,.875,119
168,NOP,2022-03-02,125,,SAC,W 125-95,240,52,88,.591,41,59,.695,11,29,.379,10,12,.833,125,35,89,.393,27,54,.500,8,35,.229,17,25,.680,95
169,CHO,2022-02-25,125,,TOR,W 125-93,240,52,94,.553,37,54,.685,15,40,.375,6,9,.667,125,37,84,.440,31,61,.508,6,23,.261,13,23,.565,93
170,IND,2022-02-25,125,,OKC,L 125-129 (OT),265,49,101,.485,35,64,.547,14,37,.378,13,22,.591,125,50,101,.495,39,70,.557,11,31,.355,18,24,.750,129
171,CHI,2022-02-16,125,,SAC,W 125-118,240,47,94,.500,35,65,.538,12,29,.414,19,20,.950,125,43,84,.512,31,54,.574,12,30,.400,20,22,.909,118
172,UTA,2022-02-04,125,,BRK,W 125-102,240,48,85,.565,31,47,.660,17,38,.447,12,14,.857,125,41,99,.414,29,65,.446,12,34,.353,8,11,.727,102
173,TOR,2022-02-04,125,,ATL,W 125-114,240,46,81,.568,29,54,.537,17,27,.630,16,18,.889,125,43,93,.462,34,64,.531,9,29,.310,19,21,.905,114
174,TOR,2022-01-25,125,,CHO,W 125-113,240,43,82,.524,27,48,.563,16,34,.471,23,29,.793,125,40,82,.488,30,51,.588,10,31,.323,23,32,.719,113
175,SAC,2022-01-12,125,,LAL,W 125-116,240,49,89,.551,38,59,.644,11,30,.367,16,19,.842,125,42,98,.429,26,51,.510,16,47,.340,16,24,.667,116
176,IND,2022-01-08,125,,UTA,W 125-113,240,44,80,.550,30,51,.588,14,29,.483,23,32,.719,125,40,84,.476,25,49,.510,15,35,.429,18,19,.947,113
177,MIA,2021-12-21,125,,IND,W 125-96,240,47,95,.495,25,46,.543,22,49,.449,9,11,.818,125,31,87,.356,20,56,.357,11,31,.355,23,28,.821,96
178,POR,2021-12-17,125,,CHO,W 125-116,240,44,85,.518,23,38,.605,21,47,.447,16,18,.889,125,44,92,.478,31,55,.564,13,37,.351,15,18,.833,116
179,SAC,2021-11-24,125,,POR,W 125-121,240,45,86,.523,33,53,.623,12,33,.364,23,34,.676,125,44,94,.468,32,56,.571,12,38,.316,21,25,.840,121
180,MEM,2021-11-08,125,,MIN,W 125-118 (OT),265,46,92,.500,35,64,.547,11,28,.393,22,26,.846,125,41,97,.423,24,52,.462,17,45,.378,19,23,.826,118
181,CHO,2021-10-31,125,,POR,W 125-113,240,46,89,.517,26,47,.553,20,42,.476,13,21,.619,125,43,97,.443,26,43,.605,17,54,.315,10,11,.909,113
182,CHO,2022-04-10,124,,WAS,W 124-108,240,48,89,.539,30,56,.536,18,33,.545,10,14,.714,124,42,94,.447,34,71,.479,8,23,.348,16,26,.615,108
183,SAC,2022-03-20,124,,PHO,L 124-127 (OT),265,39,91,.429,23,57,.404,16,34,.471,30,36,.833,124,46,92,.500,34,64,.531,12,28,.429,23,27,.852,127
184,MIN,2022-03-16,124,,LAL,W 124-104,240,40,90,.444,23,48,.479,17,42,.405,27,31,.871,124,39,93,.419,29,49,.592,10,44,.227,16,23,.696,104
185,MIL,2022-03-09,124,,ATL,W 124-115,240,47,94,.500,35,59,.593,12,35,.343,18,23,.783,124,43,86,.500,32,48,.667,11,38,.289,18,22,.818,115
186,IND,2022-03-08,124,,CLE,L 124-127,240,49,91,.538,33,59,.559,16,32,.500,10,15,.667,124,47,94,.500,38,62,.613,9,32,.281,24,27,.889,127
187,MIN,2022-03-07,124,,POR,W 124-81,240,38,92,.413,25,49,.510,13,43,.302,35,44,.795,124,23,83,.277,16,55,.291,7,28,.250,28,38,.737,81
188,LAL,2022-03-05,124,,GSW,W 124-116,240,44,89,.494,26,48,.542,18,41,.439,18,21,.857,124,46,92,.500,31,58,.534,15,34,.441,9,19,.474,116
189,MEM,2022-03-05,124,,ORL,W 124-96,240,46,92,.500,32,58,.552,14,34,.412,18,27,.667,124,37,86,.430,26,51,.510,11,35,.314,11,16,.688,96
190,NOP,2022-03-04,124,,UTA,W 124-90,240,50,97,.515,39,61,.639,11,36,.306,13,17,.765,124,31,89,.348,20,48,.417,11,41,.268,17,26,.654,90
191,PHO,2022-02-16,124,,HOU,W 124-121,240,44,86,.512,37,62,.597,7,24,.292,29,36,.806,124,42,97,.433,29,53,.547,13,44,.295,24,28,.857,121
192,ATL,2022-02-15,124,,CLE,W 124-116,240,43,80,.538,29,47,.617,14,33,.424,24,27,.889,124,45,88,.511,29,47,.617,16,41,.390,10,12,.833,116
193,CHI,2022-02-07,124,,PHO,L 124-127,240,43,90,.478,33,64,.516,10,26,.385,28,31,.903,124,49,90,.544,37,58,.638,12,32,.375,17,19,.895,127
194,DEN,2022-02-06,124,,BRK,W 124-104,240,49,94,.521,39,62,.629,10,32,.313,16,21,.762,124,36,87,.414,20,46,.435,16,41,.390,16,22,.727,104
195,ATL,2022-02-03,124,,PHO,W 124-115,240,44,84,.524,24,44,.545,20,40,.500,16,22,.727,124,46,88,.523,37,56,.661,9,32,.281,14,18,.778,115
196,GSW,2022-01-27,124,,MIN,W 124-115,240,44,82,.537,23,46,.500,21,36,.583,15,21,.714,124,42,95,.442,32,51,.627,10,44,.227,21,27,.778,115
197,MIA,2022-01-14,124,,ATL,W 124-118,240,41,77,.532,27,47,.574,14,30,.467,28,30,.933,124,38,79,.481,22,41,.537,16,38,.421,26,30,.867,118
198,SAS,2022-01-12,124,,HOU,L 124-128,240,43,99,.434,26,53,.491,17,46,.370,21,27,.778,124,45,82,.549,29,46,.630,16,36,.444,22,32,.688,128
199,WAS,2022-01-03,124,,CHO,W 124-121,240,40,87,.460,24,49,.490,16,38,.421,28,31,.903,124,50,104,.481,36,66,.545,14,38,.368,7,13,.538,121
200,UTA,2021-12-15,124,,LAC,W 124-103,240,47,89,.528,32,52,.615,15,37,.405,15,20,.750,124,40,85,.471,30,55,.545,10,30,.333,13,20,.650,103
201,CLE,2021-12-15,124,,HOU,W 124-89,240,45,80,.563,27,40,.675,18,40,.450,16,24,.667,124,30,78,.385,25,49,.510,5,29,.172,24,35,.686,89
202,TOR,2021-12-13,124,,SAC,W 124-101,240,53,98,.541,42,67,.627,11,31,.355,7,10,.700,124,38,94,.404,27,60,.450,11,34,.324,14,21,.667,101
203,CHO,2021-12-10,124,,SAC,W 124-123,240,48,87,.552,34,52,.654,14,35,.400,14,20,.700,124,48,101,.475,34,60,.567,14,41,.341,13,17,.765,123
204,CHO,2021-12-06,124,,PHI,L 124-127 (OT),265,48,107,.449,32,61,.525,16,46,.348,12,17,.706,124,46,87,.529,31,51,.608,15,36,.417,20,27,.741,127
205,MIL,2021-12-04,124,,MIA,W 124-102,240,44,98,.449,26,48,.542,18,50,.360,18,20,.900,124,34,84,.405,17,41,.415,17,43,.395,17,24,.708,102
206,DEN,2021-11-14,124,,POR,W 124-95,240,47,90,.522,28,50,.560,19,40,.475,11,14,.786,124,35,80,.438,22,41,.537,13,39,.333,12,13,.923,95
207,HOU,2021-10-22,124,,OKC,W 124-91,240,48,95,.505,31,57,.544,17,38,.447,11,14,.786,124,34,91,.374,20,48,.417,14,43,.326,9,16,.563,91
208,MIN,2021-10-20,124,,HOU,W 124-106,240,42,87,.483,26,49,.531,16,38,.421,24,31,.774,124,40,88,.455,29,55,.527,11,33,.333,15,22,.682,106
209,MEM,2022-03-28,123,,GSW,W 123-95,240,43,92,.467,31,62,.500,12,30,.400,25,35,.714,123,33,81,.407,24,52,.462,9,29,.310,20,26,.769,95
210,IND,2022-03-28,123,,ATL,L 123-132,240,45,87,.517,28,51,.549,17,36,.472,16,18,.889,123,47,86,.547,30,51,.588,17,35,.486,21,26,.808,132
211,MIA,2022-03-28,123,,SAC,W 123-100,240,49,90,.544,30,50,.600,19,40,.475,6,6,1.000,123,37,81,.457,25,46,.543,12,35,.343,14,18,.778,100
212,WAS,2022-03-27,123,,GSW,W 123-115,240,44,84,.524,28,56,.500,16,28,.571,19,22,.864,123,38,89,.427,30,56,.536,8,33,.242,31,39,.795,115
213,OKC,2022-03-21,123,,BOS,L 123-132,240,48,93,.516,31,56,.554,17,37,.459,10,14,.714,123,44,86,.512,29,46,.630,15,40,.375,29,34,.853,132
214,TOR,2022-03-18,123,,LAL,L 123-128 (OT),265,49,97,.505,37,60,.617,12,37,.324,13,20,.650,123,47,96,.490,28,53,.528,19,43,.442,15,21,.714,128
215,UTA,2022-03-09,123,,POR,W 123-85,240,42,81,.519,25,35,.714,17,46,.370,22,27,.815,123,29,89,.326,20,53,.377,9,36,.250,18,22,.818,85
216,MIA,2022-03-07,123,,HOU,W 123-106,240,49,91,.538,35,60,.583,14,31,.452,11,14,.786,123,39,88,.443,26,45,.578,13,43,.302,15,22,.682,106
217,HOU,2022-03-06,123,,MEM,W 123-112,240,43,82,.524,30,48,.625,13,34,.382,24,36,.667,123,44,97,.454,39,71,.549,5,26,.192,19,27,.704,112
218,CHO,2022-03-05,123,,SAS,W 123-117,240,42,91,.462,26,49,.531,16,42,.381,23,29,.793,123,45,98,.459,34,61,.557,11,37,.297,16,20,.800,117
219,PHI,2022-03-02,123,,NYK,W 123-108,240,39,75,.520,22,39,.564,17,36,.472,28,33,.848,123,39,91,.429,31,63,.492,8,28,.286,22,32,.688,108
220,MIL,2022-02-26,123,,BRK,L 123-126,240,41,78,.526,25,40,.625,16,38,.421,25,38,.658,123,44,92,.478,31,58,.534,13,34,.382,25,33,.758,126
221,NYK,2022-02-14,123,,OKC,L 123-127 (OT),265,45,108,.417,30,58,.517,15,50,.300,18,22,.818,123,48,96,.500,35,62,.565,13,34,.382,18,27,.667,127
222,MIL,2022-01-28,123,,NYK,W 123-108,240,41,89,.461,27,46,.587,14,43,.326,27,31,.871,123,39,84,.464,25,44,.568,14,40,.350,16,28,.571,108
223,PHI,2022-01-19,123,,ORL,W 123-110,240,45,83,.542,35,55,.636,10,28,.357,23,27,.852,123,40,90,.444,22,55,.400,18,35,.514,12,16,.750,110
224,HOU,2022-01-09,123,,MIN,L 123-141,240,46,97,.474,32,54,.593,14,43,.326,17,28,.607,123,55,108,.509,40,66,.606,15,42,.357,16,21,.762,141
225,BOS,2021-12-31,123,,PHO,W 123-108,240,45,83,.542,35,56,.625,10,27,.370,23,26,.885,123,41,100,.410,30,65,.462,11,35,.314,15,16,.938,108
226,HOU,2021-12-28,123,,LAL,L 123-132,240,44,83,.530,28,48,.583,16,35,.457,19,25,.760,123,48,92,.522,34,58,.586,14,34,.412,22,29,.759,132
227,CHO,2021-12-27,123,,HOU,W 123-99,240,47,88,.534,29,47,.617,18,41,.439,11,14,.786,123,36,87,.414,21,41,.512,15,46,.326,12,18,.667,99
228,SAS,2021-12-09,123,,DEN,W 123-111,240,46,88,.523,31,53,.585,15,35,.429,16,22,.727,123,42,94,.447,27,55,.491,15,39,.385,12,13,.923,111
229,MIL,2021-11-22,123,,ORL,W 123-92,240,44,94,.468,26,49,.531,18,45,.400,17,24,.708,123,34,93,.366,23,52,.442,11,41,.268,13,18,.722,92
230,GSW,2021-11-10,123,,MIN,W 123-110,240,40,85,.471,29,45,.644,11,40,.275,32,40,.800,123,39,95,.411,22,51,.431,17,44,.386,15,20,.750,110
231,PHO,2021-11-04,123,,HOU,W 123-111,240,44,93,.473,30,62,.484,14,31,.452,21,23,.913,123,38,88,.432,27,56,.482,11,32,.344,24,28,.857,111
232,OKC,2021-10-27,123,,LAL,W 123-115,240,43,86,.500,28,49,.571,15,37,.405,22,29,.759,123,46,92,.500,35,57,.614,11,35,.314,12,14,.857,115
233,CHO,2021-10-20,123,,IND,W 123-122,240,46,107,.430,33,76,.434,13,31,.419,18,27,.667,123,42,90,.467,25,43,.581,17,47,.362,21,24,.875,122
234,SAS,2021-10-20,123,,ORL,W 123-97,240,49,98,.500,36,68,.529,13,30,.433,12,18,.667,123,35,86,.407,26,57,.456,9,29,.310,18,23,.783,97
235,DEN,2022-04-07,122,,MEM,W 122-109,240,44,80,.550,32,50,.640,12,30,.400,22,25,.880,122,42,89,.472,31,61,.508,11,28,.393,14,19,.737,109
236,IND,2022-04-05,122,,PHI,L 122-131,240,45,95,.474,33,55,.600,12,40,.300,20,21,.952,122,47,87,.540,24,47,.511,23,40,.575,14,18,.778,131
237,ATL,2022-04-02,122,,BRK,W 122-115,240,36,86,.419,23,45,.511,13,41,.317,37,49,.755,122,42,99,.424,25,62,.403,17,37,.459,14,19,.737,115
238,MEM,2022-04-01,122,,PHO,W 122-114,240,46,102,.451,39,78,.500,7,24,.292,23,28,.821,122,47,86,.547,37,59,.627,10,27,.370,10,17,.588,114
239,UTA,2022-03-31,122,,LAL,W 122-109,240,46,90,.511,31,46,.674,15,44,.341,15,24,.625,122,41,83,.494,34,58,.586,7,25,.280,20,28,.714,109
240,DET,2022-03-23,122,,ATL,W 122-101,240,44,88,.500,32,55,.582,12,33,.364,22,25,.880,122,37,92,.402,23,48,.479,14,44,.318,13,15,.867,101
241,SAS,2022-03-16,122,,OKC,W 122-120,240,43,98,.439,24,57,.421,19,41,.463,17,20,.850,122,43,82,.524,30,47,.638,13,35,.371,21,29,.724,120
242,ATL,2022-03-14,122,,POR,W 122-113,240,40,109,.367,28,61,.459,12,48,.250,30,32,.938,122,44,88,.500,34,64,.531,10,24,.417,15,21,.714,113
243,GSW,2022-03-12,122,,MIL,W 122-109,240,45,93,.484,27,48,.563,18,45,.400,14,15,.933,122,38,92,.413,21,48,.438,17,44,.386,16,23,.696,109
244,LAL,2022-03-11,122,,WAS,W 122-109,240,48,91,.527,34,60,.567,14,31,.452,12,17,.706,122,39,85,.459,30,58,.517,9,27,.333,22,33,.667,109
245,DAL,2022-03-03,122,,GSW,W 122-113,240,45,85,.529,28,48,.583,17,37,.459,15,20,.750,122,44,81,.543,29,51,.569,15,30,.500,10,13,.769,113
246,CLE,2022-02-28,122,,MIN,L 122-127,240,39,74,.527,24,37,.649,15,37,.405,29,34,.853,122,47,86,.547,29,44,.659,18,42,.429,15,19,.789,127
247,LAL,2022-02-05,122,,NYK,W 122-115 (OT),265,48,102,.471,39,68,.574,9,34,.265,17,28,.607,122,39,98,.398,28,60,.467,11,38,.289,26,36,.722,115
248,PHI,2022-01-31,122,,MEM,W 122-119 (OT),265,49,100,.490,38,69,.551,11,31,.355,13,15,.867,122,47,102,.461,41,72,.569,6,30,.200,19,28,.679,119
249,IND,2022-01-31,122,,LAC,W 122-116,240,50,95,.526,36,66,.545,14,29,.483,8,12,.667,122,45,96,.469,30,52,.577,15,44,.341,11,13,.846,116
250,BOS,2022-01-31,122,,MIA,W 122-92,240,44,84,.524,28,42,.667,16,42,.381,18,27,.667,122,34,87,.391,17,43,.395,17,44,.386,7,10,.700,92
251,WAS,2022-01-11,122,,OKC,W 122-118,240,47,87,.540,36,54,.667,11,33,.333,17,23,.739,122,47,98,.480,36,59,.610,11,39,.282,13,15,.867,118
252,TOR,2022-01-07,122,,UTA,W 122-108,240,45,100,.450,33,59,.559,12,41,.293,20,25,.800,122,39,81,.481,22,43,.512,17,38,.447,13,18,.722,108
253,LAL,2022-01-04,122,,SAC,W 122-114,240,49,99,.495,38,67,.567,11,32,.344,13,20,.650,122,43,83,.518,29,49,.592,14,34,.412,14,18,.778,114
254,IND,2021-12-16,122,,DET,W 122-113,240,45,91,.495,38,59,.644,7,32,.219,25,28,.893,122,40,81,.494,33,56,.589,7,25,.280,26,30,.867,113
255,IND,2021-12-08,122,,NYK,W 122-102,240,46,86,.535,36,59,.610,10,27,.370,20,25,.800,122,36,86,.419,27,56,.482,9,30,.300,21,23,.913,102
256,BOS,2021-11-12,122,,MIL,W 122-113 (OT),265,47,96,.490,35,55,.636,12,41,.293,16,18,.889,122,44,98,.449,28,51,.549,16,47,.340,9,11,.818,113
257,PHI,2021-10-30,122,,ATL,W 122-94,240,46,86,.535,34,48,.708,12,38,.316,18,19,.947,122,36,95,.379,28,73,.384,8,22,.364,14,19,.737,94
258,WAS,2021-10-28,122,,ATL,W 122-111,240,46,99,.465,33,65,.508,13,34,.382,17,21,.810,122,48,88,.545,42,67,.627,6,21,.286,9,14,.643,111
259,UTA,2021-10-26,122,,DEN,W 122-110,240,44,85,.518,32,46,.696,12,39,.308,22,29,.759,122,42,83,.506,32,55,.582,10,28,.357,16,24,.667,110
260,ATL,2021-10-25,122,,DET,W 122-104,240,46,90,.511,34,58,.586,12,32,.375,18,21,.857,122,40,91,.440,31,58,.534,9,33,.273,15,18,.833,104
261,UTA,2022-04-05,121,,MEM,W 121-115 (OT),265,40,96,.417,28,58,.483,12,38,.316,29,43,.674,121,39,101,.386,26,70,.371,13,31,.419,24,29,.828,115
262,PHO,2022-04-05,121,,LAL,W 121-110,240,50,102,.490,36,63,.571,14,39,.359,7,9,.778,121,39,86,.453,30,57,.526,9,29,.310,23,30,.767,110
263,LAC,2022-03-29,121,,UTA,W 121-115,240,41,83,.494,26,47,.553,15,36,.417,24,28,.857,121,43,78,.551,31,47,.660,12,31,.387,17,29,.586,115
264,ATL,2022-03-25,121,,GSW,W 121-110,240,46,89,.517,32,52,.615,14,37,.378,15,19,.789,121,43,90,.478,29,49,.592,14,41,.341,10,13,.769,110
265,LAL,2022-03-23,121,,PHI,L 121-126,240,50,97,.515,39,67,.582,11,30,.367,10,16,.625,121,47,91,.516,37,64,.578,10,27,.370,22,28,.786,126
266,UTA,2022-03-18,121,,LAC,W 121-92,240,47,97,.485,31,53,.585,16,44,.364,11,14,.786,121,31,86,.360,20,51,.392,11,35,.314,19,21,.905,92
267,CHO,2022-03-08,121,,BRK,L 121-132,240,45,92,.489,32,51,.627,13,41,.317,18,22,.818,121,46,82,.561,28,47,.596,18,35,.514,22,29,.759,132
268,PHI,2022-03-07,121,,CHI,W 121-106,240,41,84,.488,29,54,.537,12,30,.400,27,34,.794,121,39,87,.448,31,63,.492,8,24,.333,20,26,.769,106
269,DEN,2022-02-14,121,,ORL,W 121-111,240,42,88,.477,26,48,.542,16,40,.400,21,23,.913,121,40,91,.440,29,52,.558,11,39,.282,20,23,.870,111
270,ATL,2022-02-11,121,,SAS,L 121-136,240,47,103,.456,33,60,.550,14,43,.326,13,15,.867,121,50,90,.556,32,58,.552,18,32,.563,18,21,.857,136
271,PHO,2022-02-01,121,,BRK,W 121-111,240,42,76,.553,31,45,.689,11,31,.355,26,31,.839,121,40,81,.494,24,41,.585,16,40,.400,15,21,.714,111
272,MIA,2022-01-28,121,,LAC,W 121-114,240,40,85,.471,25,51,.490,15,34,.441,26,27,.963,121,41,92,.446,32,57,.561,9,35,.257,23,32,.719,114
273,ATL,2022-01-26,121,,SAC,W 121-104,240,48,90,.533,36,54,.667,12,36,.333,13,17,.765,121,39,93,.419,27,53,.509,12,40,.300,14,19,.737,104
274,CHO,2022-01-21,121,,OKC,W 121-98,240,45,99,.455,28,50,.560,17,49,.347,14,20,.700,121,37,98,.378,25,54,.463,12,44,.273,12,15,.800,98
275,ATL,2022-01-17,121,,MIL,W 121-114,240,38,86,.442,23,50,.460,15,36,.417,30,32,.938,121,39,88,.443,23,50,.460,16,38,.421,20,24,.833,114
276,BRK,2022-01-09,121,,SAS,W 121-119 (OT),265,47,98,.480,39,70,.557,8,28,.286,19,22,.864,121,46,107,.430,33,75,.440,13,32,.406,14,18,.778,119
277,DEN,2022-01-07,121,,SAC,W 121-111,240,47,85,.553,35,51,.686,12,34,.353,15,24,.625,121,40,92,.435,29,63,.460,11,29,.379,20,24,.833,111
278,IND,2022-01-05,121,,BRK,L 121-129,240,41,82,.500,28,43,.651,13,39,.333,26,28,.929,121,49,86,.570,44,65,.677,5,21,.238,26,29,.897,129
279,SAC,2021-12-19,121,,SAS,W 121-114,240,46,91,.505,32,66,.485,14,25,.560,15,18,.833,121,45,91,.495,33,66,.500,12,25,.480,12,13,.923,114
280,CHO,2021-11-19,121,,IND,W 121-118,240,44,81,.543,32,50,.640,12,31,.387,21,28,.750,121,41,88,.466,30,52,.577,11,36,.306,25,32,.781,118
281,TOR,2021-11-13,121,,DET,L 121-127,240,44,87,.506,31,53,.585,13,34,.382,20,31,.645,121,43,79,.544,28,44,.636,15,35,.429,26,30,.867,127
282,PHO,2021-11-06,121,,ATL,W 121-117,240,45,88,.511,31,45,.689,14,43,.326,17,21,.810,121,42,97,.433,29,64,.453,13,33,.394,20,23,.870,117
283,SAS,2021-10-26,121,,LAL,L 121-125 (OT),265,48,108,.444,35,72,.486,13,36,.361,12,22,.545,121,50,105,.476,42,75,.560,8,30,.267,17,22,.773,125
284,LAL,2021-10-24,121,,MEM,W 121-118,240,45,84,.536,29,54,.537,16,30,.533,15,22,.682,121,45,100,.450,32,65,.492,13,35,.371,15,18,.833,118
285,POR,2021-10-20,121,,SAC,L 121-124,240,45,93,.484,33,58,.569,12,35,.343,19,22,.864,121,42,92,.457,25,51,.490,17,41,.415,23,29,.793,124
286,MIN,2022-04-10,120,,CHI,L 120-124,240,46,91,.505,35,60,.583,11,31,.355,17,22,.773,120,44,83,.530,34,62,.548,10,21,.476,26,33,.788,124
287,LAL,2022-04-08,120,,OKC,W 120-101,240,41,82,.500,32,51,.627,9,31,.290,29,39,.744,120,40,88,.455,34,59,.576,6,29,.207,15,19,.789,101
288,ORL,2022-04-05,120,,CLE,W 120-115,240,47,93,.505,31,58,.534,16,35,.457,10,15,.667,120,42,86,.488,26,50,.520,16,36,.444,15,22,.682,115
289,HOU,2022-03-28,120,,SAS,L 120-123,240,38,92,.413,18,43,.419,20,49,.408,24,28,.857,120,47,100,.470,40,71,.563,7,29,.241,22,28,.786,123
290,CLE,2022-03-21,120,,LAL,L 120-131,240,45,86,.523,31,47,.660,14,39,.359,16,19,.842,120,53,94,.564,41,62,.661,12,32,.375,13,16,.813,131
291,ATL,2022-03-18,120,,MEM,W 120-105,240,45,91,.495,32,63,.508,13,28,.464,17,21,.810,120,40,86,.465,32,64,.500,8,22,.364,17,23,.739,105
292,MIA,2022-03-18,120,,OKC,W 120-108,240,46,95,.484,28,44,.636,18,51,.353,10,12,.833,120,40,84,.476,30,50,.600,10,34,.294,18,23,.783,108
293,ORL,2022-03-17,120,,DET,L 120-134,240,47,97,.485,36,67,.537,11,30,.367,15,21,.714,120,47,94,.500,27,51,.529,20,43,.465,20,31,.645,134
294,CLE,2022-03-14,120,,LAC,W 120-111 (OT),265,41,86,.477,26,56,.464,15,30,.500,23,32,.719,120,43,98,.439,31,62,.500,12,36,.333,13,17,.765,111
295,NOP,2022-03-11,120,,CHO,L 120-142,240,43,86,.500,28,47,.596,15,39,.385,19,25,.760,120,52,87,.598,30,40,.750,22,47,.468,16,20,.800,142
296,BOS,2022-03-03,120,,MEM,W 120-107,240,46,89,.517,30,52,.577,16,37,.432,12,15,.800,120,42,99,.424,29,59,.492,13,40,.325,10,13,.769,107
297,PHO,2022-03-02,120,,POR,W 120-90,240,40,80,.500,26,44,.591,14,36,.389,26,31,.839,120,30,78,.385,19,47,.404,11,31,.355,19,25,.760,90
298,MIL,2022-03-02,120,,MIA,W 120-119,240,41,91,.451,27,55,.491,14,36,.389,24,27,.889,120,44,97,.454,23,53,.434,21,44,.477,10,12,.833,119
299,MIL,2022-02-17,120,,PHI,L 120-123,240,42,95,.442,28,51,.549,14,44,.318,22,28,.786,120,44,88,.500,32,54,.593,12,34,.353,23,27,.852,123
300,NOP,2022-02-14,120,,TOR,W 120-90,240,45,77,.584,29,42,.690,16,35,.457,14,16,.875,120,29,95,.305,21,61,.344,8,34,.235,24,31,.774,90
301,CHI,2022-02-14,120,,SAS,W 120-109,240,46,88,.523,36,64,.563,10,24,.417,18,21,.857,120,44,92,.478,38,72,.528,6,20,.300,15,21,.714,109
302,IND,2022-02-13,120,,MIN,L 120-129,240,45,102,.441,32,57,.561,13,45,.289,17,22,.773,120,43,84,.512,25,50,.500,18,34,.529,25,28,.893,129
303,HOU,2022-02-10,120,,TOR,L 120-139,240,43,82,.524,27,44,.614,16,38,.421,18,30,.600,120,53,97,.546,38,58,.655,15,39,.385,18,22,.818,139
304,SAS,2022-02-01,120,,GSW,L 120-124,240,46,83,.554,30,50,.600,16,33,.485,12,17,.706,120,43,96,.448,23,50,.460,20,46,.435,18,18,1.000,124
305,MIA,2022-01-29,120,,TOR,L 120-124 (3OT),315,45,110,.409,29,60,.483,16,50,.320,14,20,.700,120,47,107,.439,31,62,.500,16,45,.356,14,18,.778,124
306,BRK,2022-01-15,120,,NOP,W 120-105,240,46,84,.548,34,57,.596,12,27,.444,16,17,.941,120,40,87,.460,31,56,.554,9,31,.290,16,24,.667,105
307,TOR,2022-01-02,120,,NYK,W 120-105,240,41,86,.477,28,52,.538,13,34,.382,25,30,.833,120,35,78,.449,23,42,.548,12,36,.333,23,28,.821,105
308,UTA,2021-12-31,120,,MIN,W 120-108,240,37,78,.474,26,49,.531,11,29,.379,35,41,.854,120,40,93,.430,26,52,.500,14,41,.341,14,22,.636,108
309,UTA,2021-12-25,120,,DAL,W 120-116,240,40,90,.444,28,54,.519,12,36,.333,28,37,.757,120,38,89,.427,28,59,.475,10,30,.333,30,35,.857,116
310,DAL,2021-12-13,120,,CHO,W 120-96,240,43,83,.518,24,42,.571,19,41,.463,15,17,.882,120,34,86,.395,21,49,.429,13,37,.351,15,24,.625,96
311,PHI,2021-11-27,120,,MIN,L 120-121 (2OT),290,39,93,.419,27,59,.458,12,34,.353,30,39,.769,120,48,96,.500,34,60,.567,14,36,.389,11,16,.688,121
312,MEM,2021-11-18,120,,LAC,W 120-108,240,52,96,.542,41,70,.586,11,26,.423,5,6,.833,120,42,90,.467,26,51,.510,16,39,.410,8,8,1.000,108
313,UTA,2021-11-16,120,,PHI,W 120-85,240,46,89,.517,30,51,.588,16,38,.421,12,19,.632,120,33,90,.367,27,61,.443,6,29,.207,13,17,.765,85
314,ATL,2021-11-14,120,,MIL,W 120-100,240,47,97,.485,32,62,.516,15,35,.429,11,13,.846,120,38,84,.452,24,43,.558,14,41,.341,10,16,.625,100
315,LAL,2021-11-10,120,,MIA,W 120-117 (OT),265,46,92,.500,28,54,.519,18,38,.474,10,16,.625,120,40,96,.417,30,59,.508,10,37,.270,27,35,.771,117
316,GSW,2021-11-07,120,,HOU,W 120-107,240,44,85,.518,29,39,.744,15,46,.326,17,20,.850,120,36,79,.456,26,46,.565,10,33,.303,25,37,.676,107
317,LAC,2021-11-07,120,,CHO,W 120-106,240,41,86,.477,23,38,.605,18,48,.375,20,21,.952,120,41,101,.406,31,68,.456,10,33,.303,14,18,.778,106
318,TOR,2022-04-07,119,,PHI,W 119-114,240,45,91,.495,30,58,.517,15,33,.455,14,18,.778,119,37,75,.493,18,39,.462,19,36,.528,21,25,.840,114
319,LAC,2022-04-03,119,,NOP,W 119-100,240,45,95,.474,24,51,.471,21,44,.477,8,10,.800,119,35,87,.402,26,63,.413,9,24,.375,21,27,.778,100
320,MIL,2022-04-01,119,,LAC,L 119-153,240,50,94,.532,42,69,.609,8,25,.320,11,18,.611,119,56,92,.609,33,49,.673,23,43,.535,18,24,.750,153
321,BRK,2022-03-31,119,,MIL,L 119-120 (OT),265,45,97,.464,27,60,.450,18,37,.486,11,16,.688,119,40,89,.449,28,48,.583,12,41,.293,28,34,.824,120
322,CLE,2022-03-18,119,,DEN,W 119-116 (OT),265,44,98,.449,30,61,.492,14,37,.378,17,26,.654,119,46,92,.500,36,59,.610,10,33,.303,14,18,.778,116
323,ORL,2022-02-28,119,,IND,W 119-103,240,45,96,.469,33,59,.559,12,37,.324,17,22,.773,119,35,72,.486,20,36,.556,15,36,.417,18,25,.720,103
324,ORL,2022-02-25,119,,HOU,W 119-111,240,42,83,.506,29,47,.617,13,36,.361,22,29,.759,119,44,94,.468,30,47,.638,14,47,.298,9,20,.450,111
325,MIN,2022-02-24,119,,MEM,W 119-114,240,43,93,.462,27,51,.529,16,42,.381,17,25,.680,119,38,98,.388,29,67,.433,9,31,.290,29,40,.725,114
326,MEM,2022-02-16,119,,POR,L 119-123,240,37,85,.435,26,55,.473,11,30,.367,34,42,.810,119,43,85,.506,30,53,.566,13,32,.406,24,32,.750,123
327,LAC,2022-02-14,119,,GSW,W 119-104,240,48,85,.565,33,51,.647,15,34,.441,8,15,.533,119,39,86,.453,23,45,.511,16,41,.390,10,13,.769,104
328,DET,2022-02-11,119,,CHO,L 119-141,240,48,102,.471,36,67,.537,12,35,.343,11,18,.611,119,54,97,.557,36,55,.655,18,42,.429,15,23,.652,141
329,ORL,2022-01-28,119,,DET,W 119-103,240,41,83,.494,29,58,.500,12,25,.480,25,26,.962,119,32,87,.368,22,58,.379,10,29,.345,29,37,.784,103
330,MEM,2022-01-28,119,,UTA,W 119-109,240,46,82,.561,37,59,.627,9,23,.391,18,24,.750,119,37,85,.435,20,39,.513,17,46,.370,18,21,.857,109
331,MEM,2022-01-17,119,,CHI,W 119-106,240,47,92,.511,37,67,.552,10,25,.400,15,20,.750,119,40,92,.435,27,61,.443,13,31,.419,13,15,.867,106
332,MIN,2022-01-16,119,,GSW,W 119-99,240,45,91,.495,29,48,.604,16,43,.372,13,20,.650,119,32,82,.390,19,40,.475,13,42,.310,22,29,.759,99
333,LAL,2022-01-09,119,,MEM,L 119-127,240,45,97,.464,31,64,.484,14,33,.424,15,19,.789,119,47,86,.547,36,56,.643,11,30,.367,22,32,.688,127
334,PHI,2022-01-07,119,,SAS,W 119-100,240,45,87,.517,37,64,.578,8,23,.348,21,27,.778,119,38,92,.413,29,62,.468,9,30,.300,15,20,.750,100
335,WAS,2022-01-01,119,,CHI,L 119-120,240,46,87,.529,40,60,.667,6,27,.222,21,26,.808,119,41,84,.488,24,50,.480,17,34,.500,21,25,.840,120
336,MIA,2021-12-28,119,,WAS,W 119-112,240,41,92,.446,25,58,.431,16,34,.471,21,23,.913,119,42,85,.494,25,43,.581,17,42,.405,11,14,.786,112
337,TOR,2021-12-18,119,,GSW,W 119-100,240,45,90,.500,31,52,.596,14,38,.368,15,23,.652,119,37,79,.468,26,43,.605,11,36,.306,15,21,.714,100
338,SAC,2021-12-15,119,,WAS,W 119-105,240,45,82,.549,37,56,.661,8,26,.308,21,29,.724,119,42,89,.472,37,65,.569,5,24,.208,16,21,.762,105
339,POR,2021-11-23,119,,DEN,W 119-100,240,45,88,.511,30,49,.612,15,39,.385,14,20,.700,119,38,78,.487,23,45,.511,15,33,.455,9,11,.818,100
340,GSW,2021-11-21,119,,TOR,W 119-104,240,39,79,.494,17,34,.500,22,45,.489,19,24,.792,119,39,99,.394,24,62,.387,15,37,.405,11,20,.550,104
341,UTA,2021-11-18,119,,TOR,W 119-103,240,44,80,.550,25,34,.735,19,46,.413,12,13,.923,119,39,94,.415,29,56,.518,10,38,.263,15,17,.882,103
342,GSW,2021-11-12,119,,CHI,W 119-93,240,45,93,.484,30,47,.638,15,46,.326,14,16,.875,119,34,78,.436,26,51,.510,8,27,.296,17,22,.773,93
343,PHO,2021-11-10,119,,POR,W 119-109,240,49,94,.521,38,66,.576,11,28,.393,10,12,.833,119,44,91,.484,37,61,.607,7,30,.233,14,16,.875,109
344,LAL,2021-11-02,119,,HOU,W 119-117,240,49,93,.527,43,68,.632,6,25,.240,15,20,.750,119,48,91,.527,32,49,.653,16,42,.381,5,12,.417,117
345,UTA,2021-11-02,119,,SAC,W 119-113,240,43,98,.439,29,50,.580,14,48,.292,19,27,.704,119,42,93,.452,30,62,.484,12,31,.387,17,24,.708,113
346,PHI,2022-04-10,118,,DET,W 118-106,240,46,88,.523,41,63,.651,5,25,.200,21,23,.913,118,38,83,.458,27,49,.551,11,34,.324,19,29,.655,106
347,BRK,2022-04-08,118,,CLE,W 118-107,240,43,92,.467,31,60,.517,12,32,.375,20,21,.952,118,40,82,.488,32,55,.582,8,27,.296,19,24,.792,107
348,ATL,2022-04-06,118,,WAS,W 118-103,240,43,92,.467,27,53,.509,16,39,.410,16,19,.842,118,42,86,.488,32,51,.627,10,35,.286,9,11,.818,103
349,TOR,2022-04-05,118,,ATL,W 118-108,240,44,101,.436,35,66,.530,9,35,.257,21,31,.677,118,43,94,.457,29,57,.509,14,37,.378,8,12,.667,108
350,BRK,2022-04-05,118,,HOU,W 118-105,240,39,86,.453,24,49,.490,15,37,.405,25,27,.926,118,40,99,.404,29,56,.518,11,43,.256,14,25,.560,105
351,LAL,2022-04-03,118,,DEN,L 118-129,240,49,92,.533,43,72,.597,6,20,.300,14,21,.667,118,47,82,.573,35,51,.686,12,31,.387,23,29,.793,129
352,HOU,2022-03-30,118,,SAC,L 118-121,240,43,94,.457,30,52,.577,13,42,.310,19,25,.760,118,44,95,.463,37,69,.536,7,26,.269,26,36,.722,121
353,IND,2022-03-30,118,,DEN,L 118-125,240,44,97,.454,32,57,.561,12,40,.300,18,23,.783,118,50,80,.625,38,52,.731,12,28,.429,13,14,.929,125
354,OKC,2022-03-30,118,,ATL,L 118-136,240,41,87,.471,24,46,.522,17,41,.415,19,27,.704,118,49,91,.538,31,52,.596,18,39,.462,20,22,.909,136
355,OKC,2022-03-23,118,,ORL,W 118-102,240,38,79,.481,21,38,.553,17,41,.415,25,30,.833,118,36,93,.387,19,42,.452,17,51,.333,13,16,.813,102
356,HOU,2022-03-18,118,,IND,L 118-121,240,39,79,.494,27,52,.519,12,27,.444,28,32,.875,118,47,101,.465,33,58,.569,14,43,.326,13,19,.684,121
357,OKC,2022-03-13,118,,MEM,L 118-125,240,41,97,.423,28,56,.500,13,41,.317,23,28,.821,118,48,102,.471,37,73,.507,11,29,.379,18,20,.900,125
358,ORL,2022-03-11,118,,MIN,W 118-110,240,40,86,.465,24,46,.522,16,40,.400,22,25,.880,118,41,90,.456,26,45,.578,15,45,.333,13,13,1.000,110
359,MEM,2022-03-11,118,,NYK,W 118-114,240,46,104,.442,37,78,.474,9,26,.346,17,29,.586,118,38,90,.422,28,65,.431,10,25,.400,28,37,.757,114
360,MEM,2022-02-28,118,,SAS,W 118-105,240,48,89,.539,37,63,.587,11,26,.423,11,19,.579,118,41,99,.414,32,67,.478,9,32,.281,14,19,.737,105
361,NOP,2022-02-17,118,,DAL,L 118-125,240,46,92,.500,34,64,.531,12,28,.429,14,21,.667,118,44,82,.537,25,42,.595,19,40,.475,18,25,.720,125
362,CHO,2022-02-12,118,,MEM,L 118-125,240,39,97,.402,25,52,.481,14,45,.311,26,33,.788,118,47,96,.490,36,63,.571,11,33,.333,20,33,.606,125
363,MIN,2022-02-06,118,,DET,W 118-105,240,42,91,.462,25,55,.455,17,36,.472,17,21,.810,118,40,95,.421,28,63,.444,12,32,.375,13,19,.684,105
364,IND,2022-02-02,118,,ORL,L 118-119,240,44,98,.449,30,66,.455,14,32,.438,16,23,.696,118,42,95,.442,31,60,.517,11,35,.314,24,26,.923,119
365,BRK,2022-01-26,118,,DEN,L 118-124,240,43,88,.489,31,59,.525,12,29,.414,20,26,.769,118,42,89,.472,27,53,.509,15,36,.417,25,27,.926,124
366,DEN,2022-01-21,118,,MEM,L 118-122,240,43,91,.473,30,59,.508,13,32,.406,19,23,.826,118,43,82,.524,32,57,.561,11,25,.440,25,40,.625,122
367,WAS,2022-01-19,118,,BRK,L 118-119,240,41,86,.477,31,57,.544,10,29,.345,26,32,.813,118,47,89,.528,39,64,.609,8,25,.320,17,20,.850,119
368,SAS,2022-01-19,118,,OKC,W 118-96,240,47,96,.490,32,56,.571,15,40,.375,9,14,.643,118,38,98,.388,30,67,.448,8,31,.258,12,15,.800,96
369,MIL,2022-01-13,118,,GSW,W 118-99,240,44,86,.512,26,45,.578,18,41,.439,12,18,.667,118,33,95,.347,17,47,.362,16,48,.333,17,24,.708,99
370,MEM,2022-01-06,118,,DET,W 118-88,240,48,98,.490,38,66,.576,10,32,.313,12,19,.632,118,34,99,.343,24,55,.436,10,44,.227,10,13,.769,88
371,MEM,2021-12-31,118,,SAS,W 118-105,240,49,102,.480,39,76,.513,10,26,.385,10,16,.625,118,39,90,.433,27,55,.491,12,35,.343,15,24,.625,105
372,CLE,2021-12-31,118,,ATL,L 118-121,240,48,84,.571,40,59,.678,8,25,.320,14,24,.583,118,43,97,.443,27,59,.458,16,38,.421,19,21,.905,121
373,ORL,2021-12-30,118,,MIL,L 118-136,240,42,87,.483,29,51,.569,13,36,.361,21,27,.778,118,45,91,.495,32,58,.552,13,33,.394,33,36,.917,136
374,ATL,2021-12-27,118,,CHI,L 118-130,240,40,89,.449,25,55,.455,15,34,.441,23,26,.885,118,51,94,.543,33,57,.579,18,37,.486,10,14,.714,130
375,IND,2021-12-23,118,,HOU,W 118-106,240,46,88,.523,33,50,.660,13,38,.342,13,19,.684,118,35,80,.438,20,43,.465,15,37,.405,21,26,.808,106
376,PHO,2021-12-16,118,,WAS,W 118-98,240,42,79,.532,33,50,.660,9,29,.310,25,26,.962,118,40,82,.488,34,61,.557,6,21,.286,12,19,.632,98
377,MIA,2021-12-11,118,,CHI,W 118-92,240,46,93,.495,27,50,.540,19,43,.442,7,9,.778,118,31,83,.373,14,43,.326,17,40,.425,13,20,.650,92
378,HOU,2021-12-05,118,,NOP,W 118-108,240,39,79,.494,22,39,.564,17,40,.425,23,29,.793,118,40,94,.426,30,56,.536,10,38,.263,18,25,.720,108
379,HOU,2021-12-03,118,,ORL,W 118-116,240,44,92,.478,27,45,.600,17,47,.362,13,15,.867,118,42,86,.488,29,49,.592,13,37,.351,19,21,.905,116
380,GSW,2021-12-03,118,,PHO,W 118-96,240,45,92,.489,26,53,.491,19,39,.487,9,12,.750,118,31,81,.383,23,59,.390,8,22,.364,26,35,.743,96
381,GSW,2021-11-26,118,,POR,W 118-103,240,47,87,.540,35,50,.700,12,37,.324,12,16,.750,118,36,86,.419,23,48,.479,13,38,.342,18,23,.783,103
382,HOU,2021-11-24,118,,CHI,W 118-113,240,42,84,.500,25,48,.521,17,36,.472,17,22,.773,118,44,96,.458,29,61,.475,15,35,.429,10,12,.833,113
383,UTA,2021-11-22,118,,MEM,L 118-119,240,41,87,.471,24,44,.545,17,43,.395,19,25,.760,118,42,95,.442,29,60,.483,13,35,.371,22,27,.815,119
384,POR,2021-11-20,118,,PHI,W 118-111,240,40,80,.500,25,46,.543,15,34,.441,23,23,1.000,118,41,81,.506,31,53,.585,10,28,.357,19,21,.905,111
385,POR,2021-11-15,118,,TOR,W 118-113,240,46,82,.561,30,46,.652,16,36,.444,10,14,.714,118,41,89,.461,26,56,.464,15,33,.455,16,18,.889,113
386,IND,2021-11-13,118,,PHI,W 118-113,240,47,82,.573,33,54,.611,14,28,.500,10,15,.667,118,38,89,.427,26,66,.394,12,23,.522,25,29,.862,113
387,CHI,2021-11-08,118,,BRK,W 118-95,240,46,98,.469,37,67,.552,9,31,.290,17,20,.850,118,34,86,.395,23,53,.434,11,33,.333,16,19,.842,95
388,MIA,2021-11-06,118,,UTA,W 118-115,240,47,78,.603,36,57,.632,11,21,.524,13,17,.765,118,43,83,.518,28,38,.737,15,45,.333,14,19,.737,115
389,ATL,2021-11-01,118,,WAS,W 118-111,240,38,83,.458,25,49,.510,13,34,.382,29,29,1.000,118,41,86,.477,28,47,.596,13,39,.333,16,16,1.000,111
390,TOR,2021-10-27,118,,IND,W 118-100,240,46,100,.460,32,70,.457,14,30,.467,12,19,.632,118,38,79,.481,28,50,.560,10,29,.345,14,17,.824,100
391,LAC,2022-04-09,117,,SAC,W 117-98,240,42,86,.488,21,43,.488,21,43,.488,12,15,.800,117,38,86,.442,31,58,.534,7,28,.250,15,24,.625,98
392,TOR,2022-04-08,117,,HOU,W 117-115,240,44,96,.458,37,67,.552,7,29,.241,22,23,.957,117,43,81,.531,33,52,.635,10,29,.345,19,24,.792,115
393,CHI,2022-04-08,117,,CHO,L 117-133,240,44,82,.537,31,58,.534,13,24,.542,16,20,.800,117,52,86,.605,33,46,.717,19,40,.475,10,10,1.000,133
394,IND,2022-04-03,117,,DET,L 117-121,240,45,94,.479,33,56,.589,12,38,.316,15,19,.789,117,43,99,.434,22,58,.379,21,41,.512,14,18,.778,121
395,OKC,2022-04-03,117,,PHO,W 117-96,240,43,87,.494,26,46,.565,17,41,.415,14,18,.778,117,37,89,.416,30,51,.588,7,38,.184,15,17,.882,96
396,HOU,2022-04-01,117,,SAC,L 117-122,240,41,97,.423,24,52,.462,17,45,.378,18,26,.692,117,42,81,.519,30,53,.566,12,28,.429,26,34,.765,122
397,TOR,2022-03-24,117,,CLE,W 117-104,240,42,89,.472,26,52,.500,16,37,.432,17,19,.895,117,37,79,.468,25,49,.510,12,30,.400,18,22,.818,104
398,MIA,2022-03-11,117,,CLE,W 117-105,240,41,86,.477,30,51,.588,11,35,.314,24,27,.889,117,35,79,.443,27,54,.500,8,25,.320,27,29,.931,105
399,SAS,2022-03-07,117,,LAL,W 117-110,240,46,84,.548,37,58,.638,9,26,.346,16,30,.533,117,43,91,.473,35,65,.538,8,26,.308,16,23,.696,110
400,GSW,2022-02-12,117,,LAL,W 117-115,240,40,90,.444,28,52,.538,12,38,.316,25,34,.735,117,41,88,.466,30,61,.492,11,27,.407,22,33,.667,115
401,DET,2022-02-03,117,,MIN,L 117-128,240,40,91,.440,25,45,.556,15,46,.326,22,28,.786,117,44,87,.506,29,53,.547,15,34,.441,25,28,.893,128
402,CHO,2022-01-28,117,,LAL,W 117-114,240,43,83,.518,32,47,.681,11,36,.306,20,28,.714,117,38,91,.418,23,51,.451,15,40,.375,23,32,.719,114
403,PHI,2022-01-25,117,,NOP,W 117-107,240,39,84,.464,29,53,.547,10,31,.323,29,31,.935,117,40,83,.482,31,61,.508,9,22,.409,18,26,.692,107
404,NOP,2022-01-24,117,,IND,W 117-113,240,41,88,.466,35,58,.603,6,30,.200,29,31,.935,117,38,87,.437,19,41,.463,19,46,.413,18,25,.720,113
405,DEN,2022-01-23,117,,DET,W 117-111,240,44,85,.518,32,50,.640,12,35,.343,17,23,.739,117,42,75,.560,31,46,.674,11,29,.379,16,19,.842,111
406,GSW,2022-01-20,117,,IND,L 117-121 (OT),265,42,94,.447,33,52,.635,9,42,.214,24,29,.828,117,41,95,.432,26,60,.433,15,35,.429,24,34,.706,121
407,CHI,2022-01-19,117,,CLE,W 117-104,240,47,86,.547,37,64,.578,10,22,.455,13,18,.722,117,40,77,.519,31,50,.620,9,27,.333,15,22,.682,104
408,WAS,2022-01-17,117,,PHI,W 117-98,240,42,87,.483,33,57,.579,9,30,.300,24,32,.750,117,35,86,.407,28,60,.467,7,26,.269,21,25,.840,98
409,DET,2022-01-01,117,,SAS,W 117-116 (OT),265,41,101,.406,32,66,.485,9,35,.257,26,33,.788,117,42,102,.412,30,62,.484,12,40,.300,20,28,.714,116
410,SAC,2021-12-28,117,,OKC,W 117-111,240,40,95,.421,23,56,.411,17,39,.436,20,27,.741,117,35,90,.389,24,57,.421,11,33,.333,30,36,.833,111
411,POR,2021-12-27,117,,DAL,L 117-132,240,35,82,.427,23,42,.548,12,40,.300,35,42,.833,117,48,84,.571,36,51,.706,12,33,.364,24,33,.727,132
412,OKC,2021-12-26,117,,NOP,W 117-112,240,41,86,.477,28,50,.560,13,36,.361,22,31,.710,117,39,94,.415,29,53,.547,10,41,.244,24,28,.857,112
413,MIL,2021-12-25,117,,BOS,W 117-113,240,43,91,.473,31,58,.534,12,33,.364,19,27,.704,117,38,89,.427,21,44,.477,17,45,.378,20,24,.833,113
414,NYK,2021-12-23,117,,WAS,L 117-124,240,42,93,.452,29,51,.569,13,42,.310,20,23,.870,117,42,75,.560,26,38,.684,16,37,.432,24,32,.750,124
415,BOS,2021-12-13,117,,MIL,W 117-103,240,43,86,.500,23,39,.590,20,47,.426,11,13,.846,117,40,90,.444,29,54,.537,11,36,.306,12,15,.800,103
416,CLE,2021-12-11,117,,SAC,W 117-103,240,41,88,.466,29,57,.509,12,31,.387,23,28,.821,117,41,93,.441,34,65,.523,7,28,.250,14,22,.636,103
417,LAL,2021-12-07,117,,BOS,W 117-102,240,48,93,.516,40,66,.606,8,27,.296,13,17,.765,117,36,82,.439,26,49,.531,10,33,.303,20,29,.690,102
418,POR,2021-12-04,117,,BOS,L 117-145,240,42,89,.472,34,60,.567,8,29,.276,25,32,.781,117,49,87,.563,28,50,.560,21,37,.568,26,29,.897,145
419,MIL,2021-11-20,117,,ORL,W 117-108,240,37,82,.451,18,42,.429,19,40,.475,24,37,.649,117,39,98,.398,20,47,.426,19,51,.373,11,14,.786,108
420,CHI,2021-11-10,117,,DAL,W 117-107,240,45,89,.506,30,58,.517,15,31,.484,12,14,.857,117,38,83,.458,26,50,.520,12,33,.364,19,24,.792,107
421,LAC,2021-11-09,117,,POR,W 117-109,240,44,85,.518,28,55,.509,16,30,.533,13,19,.684,117,43,91,.473,29,54,.537,14,37,.378,9,12,.750,109
422,BRK,2021-11-03,117,,ATL,W 117-108,240,43,88,.489,21,40,.525,22,48,.458,9,12,.750,117,41,94,.436,28,59,.475,13,35,.371,13,15,.867,108
423,BRK,2021-10-31,117,,DET,W 117-91,240,47,72,.653,34,47,.723,13,25,.520,10,16,.625,117,32,79,.405,20,46,.435,12,33,.364,15,22,.682,91
424,NOP,2021-10-30,117,,NYK,L 117-123,240,42,92,.457,31,59,.525,11,33,.333,22,24,.917,117,42,81,.519,23,48,.479,19,33,.576,20,25,.800,123
425,PHI,2022-03-29,116,,MIL,L 116-118,240,43,89,.483,27,48,.563,16,41,.390,14,18,.778,116,44,88,.500,30,50,.600,14,38,.368,16,23,.696,118
426,NOP,2022-03-27,116,,LAL,W 116-108,240,44,91,.484,35,64,.547,9,27,.333,19,24,.792,116,42,80,.525,28,45,.622,14,35,.400,10,16,.625,108
427,MIN,2022-03-25,116,,DAL,W 116-95,240,43,84,.512,32,52,.615,11,32,.344,19,24,.792,116,35,90,.389,25,47,.532,10,43,.233,15,19,.789,95
428,MIN,2022-03-23,116,,PHO,L 116-125,240,42,95,.442,29,52,.558,13,43,.302,19,22,.864,116,45,86,.523,33,53,.623,12,33,.364,23,29,.793,125
429,CHO,2022-03-16,116,,ATL,W 116-106,240,43,87,.494,32,52,.615,11,35,.314,19,23,.826,116,40,93,.430,27,56,.482,13,37,.351,13,14,.929,106
430,OKC,2022-03-14,116,,CHO,L 116-134,240,42,90,.467,26,46,.565,16,44,.364,16,19,.842,116,49,91,.538,29,56,.518,20,35,.571,16,21,.762,134
431,DEN,2022-03-04,116,,HOU,W 116-101,240,39,86,.453,26,53,.491,13,33,.394,25,31,.806,116,38,83,.458,28,47,.596,10,36,.278,15,22,.682,101
432,WAS,2022-03-01,116,,DET,W 116-113,240,41,82,.500,28,56,.500,13,26,.500,21,26,.808,116,43,90,.478,35,63,.556,8,27,.296,19,23,.826,113
433,GSW,2022-02-16,116,,DEN,L 116-117,240,45,87,.517,35,53,.660,10,34,.294,16,24,.667,116,43,91,.473,29,55,.527,14,36,.389,17,21,.810,117
434,DAL,2022-02-08,116,,DET,W 116-86,240,40,79,.506,22,43,.512,18,36,.500,18,23,.783,116,33,87,.379,28,57,.491,5,30,.167,15,22,.682,86
435,LAL,2022-02-08,116,,MIL,L 116-131,240,44,85,.518,34,53,.642,10,32,.313,18,30,.600,116,52,96,.542,37,60,.617,15,36,.417,12,20,.600,131
436,NYK,2022-01-31,116,,SAC,W 116-96,240,40,80,.500,27,45,.600,13,35,.371,23,29,.793,116,37,86,.430,26,48,.542,11,38,.289,11,22,.500,96
437,MEM,2022-01-13,116,,MIN,W 116-108,240,42,92,.457,34,60,.567,8,32,.250,24,35,.686,116,41,96,.427,26,48,.542,15,48,.313,11,14,.786,108
438,MEM,2022-01-11,116,,GSW,W 116-108,240,44,100,.440,30,66,.455,14,34,.412,14,18,.778,116,35,82,.427,22,46,.478,13,36,.361,25,29,.862,108
439,BOS,2022-01-02,116,,ORL,W 116-111 (OT),265,39,86,.453,26,50,.520,13,36,.361,25,28,.893,116,40,95,.421,31,68,.456,9,27,.333,22,27,.815,111
440,UTA,2022-01-01,116,,GSW,L 116-123,240,40,92,.435,26,48,.542,14,44,.318,22,28,.786,116,46,86,.535,29,54,.537,17,32,.531,14,21,.667,123
441,BRK,2022-01-01,116,,LAC,L 116-120,240,42,97,.433,31,64,.484,11,33,.333,21,25,.840,116,42,86,.488,28,50,.560,14,36,.389,22,31,.710,120
442,TOR,2021-12-31,116,,LAC,W 116-108,240,40,96,.417,29,61,.475,11,35,.314,25,33,.758,116,38,78,.487,23,44,.523,15,34,.441,17,19,.895,108
443,NOP,2021-12-17,116,,MIL,W 116-112 (OT),265,42,89,.472,29,52,.558,13,37,.351,19,30,.633,116,45,104,.433,31,57,.544,14,47,.298,8,10,.800,112
444,DET,2021-12-08,116,,WAS,L 116-119 (OT),265,37,79,.468,24,55,.436,13,24,.542,29,35,.829,116,42,88,.477,30,56,.536,12,32,.375,23,28,.821,119
445,IND,2021-12-06,116,,WAS,W 116-110,240,43,82,.524,34,59,.576,9,23,.391,21,22,.955,116,43,81,.531,36,66,.545,7,15,.467,17,21,.810,110
446,SAS,2021-11-29,116,,WAS,W 116-99,240,49,92,.533,41,74,.554,8,18,.444,10,16,.625,116,41,92,.446,32,61,.525,9,31,.290,8,13,.615,99
447,GSW,2021-11-24,116,,PHI,W 116-96,240,42,80,.525,27,42,.643,15,38,.395,17,24,.708,116,34,80,.425,26,52,.500,8,28,.286,20,22,.909,96
448,IND,2021-11-24,116,,LAL,L 116-124 (OT),265,42,104,.404,29,58,.500,13,46,.283,19,24,.792,116,42,95,.442,27,58,.466,15,37,.405,25,29,.862,124
449,DET,2021-11-21,116,,LAL,L 116-121,240,43,97,.443,29,57,.509,14,40,.350,16,21,.762,116,45,92,.489,35,61,.574,10,31,.323,21,27,.778,121
450,POR,2021-10-27,116,,MEM,W 116-96,240,39,84,.464,24,48,.500,15,36,.417,23,31,.742,116,35,96,.365,18,46,.391,17,50,.340,9,19,.474,96
451,DAL,2021-10-26,116,,HOU,W 116-106,240,43,93,.462,31,50,.620,12,43,.279,18,25,.720,116,36,86,.419,20,47,.426,16,39,.410,18,26,.692,106
452,LAC,2021-10-25,116,,POR,W 116-86,240,44,93,.473,30,50,.600,14,43,.326,14,19,.737,116,32,85,.376,24,48,.500,8,37,.216,14,18,.778,86
453,TOR,2022-03-28,115,,BOS,W 115-112 (OT),265,46,106,.434,36,67,.537,10,39,.256,13,18,.722,115,39,95,.411,27,55,.491,12,40,.300,22,28,.786,112
454,HOU,2022-03-21,115,,WAS,W 115-97,240,42,85,.494,22,46,.478,20,39,.513,11,13,.846,115,35,85,.412,29,56,.518,6,29,.207,21,24,.875,97
455,DET,2022-03-21,115,,POR,L 115-119,240,36,85,.424,27,50,.540,9,35,.257,34,41,.829,115,37,88,.420,29,60,.483,8,28,.286,37,49,.755,119
456,NOP,2022-03-15,115,,PHO,L 115-131,240,43,86,.500,31,52,.596,12,34,.353,17,24,.708,115,49,90,.544,31,56,.554,18,34,.529,15,15,1.000,131
457,DEN,2022-03-12,115,,TOR,L 115-127,240,43,78,.551,32,51,.627,11,27,.407,18,24,.750,115,48,102,.471,36,71,.507,12,31,.387,19,25,.760,127
458,LAC,2022-03-09,115,,WAS,W 115-109,240,43,86,.500,27,54,.500,16,32,.500,13,13,1.000,115,41,87,.471,31,60,.517,10,27,.370,17,20,.850,109
459,OKC,2022-03-08,115,,MIL,L 115-142,240,42,84,.500,26,45,.578,16,39,.410,15,21,.714,115,53,100,.530,33,60,.550,20,40,.500,16,20,.800,142
460,SAC,2022-03-07,115,,NYK,L 115-131,240,39,80,.488,28,48,.583,11,32,.344,26,36,.722,115,47,92,.511,29,50,.580,18,42,.429,19,23,.826,131
461,PHO,2022-03-04,115,,NYK,W 115-114,240,38,85,.447,21,51,.412,17,34,.500,22,27,.815,115,40,86,.465,27,57,.474,13,29,.448,21,30,.700,114
462,DEN,2022-02-26,115,,SAC,W 115-110,240,38,82,.463,22,39,.564,16,43,.372,23,29,.793,115,38,89,.427,29,59,.492,9,30,.300,25,33,.758,110
463,MIA,2022-02-12,115,,BRK,W 115-111,240,41,82,.500,31,53,.585,10,29,.345,23,29,.793,115,42,93,.452,30,53,.566,12,40,.300,15,22,.682,111
464,ORL,2022-02-05,115,,MEM,L 115-135,240,39,90,.433,22,42,.524,17,48,.354,20,29,.690,115,53,105,.505,40,66,.606,13,39,.333,16,22,.727,135
465,IND,2022-02-04,115,,CHI,L 115-122,240,47,95,.495,35,68,.515,12,27,.444,9,9,1.000,115,49,90,.544,43,64,.672,6,26,.231,18,23,.783,122
466,HOU,2022-02-02,115,,CLE,W 115-104,240,39,82,.476,25,42,.595,14,40,.350,23,33,.697,115,41,80,.513,34,59,.576,7,21,.333,15,27,.556,104
467,PHO,2022-01-30,115,,SAS,W 115-110,240,48,97,.495,37,65,.569,11,32,.344,8,12,.667,115,45,100,.450,32,63,.508,13,37,.351,7,8,.875,110
468,DET,2022-01-30,115,,CLE,W 115-105,240,42,91,.462,32,65,.492,10,26,.385,21,25,.840,115,38,82,.463,25,48,.521,13,34,.382,16,25,.640,105
469,MEM,2022-01-29,115,,WAS,W 115-95,240,46,100,.460,33,69,.478,13,31,.419,10,12,.833,115,35,84,.417,25,55,.455,10,29,.345,15,21,.714,95
470,CLE,2022-01-26,115,,MIL,W 115-99,240,41,87,.471,22,45,.489,19,42,.452,14,17,.824,115,37,80,.463,28,48,.583,9,32,.281,16,18,.889,99
471,WAS,2022-01-25,115,,LAC,L 115-116,240,37,80,.463,28,53,.528,9,27,.333,32,40,.800,115,39,94,.415,28,65,.431,11,29,.379,27,31,.871,116
472,PHO,2022-01-24,115,,UTA,W 115-109,240,47,99,.475,34,63,.540,13,36,.361,8,15,.533,115,40,81,.494,26,50,.520,14,31,.452,15,22,.682,109
473,GSW,2022-01-03,115,,MIA,W 115-108,240,45,92,.489,31,54,.574,14,38,.368,11,13,.846,115,37,90,.411,20,48,.417,17,42,.405,17,19,.895,108
474,SAC,2022-01-02,115,,MIA,W 115-113,240,40,78,.513,27,44,.614,13,34,.382,22,27,.815,115,46,105,.438,37,72,.514,9,33,.273,12,12,1.000,113
475,PHO,2021-12-29,115,,OKC,W 115-97,240,41,89,.461,29,55,.527,12,34,.353,21,28,.750,115,38,96,.396,31,61,.508,7,35,.200,14,16,.875,97
476,LAL,2021-12-25,115,,BRK,L 115-122,240,40,96,.417,30,61,.492,10,35,.286,25,28,.893,115,43,89,.483,29,57,.509,14,32,.438,22,27,.815,122
477,MIA,2021-12-23,115,,DET,W 115-112,240,43,88,.489,31,56,.554,12,32,.375,17,19,.895,115,36,80,.450,18,40,.450,18,40,.450,22,25,.880,112
478,CHI,2021-12-19,115,,LAL,W 115-110,240,40,93,.430,30,63,.476,10,30,.333,25,31,.806,115,42,82,.512,30,48,.625,12,34,.353,14,22,.636,110
479,ATL,2021-12-17,115,,DEN,L 115-133,240,41,88,.466,34,64,.531,7,24,.292,26,34,.765,115,50,86,.581,33,48,.688,17,38,.447,16,18,.889,133
480,SAS,2021-12-15,115,,CHO,L 115-131,240,39,90,.433,27,53,.509,12,37,.324,25,25,1.000,115,51,86,.593,33,52,.635,18,34,.529,11,16,.688,131
481,CLE,2021-12-08,115,,CHI,W 115-92,240,44,80,.550,31,52,.596,13,28,.464,14,16,.875,115,35,84,.417,28,58,.483,7,26,.269,15,21,.714,92
482,LAL,2021-12-03,115,,LAC,L 115-119,240,45,90,.500,33,57,.579,12,33,.364,13,21,.619,115,41,81,.506,25,46,.543,16,35,.457,21,24,.875,119
483,NYK,2021-12-02,115,,CHI,L 115-119,240,42,82,.512,33,56,.589,9,26,.346,22,27,.815,115,44,89,.494,33,60,.550,11,29,.379,20,21,.952,119
484,LAC,2021-12-01,115,,SAC,L 115-124,240,47,100,.470,38,69,.551,9,31,.290,12,16,.750,115,46,88,.523,31,50,.620,15,38,.395,17,20,.850,124
485,WAS,2021-12-01,115,,MIN,W 115-107,240,45,91,.495,35,59,.593,10,32,.313,15,21,.714,115,37,88,.420,26,51,.510,11,37,.297,22,26,.846,107
486,CLE,2021-11-24,115,,PHO,L 115-120,240,43,97,.443,31,58,.534,12,39,.308,17,25,.680,115,45,86,.523,37,64,.578,8,22,.364,22,28,.786,120
487,ATL,2021-11-20,115,,CHO,W 115-105,240,43,82,.524,31,48,.646,12,34,.353,17,21,.810,115,43,102,.422,33,62,.532,10,40,.250,9,15,.600,105
488,BRK,2021-11-19,115,,ORL,W 115-113,240,41,91,.451,31,58,.534,10,33,.303,23,25,.920,115,40,89,.449,26,51,.510,14,38,.368,19,25,.760,113
489,MIN,2021-11-18,115,,SAS,W 115-90,240,41,86,.477,20,37,.541,21,49,.429,12,15,.800,115,35,84,.417,29,52,.558,6,32,.188,14,19,.737,90
490,WAS,2021-11-05,115,,MEM,W 115-87,240,49,84,.583,39,59,.661,10,25,.400,7,13,.538,115,34,96,.354,28,65,.431,6,31,.194,13,17,.765,87
491,MIN,2021-11-03,115,,LAC,L 115-126,240,43,94,.457,29,54,.537,14,40,.350,15,16,.938,115,47,78,.603,26,42,.619,21,36,.583,11,12,.917,126
492,WAS,2021-10-30,115,,BOS,W 115-112 (2OT),290,38,104,.365,28,68,.412,10,36,.278,29,36,.806,115,44,107,.411,42,81,.519,2,26,.077,22,25,.880,112
493,GSW,2021-10-21,115,,LAC,W 115-113,240,43,83,.518,28,52,.538,15,31,.484,14,22,.636,115,42,96,.438,28,56,.500,14,40,.350,15,21,.714,113
494,HOU,2022-04-10,114,,ATL,L 114-130,240,41,89,.461,24,43,.558,17,46,.370,15,20,.750,114,45,87,.517,24,49,.490,21,38,.553,19,24,.792,130
495,MIN,2022-04-05,114,,WAS,L 114-132,240,41,91,.451,27,50,.540,14,41,.341,18,25,.720,114,56,101,.554,43,71,.606,13,30,.433,7,14,.500,132
496,NYK,2022-03-30,114,,CHO,L 114-125,240,40,85,.471,24,41,.585,16,44,.364,18,26,.692,114,49,90,.544,37,55,.673,12,35,.343,15,17,.882,125
497,DAL,2022-03-27,114,,UTA,W 114-100,240,40,77,.519,23,43,.535,17,34,.500,17,24,.708,114,41,89,.461,29,55,.527,12,34,.353,6,10,.600,100
498,PHO,2022-03-27,114,,PHI,W 114-104,240,45,87,.517,32,60,.533,13,27,.481,11,17,.647,114,37,89,.416,27,53,.509,10,36,.278,20,26,.769,104
499,MIL,2022-03-24,114,,WAS,W 114-102,240,42,81,.519,26,46,.565,16,35,.457,14,16,.875,114,43,92,.467,32,54,.593,11,38,.289,5,9,.556,102
500,BRK,2022-03-21,114,,UTA,W 114-106,240,45,83,.542,34,53,.642,11,30,.367,13,15,.867,114,37,83,.446,23,44,.523,14,39,.359,18,22,.818,106
501,CLE,2022-03-16,114,,PHI,L 114-118,240,39,80,.488,30,52,.577,9,28,.321,27,32,.844,114,41,79,.519,29,47,.617,12,32,.375,24,28,.857,118
502,ORL,2022-03-13,114,,PHI,L 114-116 (OT),265,41,91,.451,23,48,.479,18,43,.419,14,20,.700,114,35,92,.380,21,55,.382,14,37,.378,32,37,.865,116
503,BOS,2022-03-11,114,,DET,W 114-103,240,42,90,.467,36,58,.621,6,32,.188,24,30,.800,114,35,83,.422,25,49,.510,10,34,.294,23,24,.958,103
504,DAL,2022-03-05,114,,SAC,W 114-113,240,40,84,.476,26,48,.542,14,36,.389,20,27,.741,114,46,94,.489,37,69,.536,9,25,.360,12,18,.667,113
505,WAS,2022-03-04,114,,ATL,L 114-117,240,46,85,.541,32,56,.571,14,29,.483,8,9,.889,114,38,91,.418,25,55,.455,13,36,.361,28,34,.824,117
506,ORL,2022-03-02,114,,IND,L 114-122 (OT),265,44,97,.454,34,65,.523,10,32,.313,16,20,.800,114,41,94,.436,29,57,.509,12,37,.324,28,35,.800,122
507,PHO,2022-02-27,114,,UTA,L 114-118,240,44,86,.512,31,58,.534,13,28,.464,13,16,.813,114,44,94,.468,27,54,.500,17,40,.425,13,20,.650,118
508,UTA,2022-02-25,114,,DAL,W 114-109,240,40,74,.541,24,36,.667,16,38,.421,18,22,.818,114,42,88,.477,25,49,.510,17,39,.436,8,8,1.000,109
509,NOP,2022-02-12,114,,SAS,L 114-124,240,43,87,.494,32,55,.582,11,32,.344,17,20,.850,114,47,93,.505,33,56,.589,14,37,.378,16,19,.842,124
510,UTA,2022-02-11,114,,ORL,W 114-99,240,40,89,.449,27,48,.563,13,41,.317,21,24,.875,114,37,84,.440,24,49,.490,13,35,.371,12,16,.750,99
511,GSW,2022-02-10,114,,NYK,L 114-116,240,42,91,.462,27,46,.587,15,45,.333,15,17,.882,114,39,90,.433,25,54,.463,14,36,.389,24,33,.727,116
512,SAC,2022-02-08,114,,MIN,L 114-134,240,41,83,.494,32,58,.552,9,25,.360,23,26,.885,114,50,104,.481,28,60,.467,22,44,.500,12,17,.706,134
513,DAL,2022-02-02,114,,OKC,L 114-120 (OT),265,46,98,.469,32,55,.582,14,43,.326,8,10,.800,114,41,86,.477,24,49,.490,17,37,.459,21,25,.840,120
514,ORL,2022-01-23,114,,CHI,W 114-95,240,42,80,.525,30,54,.556,12,26,.462,18,23,.783,114,33,76,.434,28,55,.509,5,21,.238,24,32,.750,95
515,CLE,2022-01-17,114,,BRK,W 114-107,240,42,81,.519,31,49,.633,11,32,.344,19,21,.905,114,41,83,.494,29,53,.547,12,30,.400,13,18,.722,107
516,BOS,2022-01-15,114,,CHI,W 114-112,240,44,90,.489,35,64,.547,9,26,.346,17,19,.895,114,44,87,.506,32,58,.552,12,29,.414,12,15,.800,112
517,POR,2022-01-10,114,,BRK,W 114-108,240,40,86,.465,25,48,.521,15,38,.395,19,26,.731,114,42,91,.462,30,59,.508,12,32,.375,12,15,.800,108
518,CHO,2022-01-08,114,,MIL,W 114-106,240,44,99,.444,28,51,.549,16,48,.333,10,17,.588,114,35,90,.389,23,53,.434,12,37,.324,24,26,.923,106
519,DAL,2021-12-21,114,,MIN,W 114-102,240,42,86,.488,31,52,.596,11,34,.324,19,23,.826,114,36,79,.456,23,39,.590,13,40,.325,17,20,.850,102
520,BOS,2021-12-18,114,,NYK,W 114-107,240,42,89,.472,25,44,.568,17,45,.378,13,17,.765,114,35,80,.438,22,44,.500,13,36,.361,24,30,.800,107
521,BRK,2021-12-16,114,,PHI,W 114-105,240,44,89,.494,33,66,.500,11,23,.478,15,16,.938,114,39,89,.438,29,55,.527,10,34,.294,17,20,.850,105
522,MIL,2021-12-15,114,,IND,W 114-99,240,44,90,.489,30,61,.492,14,29,.483,12,15,.800,114,39,83,.470,28,45,.622,11,38,.289,10,11,.909,99
523,HOU,2021-12-10,114,,MIL,L 114-123,240,42,89,.472,23,43,.535,19,46,.413,11,20,.550,114,42,83,.506,27,44,.614,15,39,.385,24,32,.750,123
524,HOU,2021-12-08,114,,BRK,W 114-104,240,40,81,.494,26,40,.650,14,41,.341,20,29,.690,114,35,89,.393,27,56,.482,8,33,.242,26,31,.839,104
525,LAC,2021-12-08,114,,BOS,W 114-111,240,40,85,.471,26,53,.491,14,32,.438,20,22,.909,114,41,86,.477,31,54,.574,10,32,.313,19,21,.905,111
526,NOP,2021-12-08,114,,DEN,L 114-120 (OT),265,47,90,.522,36,60,.600,11,30,.367,9,12,.750,114,45,88,.511,36,56,.643,9,32,.281,21,27,.778,120
527,PHO,2021-12-02,114,,DET,W 114-103,240,43,79,.544,31,58,.534,12,21,.571,16,23,.696,114,36,80,.450,25,53,.472,11,27,.407,20,26,.769,103
528,DAL,2021-11-27,114,,WAS,L 114-120,240,42,89,.472,28,51,.549,14,38,.368,16,22,.727,114,45,78,.577,36,54,.667,9,24,.375,21,26,.808,120
529,IND,2021-11-26,114,,TOR,W 114-97,240,47,97,.485,36,58,.621,11,39,.282,9,11,.818,114,37,89,.416,30,59,.508,7,30,.233,16,22,.727,97
530,MIL,2021-11-24,114,,DET,W 114-93,240,42,87,.483,27,51,.529,15,36,.417,15,17,.882,114,34,95,.358,23,50,.460,11,45,.244,14,19,.737,93
531,LAL,2021-11-14,114,,SAS,W 114-106,240,43,83,.518,28,52,.538,15,31,.484,13,17,.765,114,40,90,.444,24,54,.444,16,36,.444,10,15,.667,106
532,GSW,2021-11-03,114,,CHO,W 114-92,240,42,86,.488,24,41,.585,18,45,.400,12,18,.667,114,34,91,.374,24,55,.436,10,36,.278,14,19,.737,92
533,BOS,2021-11-01,114,,CHI,L 114-128,240,42,96,.438,27,63,.429,15,33,.455,15,20,.750,114,49,86,.570,36,55,.655,13,31,.419,17,18,.944,128
534,MIA,2021-10-29,114,,CHO,W 114-99,240,43,91,.473,34,56,.607,9,35,.257,19,19,1.000,114,35,90,.389,22,53,.415,13,37,.351,16,22,.727,99
535,LAC,2021-10-23,114,,MEM,L 114-120,240,43,99,.434,30,60,.500,13,39,.333,15,17,.882,114,42,90,.467,27,54,.500,15,36,.417,21,25,.840,120
536,LAL,2021-10-19,114,,GSW,L 114-121,240,45,95,.474,30,53,.566,15,42,.357,9,19,.474,114,41,93,.441,27,54,.500,14,39,.359,25,30,.833,121
537,MIA,2022-04-08,113,,ATL,W 113-109,240,40,72,.556,29,46,.630,11,26,.423,22,28,.786,113,42,88,.477,34,54,.630,8,34,.235,17,19,.895,109
538,LAC,2022-04-06,113,,PHO,W 113-109,240,33,75,.440,21,41,.512,12,34,.353,35,44,.795,113,42,108,.389,25,60,.417,17,48,.354,8,12,.667,109
539,DET,2022-04-06,113,,DAL,L 113-131,240,35,82,.427,24,52,.462,11,30,.367,32,35,.914,113,45,80,.563,30,47,.638,15,33,.455,26,34,.765,131
540,SAS,2022-04-03,113,,POR,W 113-92,240,38,84,.452,24,42,.571,14,42,.333,23,30,.767,113,33,84,.393,17,39,.436,16,45,.356,10,15,.667,92
541,DEN,2022-03-26,113,,OKC,W 113-107,240,41,85,.482,33,54,.611,8,31,.258,23,24,.958,113,39,84,.464,25,48,.521,14,36,.389,15,16,.938,107
542,PHI,2022-03-21,113,,MIA,W 113-106,240,43,86,.500,28,49,.571,15,37,.405,12,16,.750,113,38,80,.475,28,47,.596,10,33,.303,20,20,1.000,106
543,CHI,2022-03-21,113,,TOR,W 113-99,240,44,90,.489,33,62,.532,11,28,.393,14,24,.583,113,40,91,.440,34,59,.576,6,32,.188,13,15,.867,99
544,CLE,2022-03-19,113,,DET,W 113-109,240,45,88,.511,35,62,.565,10,26,.385,13,23,.565,113,41,85,.482,28,55,.509,13,30,.433,14,19,.737,109
545,DET,2022-03-07,113,,ATL,W 113-110 (OT),265,43,93,.462,31,60,.517,12,33,.364,15,23,.652,113,42,93,.452,31,55,.564,11,38,.289,15,22,.682,110
546,IND,2022-02-16,113,,WAS,W 113-108,240,45,83,.542,41,63,.651,4,20,.200,19,29,.655,113,39,91,.429,22,54,.407,17,37,.459,13,16,.813,108
547,IND,2022-02-11,113,,CLE,L 113-120,240,42,89,.472,24,51,.471,18,38,.474,11,16,.688,113,43,81,.531,34,57,.596,9,24,.375,25,30,.833,120
548,WAS,2022-02-10,113,,BRK,W 113-112,240,43,85,.506,32,54,.593,11,31,.355,16,18,.889,113,39,84,.464,29,55,.527,10,29,.345,24,28,.857,112
549,UTA,2022-02-07,113,,NYK,W 113-104,240,39,93,.419,27,45,.600,12,48,.250,23,27,.852,113,36,95,.379,28,62,.452,8,33,.242,24,35,.686,104
550,LAC,2022-02-06,113,,MIL,L 113-137,240,40,96,.417,22,50,.440,18,46,.391,15,16,.938,113,48,88,.545,29,50,.580,19,38,.500,22,27,.815,137
551,SAC,2022-02-05,113,,OKC,W 113-103,240,43,83,.518,31,51,.608,12,32,.375,15,22,.682,113,42,87,.483,33,57,.579,9,30,.300,10,16,.625,103
552,BOS,2022-02-02,113,,CHO,W 113-107,240,42,82,.512,28,46,.609,14,36,.389,15,17,.882,113,37,87,.425,25,47,.532,12,40,.300,21,27,.778,107
553,MIA,2022-01-23,113,,LAL,W 113-107,240,40,81,.494,25,48,.521,15,33,.455,18,20,.900,113,36,79,.456,25,39,.641,11,40,.275,24,30,.800,107
554,PHO,2022-01-22,113,,IND,W 113-103,240,47,96,.490,40,71,.563,7,25,.280,12,14,.857,113,37,84,.440,27,55,.491,10,29,.345,19,27,.704,103
555,NOP,2022-01-13,113,,LAC,W 113-89,240,43,97,.443,29,58,.500,14,39,.359,13,16,.813,113,31,81,.383,21,47,.447,10,34,.294,17,20,.850,89
556,DAL,2022-01-09,113,,CHI,W 113-99,240,44,88,.500,28,52,.538,16,36,.444,9,9,1.000,113,39,90,.433,28,57,.491,11,33,.333,10,13,.769,99
557,PHO,2021-12-27,113,,MEM,L 113-114,240,41,90,.456,30,59,.508,11,31,.355,20,23,.870,113,45,88,.511,34,59,.576,11,29,.379,13,17,.765,114
558,CHI,2021-12-26,113,,IND,W 113-105,240,43,76,.566,32,53,.604,11,23,.478,16,22,.727,113,41,94,.436,33,64,.516,8,30,.267,15,21,.714,105
559,GSW,2021-12-23,113,,MEM,W 113-104,240,40,82,.488,21,42,.500,19,40,.475,14,18,.778,113,38,90,.422,30,64,.469,8,26,.308,20,24,.833,104
560,PHO,2021-12-23,113,,OKC,W 113-101,240,45,93,.484,30,54,.556,15,39,.385,8,13,.615,113,37,96,.385,26,55,.473,11,41,.268,16,21,.762,101
561,GSW,2021-12-20,113,,SAC,W 113-98,240,46,88,.523,31,51,.608,15,37,.405,6,9,.667,113,37,83,.446,24,51,.471,13,32,.406,11,16,.688,98
562,DEN,2021-12-13,113,,WAS,W 113-107,240,37,79,.468,27,47,.574,10,32,.313,29,33,.879,113,41,90,.456,29,56,.518,12,34,.353,13,21,.619,107
563,MEM,2021-12-11,113,,HOU,W 113-106,240,40,80,.500,29,51,.569,11,29,.379,22,36,.611,113,38,77,.494,27,44,.614,11,33,.333,19,29,.655,106
564,MIA,2021-12-08,113,,MIL,W 113-104,240,40,77,.519,18,30,.600,22,47,.468,11,12,.917,113,36,85,.424,24,46,.522,12,39,.308,20,27,.741,104
565,MEM,2021-11-24,113,,TOR,L 113-126,240,42,82,.512,33,53,.623,9,29,.310,20,26,.769,113,47,89,.528,33,59,.559,14,30,.467,18,21,.857,126
566,MIN,2021-11-24,113,,MIA,W 113-101,240,38,93,.409,20,38,.526,18,55,.327,19,21,.905,113,33,74,.446,18,32,.563,15,42,.357,20,29,.690,101
567,ATL,2021-11-22,113,,OKC,W 113-101,240,42,87,.483,28,53,.528,14,34,.412,15,16,.938,113,39,97,.402,29,59,.492,10,38,.263,13,14,.929,101
568,MIA,2021-11-17,113,,NOP,W 113-98,240,42,87,.483,27,47,.574,15,40,.375,14,17,.824,113,33,75,.440,23,40,.575,10,35,.286,22,28,.786,98
569,DEN,2021-11-08,113,,MIA,W 113-96,240,42,91,.462,30,50,.600,12,41,.293,17,24,.708,113,31,78,.397,18,42,.429,13,36,.361,21,25,.840,96
570,PHI,2021-11-01,113,,POR,W 113-103,240,43,83,.518,30,47,.638,13,36,.361,14,16,.875,113,40,84,.476,28,50,.560,12,34,.353,11,18,.611,103
571,LAL,2021-10-29,113,,CLE,W 113-101,240,46,84,.548,34,57,.596,12,27,.444,9,10,.900,113,37,87,.425,25,53,.472,12,34,.353,15,22,.682,101
572,ATL,2021-10-21,113,,DAL,W 113-87,240,45,94,.479,30,59,.508,15,35,.429,8,9,.889,113,31,93,.333,18,50,.360,13,43,.302,12,13,.923,87
573,MIL,2022-04-03,112,,DAL,L 112-118,240,42,95,.442,27,55,.491,15,40,.375,13,18,.722,112,39,76,.513,23,38,.605,16,38,.421,24,27,.889,118
574,CLE,2022-03-30,112,,DAL,L 112-120,240,42,83,.506,31,58,.534,11,25,.440,17,22,.773,112,46,88,.523,30,46,.652,16,42,.381,12,15,.800,120
575,ATL,2022-03-20,112,,NOP,L 112-117,240,41,87,.471,31,55,.564,10,32,.313,20,23,.870,112,43,96,.448,36,75,.480,7,21,.333,24,27,.889,117
576,HOU,2022-03-16,112,,PHO,L 112-129,240,42,85,.494,26,46,.565,16,39,.410,12,19,.632,112,53,95,.558,40,62,.645,13,33,.394,10,13,.769,129
577,SAC,2022-03-14,112,,CHI,W 112-103,240,39,82,.476,29,57,.509,10,25,.400,24,26,.923,112,36,88,.409,26,54,.481,10,34,.294,21,22,.955,103
578,PHO,2022-03-11,112,,TOR,L 112-117,240,44,88,.500,33,52,.635,11,36,.306,13,17,.765,112,42,94,.447,28,62,.452,14,32,.438,19,21,.905,117
579,ATL,2022-03-11,112,,LAC,W 112-106,240,43,90,.478,34,59,.576,9,31,.290,17,19,.895,112,40,82,.488,28,50,.560,12,32,.375,14,17,.824,106
580,GSW,2022-03-08,112,,LAC,W 112-97,240,44,92,.478,31,58,.534,13,34,.382,11,13,.846,112,33,93,.355,21,54,.389,12,39,.308,19,23,.826,97
581,CHI,2022-03-04,112,,MIL,L 112-118,240,47,94,.500,37,68,.544,10,26,.385,8,11,.727,112,43,88,.489,33,57,.579,10,31,.323,22,33,.667,118
582,SAS,2022-03-03,112,,SAC,L 112-115,240,46,93,.495,34,61,.557,12,32,.375,8,16,.500,112,39,85,.459,29,53,.547,10,32,.313,27,32,.844,115
583,MIA,2022-02-28,112,,CHI,W 112-99,240,40,81,.494,28,50,.560,12,31,.387,20,26,.769,112,41,84,.488,34,55,.618,7,29,.241,10,15,.667,99
584,CHI,2022-02-24,112,,ATL,W 112-108,240,41,84,.488,33,57,.579,8,27,.296,22,27,.815,112,41,97,.423,33,69,.478,8,28,.286,18,27,.667,108
585,POR,2022-02-12,112,,NYK,W 112-103,240,40,84,.476,25,44,.568,15,40,.375,17,20,.850,112,31,81,.383,19,42,.452,12,39,.308,29,34,.853,103
586,DAL,2022-02-10,112,,LAC,W 112-105,240,38,78,.487,25,39,.641,13,39,.333,23,27,.852,112,39,81,.481,30,58,.517,9,23,.391,18,25,.720,105
587,SAC,2022-02-02,112,,BRK,W 112-101,240,41,93,.441,27,51,.529,14,42,.333,16,18,.889,112,41,84,.488,33,59,.559,8,25,.320,11,14,.786,101
588,MIL,2022-02-01,112,,WAS,W 112-98,240,46,92,.500,34,54,.630,12,38,.316,8,9,.889,112,36,82,.439,24,47,.511,12,35,.343,14,20,.700,98
589,POR,2022-01-26,112,,DAL,L 112-132,240,42,82,.512,28,44,.636,14,38,.368,14,23,.609,112,48,88,.545,32,52,.615,16,36,.444,20,26,.769,132
590,SAC,2022-01-16,112,,HOU,L 112-118,240,41,91,.451,29,53,.547,12,38,.316,18,24,.750,112,41,76,.539,25,36,.694,16,40,.400,20,24,.833,118
591,WAS,2022-01-12,112,,ORL,W 112-106,240,43,82,.524,33,51,.647,10,31,.323,16,21,.762,112,41,99,.414,30,64,.469,11,35,.314,13,16,.813,106
592,CHI,2022-01-12,112,,BRK,L 112-138,240,38,81,.469,27,51,.529,11,30,.367,25,31,.806,112,49,87,.563,32,55,.582,17,32,.531,23,28,.821,138
593,UTA,2021-12-20,112,,CHO,W 112-102,240,34,96,.354,18,43,.419,16,53,.302,28,37,.757,112,39,101,.386,24,58,.414,15,43,.349,9,9,1.000,102
594,SAS,2021-12-12,112,,NOP,W 112-97,240,45,91,.495,38,66,.576,7,25,.280,15,20,.750,112,40,94,.426,32,65,.492,8,29,.276,9,15,.600,97
595,SAS,2021-12-11,112,,DEN,L 112-127,240,41,89,.461,31,62,.500,10,27,.370,20,29,.690,112,47,93,.505,27,50,.540,20,43,.465,13,14,.929,127
596,MIL,2021-12-06,112,,CLE,W 112-104,240,40,86,.465,27,54,.500,13,32,.406,19,24,.792,112,35,90,.389,20,44,.455,15,46,.326,19,20,.950,104
597,BRK,2021-11-30,112,,NYK,W 112-110,240,41,85,.482,33,57,.579,8,28,.286,22,25,.880,112,44,91,.484,33,59,.559,11,32,.344,11,12,.917,110
598,CLE,2021-11-22,112,,BRK,L 112-117,240,36,93,.387,22,49,.449,14,44,.318,26,29,.897,112,45,95,.474,34,60,.567,11,35,.314,16,18,.889,117
599,PHO,2021-11-19,112,,DAL,W 112-104,240,44,85,.518,30,56,.536,14,29,.483,10,14,.714,112,37,90,.411,25,50,.500,12,40,.300,18,23,.783,104
600,MIA,2021-11-18,112,,WAS,W 112-97,240,41,82,.500,31,56,.554,10,26,.385,20,24,.833,112,38,77,.494,23,41,.561,15,36,.417,6,10,.600,97
601,POR,2021-11-17,112,,CHI,W 112-107,240,37,84,.440,26,53,.491,11,31,.355,27,28,.964,112,39,83,.470,26,54,.481,13,29,.448,16,20,.800,107
602,NOP,2021-11-13,112,,MEM,W 112-101,240,38,79,.481,24,50,.480,14,29,.483,22,25,.880,112,38,88,.432,30,64,.469,8,24,.333,17,21,.810,101
603,NOP,2021-11-12,112,,BRK,L 112-120,240,43,88,.489,30,56,.536,13,32,.406,13,16,.813,112,41,82,.500,23,48,.479,18,34,.529,20,27,.741,120
604,LAC,2021-11-11,112,,MIA,W 112-109,240,43,91,.473,32,54,.593,11,37,.297,15,17,.882,112,43,97,.443,34,56,.607,9,41,.220,14,17,.824,109
605,SAC,2021-11-03,112,,NOP,W 112-99,240,42,80,.525,32,50,.640,10,30,.333,18,22,.818,112,37,86,.430,25,52,.481,12,34,.353,13,15,.867,99
606,PHO,2021-11-02,112,,NOP,W 112-100,240,43,82,.524,34,56,.607,9,26,.346,17,18,.944,112,36,91,.396,23,52,.442,13,39,.333,15,16,.938,100
607,NYK,2021-10-26,112,,PHI,W 112-99,240,41,87,.471,25,50,.500,16,37,.432,14,15,.933,112,36,82,.439,24,41,.585,12,41,.293,15,17,.882,99
608,CLE,2021-10-22,112,,CHO,L 112-123,240,43,84,.512,34,53,.642,9,31,.290,17,20,.850,112,48,91,.527,35,59,.593,13,32,.406,14,17,.824,123
609,GSW,2022-04-02,111,,UTA,W 111-107,240,40,84,.476,20,36,.556,20,48,.417,11,12,.917,111,38,89,.427,23,43,.535,15,46,.326,16,22,.727,107
610,LAL,2022-04-01,111,,NOP,L 111-114,240,39,82,.476,28,55,.509,11,27,.407,22,31,.710,111,41,79,.519,34,53,.642,7,26,.269,25,29,.862,114
611,SAS,2022-03-30,111,,MEM,L 111-112,240,42,83,.506,28,48,.583,14,35,.400,13,16,.813,111,44,91,.484,28,52,.538,16,39,.410,8,11,.727,112
612,NYK,2022-03-22,111,,ATL,L 111-117,240,42,86,.488,29,52,.558,13,34,.382,14,26,.538,111,40,81,.494,25,45,.556,15,36,.417,22,27,.815,117
613,PHI,2022-03-18,111,,DAL,W 111-101,240,37,75,.493,21,37,.568,16,38,.421,21,23,.913,111,37,80,.463,25,48,.521,12,32,.375,15,21,.714,101
614,BRK,2022-03-16,111,,DAL,L 111-113,240,45,91,.495,36,65,.554,9,26,.346,12,15,.800,111,41,83,.494,29,49,.592,12,34,.353,19,19,1.000,113
615,UTA,2022-03-14,111,,MIL,L 111-117,240,37,93,.398,20,45,.444,17,48,.354,20,24,.833,111,40,86,.465,28,55,.509,12,31,.387,25,29,.862,117
616,DAL,2022-03-07,111,,UTA,W 111-103,240,39,88,.443,22,42,.524,17,46,.370,16,20,.800,111,36,83,.434,24,52,.462,12,31,.387,19,24,.792,103
617,DET,2022-03-04,111,,IND,W 111-106,240,42,94,.447,27,64,.422,15,30,.500,12,18,.667,111,39,100,.390,29,60,.483,10,40,.250,18,28,.643,106
618,BOS,2022-02-16,111,,DET,L 111-112,240,42,77,.545,29,45,.644,13,32,.406,14,18,.778,111,43,93,.462,27,63,.429,16,30,.533,10,13,.769,112
619,UTA,2022-02-09,111,,GSW,W 111-85,240,41,89,.461,24,38,.632,17,51,.333,12,17,.706,111,28,78,.359,12,35,.343,16,43,.372,13,17,.765,85
620,LAC,2022-02-03,111,,LAL,W 111-110,240,46,89,.517,33,59,.559,13,30,.433,6,11,.545,111,41,88,.466,30,59,.508,11,29,.379,17,25,.680,110
621,CHI,2022-01-26,111,,TOR,W 111-105,240,46,84,.548,39,58,.672,7,26,.269,12,16,.750,111,38,79,.481,26,48,.542,12,31,.387,17,28,.607,105
622,UTA,2022-01-21,111,,DET,W 111-101,240,36,79,.456,26,48,.542,10,31,.323,29,34,.853,111,38,87,.437,25,55,.455,13,32,.406,12,16,.750,101
623,UTA,2022-01-19,111,,HOU,L 111-116,240,42,89,.472,32,51,.627,10,38,.263,17,20,.850,111,41,96,.427,19,51,.373,22,45,.489,12,17,.706,116
624,PHI,2022-01-14,111,,BOS,W 111-99,240,38,85,.447,24,44,.545,14,41,.341,21,25,.840,111,37,78,.474,26,47,.553,11,31,.355,14,18,.778,99
625,NYK,2022-01-10,111,,SAS,W 111-96,240,40,82,.488,27,50,.540,13,32,.406,18,24,.750,111,39,95,.411,31,66,.470,8,29,.276,10,15,.667,96
626,MIL,2022-01-05,111,,TOR,L 111-117,240,38,85,.447,21,46,.457,17,39,.436,18,26,.692,111,42,89,.472,26,53,.491,16,36,.444,17,25,.680,117
627,WAS,2022-01-05,111,,HOU,L 111-114,240,40,91,.440,30,52,.577,10,39,.256,21,26,.808,111,40,85,.471,31,59,.525,9,26,.346,25,32,.781,114
628,HOU,2022-01-01,111,,DEN,L 111-124,240,37,85,.435,21,43,.488,16,42,.381,21,24,.875,111,46,86,.535,36,54,.667,10,32,.313,22,27,.815,124
629,BOS,2021-12-22,111,,CLE,W 111-101,240,43,92,.467,32,62,.516,11,30,.367,14,18,.778,111,36,92,.391,27,54,.500,9,38,.237,20,24,.833,101
630,NOP,2021-12-21,111,,POR,W 111-97,240,42,80,.525,30,47,.638,12,33,.364,15,18,.833,111,35,78,.449,22,44,.500,13,34,.382,14,19,.737,97
631,MIN,2021-12-19,111,,DAL,W 111-105,240,36,77,.468,21,43,.488,15,34,.441,24,31,.774,111,36,82,.439,24,41,.585,12,41,.293,21,22,.955,105
632,LAC,2021-12-13,111,,PHO,W 111-95,240,43,78,.551,34,57,.596,9,21,.429,16,23,.696,111,36,96,.375,29,67,.433,7,29,.241,16,19,.842,95
633,POR,2021-12-12,111,,MIN,L 111-116,240,37,81,.457,19,33,.576,18,48,.375,19,28,.679,111,38,85,.447,24,49,.490,14,36,.389,26,32,.813,116
634,PHO,2021-12-10,111,,BOS,W 111-90,240,43,96,.448,29,58,.500,14,38,.368,11,11,1.000,111,35,93,.376,31,67,.463,4,26,.154,16,24,.667,90
635,IND,2021-12-01,111,,ATL,L 111-114,240,44,90,.489,34,57,.596,10,33,.303,13,16,.813,111,44,86,.512,28,53,.528,16,33,.485,10,12,.833,114
636,MIA,2021-11-29,111,,DEN,L 111-120,240,43,91,.473,28,47,.596,15,44,.341,10,15,.667,111,43,74,.581,25,39,.641,18,35,.514,16,21,.762,120
637,SAS,2021-11-22,111,,PHO,L 111-115,240,49,93,.527,44,73,.603,5,20,.250,8,16,.500,111,45,88,.511,33,61,.541,12,27,.444,13,16,.813,115
638,IND,2021-11-20,111,,NOP,W 111-94,240,42,91,.462,28,53,.528,14,38,.368,13,18,.722,111,35,88,.398,29,70,.414,6,18,.333,18,19,.947,94
639,BOS,2021-11-20,111,,OKC,W 111-105,240,41,88,.466,24,49,.490,17,39,.436,12,14,.857,111,39,96,.406,21,54,.389,18,42,.429,9,16,.563,105
640,DAL,2021-11-15,111,,DEN,W 111-101,240,45,90,.500,31,54,.574,14,36,.389,7,10,.700,111,40,84,.476,31,52,.596,9,32,.281,12,17,.706,101
641,IND,2021-11-03,111,,NYK,W 111-98,240,42,91,.462,26,50,.520,16,41,.390,11,14,.786,111,36,87,.414,31,63,.492,5,24,.208,21,27,.778,98
642,POR,2021-10-29,111,,LAC,W 111-92,240,41,98,.418,22,57,.386,19,41,.463,10,16,.625,111,34,87,.391,19,45,.422,15,42,.357,9,16,.563,92
643,ORL,2021-10-27,111,,CHO,L 111-120,240,43,88,.489,28,48,.583,15,40,.375,10,13,.769,111,43,83,.518,29,53,.547,14,30,.467,20,24,.833,120
644,SAS,2021-10-23,111,,MIL,L 111-121,240,48,99,.485,38,60,.633,10,39,.256,5,6,.833,111,44,83,.530,29,48,.604,15,35,.429,18,22,.818,121
645,MEM,2022-04-10,110,,BOS,L 110-139,240,39,102,.382,24,55,.436,15,47,.319,17,27,.630,110,54,99,.545,36,51,.706,18,48,.375,13,13,1.000,139
646,BRK,2022-03-27,110,,CHO,L 110-119,240,43,97,.443,36,63,.571,7,34,.206,17,26,.654,110,42,98,.429,25,66,.379,17,32,.531,18,23,.783,119
647,ORL,2022-03-26,110,,SAC,L 110-114 (OT),265,45,106,.425,32,70,.457,13,36,.361,7,7,1.000,110,42,98,.429,31,62,.500,11,36,.306,19,24,.792,114
648,DAL,2022-03-23,110,,HOU,W 110-91,240,42,86,.488,34,53,.642,8,33,.242,18,22,.818,110,33,82,.402,29,54,.537,4,28,.143,21,28,.750,91
649,DAL,2022-03-21,110,,MIN,W 110-108,240,40,83,.482,26,37,.703,14,46,.304,16,21,.762,110,36,91,.396,23,55,.418,13,36,.361,23,29,.793,108
650,PHI,2022-03-14,110,,DEN,L 110-114,240,36,84,.429,24,51,.471,12,33,.364,26,32,.813,110,44,82,.537,31,49,.633,13,33,.394,13,20,.650,114
651,BRK,2022-03-13,110,,NYK,W 110-107,240,44,89,.494,38,60,.633,6,29,.207,16,22,.727,110,39,83,.470,28,54,.519,11,29,.379,18,21,.857,107
652,OKC,2022-02-28,110,,SAC,L 110-131,240,40,86,.465,29,51,.569,11,35,.314,19,27,.704,110,49,87,.563,39,56,.696,10,31,.323,23,30,.767,131
653,CHI,2022-02-26,110,,MEM,L 110-116,240,39,93,.419,30,73,.411,9,20,.450,23,30,.767,110,44,100,.440,37,77,.481,7,23,.304,21,26,.808,116
654,SAC,2022-02-24,110,,DEN,L 110-128,240,43,86,.500,34,57,.596,9,29,.310,15,18,.833,110,48,86,.558,33,51,.647,15,35,.429,17,20,.850,128
655,WAS,2022-02-12,110,,SAC,L 110-123,240,41,88,.466,28,50,.560,13,38,.342,15,21,.714,110,43,76,.566,31,48,.646,12,28,.429,25,29,.862,123
656,NOP,2022-02-08,110,,HOU,W 110-97,240,42,80,.525,34,48,.708,8,32,.250,18,20,.900,110,32,86,.372,19,44,.432,13,42,.310,20,31,.645,97
657,TOR,2022-02-01,110,,MIA,W 110-106,240,39,81,.481,27,55,.491,12,26,.462,20,29,.690,110,38,78,.487,30,48,.625,8,30,.267,22,25,.880,106
658,ORL,2022-01-30,110,,DAL,W 110-108,240,43,84,.512,32,50,.640,11,34,.324,13,16,.813,110,39,81,.481,23,43,.535,16,38,.421,14,18,.778,108
659,GSW,2022-01-29,110,,BRK,W 110-106,240,40,98,.408,26,53,.491,14,45,.311,16,18,.889,110,39,98,.398,28,70,.400,11,28,.393,17,21,.810,106
660,OKC,2022-01-28,110,,IND,L 110-113 (OT),265,43,95,.453,29,52,.558,14,43,.326,10,17,.588,110,41,95,.432,28,56,.500,13,39,.333,18,29,.621,113
661,HOU,2022-01-28,110,,POR,L 110-125,240,38,79,.481,28,38,.737,10,41,.244,24,31,.774,110,46,81,.568,29,42,.690,17,39,.436,16,20,.800,125
662,MIA,2022-01-26,110,,NYK,W 110-96,240,37,74,.500,21,37,.568,16,37,.432,20,22,.909,110,35,83,.422,20,39,.513,15,44,.341,11,17,.647,96
663,SAS,2022-01-26,110,,MEM,L 110-118,240,43,94,.457,34,57,.596,9,37,.243,15,19,.789,110,46,90,.511,39,67,.582,7,23,.304,19,26,.731,118
664,OKC,2022-01-24,110,,CHI,L 110-111,240,38,92,.413,22,47,.468,16,45,.356,18,24,.750,110,41,89,.461,26,50,.520,15,39,.385,14,19,.737,111
665,NYK,2022-01-23,110,,LAC,W 110-102,240,39,91,.429,23,55,.418,16,36,.444,16,19,.842,110,34,79,.430,20,38,.526,14,41,.341,20,30,.667,102
666,ATL,2022-01-21,110,,MIA,W 110-108,240,38,68,.559,24,35,.686,14,33,.424,20,24,.833,110,41,85,.482,26,45,.578,15,40,.375,11,12,.917,108
667,NYK,2022-01-18,110,,MIN,L 110-112,240,37,80,.463,25,42,.595,12,38,.316,24,33,.727,110,35,81,.432,22,40,.550,13,41,.317,29,38,.763,112
668,WAS,2022-01-15,110,,POR,L 110-115,240,39,90,.433,27,53,.509,12,37,.324,20,23,.870,110,39,85,.459,26,46,.565,13,39,.333,24,35,.686,115
669,NOP,2022-01-04,110,,PHO,L 110-123,240,36,89,.404,26,56,.464,10,33,.303,28,32,.875,110,46,85,.541,29,54,.537,17,31,.548,14,20,.700,123
670,HOU,2021-12-31,110,,MIA,L 110-120,240,41,93,.441,27,51,.529,14,42,.333,14,17,.824,110,40,86,.465,26,53,.491,14,33,.424,26,31,.839,120
671,WAS,2021-12-30,110,,CLE,W 110-93,240,45,90,.500,36,61,.590,9,29,.310,11,17,.647,110,35,83,.422,27,55,.491,8,28,.286,15,23,.652,93
672,ORL,2021-12-28,110,,MIL,L 110-127,240,38,83,.458,26,44,.591,12,39,.308,22,26,.846,110,47,85,.553,30,48,.625,17,37,.459,16,22,.727,127
673,LAL,2021-12-23,110,,SAS,L 110-138,240,44,94,.468,39,67,.582,5,27,.185,17,30,.567,110,46,95,.484,28,56,.500,18,39,.462,28,33,.848,138
674,MIN,2021-12-17,110,,LAL,W 110-92,240,41,98,.418,29,54,.537,12,44,.273,16,24,.667,110,30,78,.385,18,35,.514,12,43,.279,20,29,.690,92
675,OKC,2021-12-15,110,,NOP,L 110-113,240,39,93,.419,26,58,.448,13,35,.371,19,19,1.000,110,39,80,.488,28,52,.538,11,28,.393,24,36,.667,113
676,MIN,2021-12-06,110,,ATL,L 110-121,240,39,98,.398,22,58,.379,17,40,.425,15,19,.789,110,40,90,.444,15,41,.366,25,49,.510,16,19,.842,121
677,BRK,2021-12-03,110,,MIN,W 110-105,240,36,76,.474,30,53,.566,6,23,.261,32,41,.780,110,36,93,.387,23,51,.451,13,42,.310,20,24,.833,105
678,OKC,2021-12-01,110,,HOU,L 110-114,240,40,85,.471,32,53,.604,8,32,.250,22,29,.759,110,40,79,.506,25,42,.595,15,37,.405,19,22,.864,114
679,POR,2021-11-30,110,,DET,W 110-92,240,41,96,.427,27,54,.500,14,42,.333,14,18,.778,110,29,76,.382,20,41,.488,9,35,.257,25,30,.833,92
680,LAL,2021-11-28,110,,DET,W 110-106,240,43,86,.500,34,54,.630,9,32,.281,15,25,.600,110,38,89,.427,25,56,.446,13,33,.394,17,19,.895,106
681,ATL,2021-11-17,110,,BOS,W 110-99,240,41,81,.506,28,44,.636,13,37,.351,15,18,.833,110,37,84,.440,26,43,.605,11,41,.268,14,17,.824,99
682,UTA,2021-11-09,110,,ATL,W 110-98,240,41,81,.506,26,43,.605,15,38,.395,13,16,.813,110,37,85,.435,19,50,.380,18,35,.514,6,10,.600,98
683,POR,2021-11-05,110,,IND,W 110-106,240,40,82,.488,23,43,.535,17,39,.436,13,15,.867,110,43,88,.489,29,46,.630,14,42,.333,6,10,.600,106
684,DAL,2021-11-02,110,,MIA,L 110-125,240,37,84,.440,23,42,.548,14,42,.333,22,31,.710,110,43,83,.518,30,58,.517,13,25,.520,26,30,.867,125
685,CHO,2021-11-01,110,,CLE,L 110-113,240,42,101,.416,27,62,.435,15,39,.385,11,15,.733,110,39,90,.433,30,62,.484,9,28,.321,26,38,.684,113
686,DET,2021-10-30,110,,ORL,W 110-103,240,36,89,.404,22,46,.478,14,43,.326,24,30,.800,110,38,87,.437,22,55,.400,16,32,.500,11,15,.733,103
687,TOR,2021-10-29,110,,ORL,W 110-109,240,43,86,.500,34,56,.607,9,30,.300,15,22,.682,110,41,87,.471,25,53,.472,16,34,.471,11,16,.688,109
688,PHI,2021-10-28,110,,DET,W 110-102,240,38,76,.500,26,49,.531,12,27,.444,22,24,.917,110,35,86,.407,22,47,.468,13,39,.333,19,27,.704,102
689,PHO,2022-04-10,109,,SAC,L 109-116,240,42,103,.408,28,56,.500,14,47,.298,11,15,.733,109,40,76,.526,26,50,.520,14,26,.538,22,30,.733,116
690,SAC,2022-04-05,109,,NOP,L 109-123,240,39,76,.513,28,46,.609,11,30,.367,20,22,.909,109,45,88,.511,33,63,.524,12,25,.480,21,26,.808,123
691,TOR,2022-04-03,109,,MIA,L 109-114,240,35,83,.422,23,44,.523,12,39,.308,27,34,.794,109,41,79,.519,23,41,.561,18,38,.474,14,22,.636,114
692,CHI,2022-04-02,109,,MIA,L 109-127,240,37,86,.430,28,52,.538,9,34,.265,26,29,.897,109,44,82,.537,27,48,.563,17,34,.500,22,27,.815,127
693,CHO,2022-03-28,109,,DEN,L 109-113,240,44,93,.473,31,51,.608,13,42,.310,8,12,.667,109,40,86,.465,28,53,.528,12,33,.364,21,28,.750,113
694,NYK,2022-03-28,109,,CHI,W 109-104,240,38,89,.427,26,54,.481,12,35,.343,21,35,.600,109,34,79,.430,28,56,.500,6,23,.261,30,33,.909,104
695,IND,2022-03-23,109,,SAC,L 109-110,240,42,91,.462,28,55,.509,14,36,.389,11,11,1.000,109,43,82,.524,31,45,.689,12,37,.324,12,17,.706,110
696,WAS,2022-03-16,109,,DEN,L 109-127,240,41,87,.471,36,64,.563,5,23,.217,22,31,.710,109,46,90,.511,31,53,.585,15,37,.405,20,21,.952,127
697,TOR,2022-03-01,109,,BRK,W 109-108,240,41,90,.456,34,67,.507,7,23,.304,20,23,.870,109,42,84,.500,32,59,.542,10,25,.400,14,19,.737,108
698,NYK,2022-02-27,109,,PHI,L 109-125,240,38,85,.447,27,52,.519,11,33,.333,22,35,.629,109,38,78,.487,28,45,.622,10,33,.303,39,44,.886,125
699,ORL,2022-02-16,109,,ATL,L 109-130,240,42,98,.429,29,57,.509,13,41,.317,12,13,.923,109,45,90,.500,27,57,.474,18,33,.545,22,28,.786,130
700,NOP,2022-02-15,109,,MEM,L 109-121,240,44,88,.500,40,62,.645,4,26,.154,17,20,.850,109,47,94,.500,37,60,.617,10,34,.294,17,27,.630,121
701,BRK,2022-02-14,109,,SAC,W 109-85,240,43,84,.512,34,58,.586,9,26,.346,14,15,.933,109,31,90,.344,22,55,.400,9,35,.257,14,18,.778,85
702,TOR,2022-02-12,109,,DEN,L 109-110,240,43,88,.489,31,54,.574,12,34,.353,11,17,.647,109,39,84,.464,25,47,.532,14,37,.378,18,21,.857,110
703,CHO,2022-02-09,109,,CHI,L 109-121,240,40,93,.430,27,50,.540,13,43,.302,16,23,.696,109,46,82,.561,30,49,.612,16,33,.485,13,19,.684,121
704,PHI,2022-02-08,109,,PHO,L 109-114,240,41,89,.461,31,57,.544,10,32,.313,17,18,.944,109,43,95,.453,37,69,.536,6,26,.231,22,24,.917,114
705,SAS,2022-01-23,109,,PHI,L 109-115,240,42,89,.472,32,59,.542,10,30,.333,15,22,.682,109,44,92,.478,37,76,.487,7,16,.438,20,23,.870,115
706,CHO,2022-01-14,109,,ORL,L 109-116,240,40,97,.412,28,55,.509,12,42,.286,17,21,.810,109,45,87,.517,30,42,.714,15,45,.333,11,15,.733,116
707,SAS,2022-01-14,109,,CLE,L 109-114,240,42,92,.457,27,58,.466,15,34,.441,10,13,.769,109,46,95,.484,38,75,.507,8,20,.400,14,24,.583,114
708,BRK,2022-01-13,109,,OKC,L 109-130,240,41,98,.418,34,66,.515,7,32,.219,20,22,.909,109,47,91,.516,27,46,.587,20,45,.444,16,18,.889,130
709,BRK,2022-01-07,109,,MIL,L 109-121,240,42,92,.457,36,65,.554,6,27,.222,19,20,.950,109,44,96,.458,28,51,.549,16,45,.356,17,21,.810,121
710,DEN,2022-01-05,109,,UTA,L 109-115,240,42,88,.477,31,52,.596,11,36,.306,14,15,.933,109,43,92,.467,29,51,.569,14,41,.341,15,18,.833,115
711,POR,2022-01-05,109,,MIA,L 109-115,240,33,78,.423,18,40,.450,15,38,.395,28,36,.778,109,37,82,.451,18,41,.439,19,41,.463,22,29,.759,115
712,TOR,2021-12-28,109,,PHI,L 109-114,240,38,87,.437,23,46,.500,15,41,.366,18,22,.818,109,34,77,.442,20,47,.426,14,30,.467,32,38,.842,114
713,NOP,2021-12-10,109,,DET,W 109-93,240,41,95,.432,28,58,.483,13,37,.351,14,16,.875,109,35,90,.389,23,53,.434,12,37,.324,11,12,.917,93
714,TOR,2021-12-08,109,,OKC,L 109-110,240,42,93,.452,27,52,.519,15,41,.366,10,15,.667,109,38,84,.452,21,44,.477,17,40,.425,17,20,.850,110
715,SAS,2021-12-07,109,,NYK,L 109-121,240,41,92,.446,29,61,.475,12,31,.387,15,20,.750,109,43,91,.473,25,53,.472,18,38,.474,17,19,.895,121
716,CHI,2021-12-06,109,,DEN,W 109-97,240,41,91,.451,28,56,.500,13,35,.371,14,20,.700,109,38,96,.396,27,64,.422,11,32,.344,10,15,.667,97
717,DEN,2021-11-26,109,,MIL,L 109-120,240,40,92,.435,23,45,.511,17,47,.362,12,14,.857,109,46,73,.630,30,40,.750,16,33,.485,12,20,.600,120
718,CHI,2021-11-21,109,,NYK,W 109-103,240,37,88,.420,26,59,.441,11,29,.379,24,27,.889,109,35,84,.417,28,57,.491,7,27,.259,26,31,.839,103
719,MIL,2021-11-17,109,,LAL,W 109-102,240,40,87,.460,28,50,.560,12,37,.324,17,24,.708,109,40,96,.417,28,53,.528,12,43,.279,10,12,.833,102
720,BRK,2021-11-17,109,,CLE,W 109-99,240,38,83,.458,26,51,.510,12,32,.375,21,25,.840,109,35,89,.393,24,45,.533,11,44,.250,18,21,.857,99
721,SAS,2021-11-12,109,,DAL,L 109-123,240,41,84,.488,28,54,.519,13,30,.433,14,20,.700,109,46,100,.460,28,55,.509,18,45,.400,13,19,.684,123
722,PHI,2021-11-11,109,,TOR,L 109-115,240,40,88,.455,29,54,.537,11,34,.324,18,19,.947,109,42,96,.438,28,63,.444,14,33,.424,17,17,1.000,115
723,PHI,2021-11-09,109,,MIL,L 109-118,240,42,103,.408,28,60,.467,14,43,.326,11,12,.917,109,44,95,.463,29,56,.518,15,39,.385,15,21,.714,118
724,NYK,2021-11-07,109,,CLE,L 109-126,240,39,85,.459,30,54,.556,9,31,.290,22,24,.917,109,49,90,.544,30,55,.545,19,35,.543,9,11,.818,126
725,NOP,2021-10-29,109,,SAC,L 109-113,240,42,98,.429,33,64,.516,9,34,.265,16,25,.640,109,40,80,.500,31,53,.585,9,27,.333,24,25,.960,113
726,IND,2021-10-25,109,,MIL,L 109-119,240,40,90,.444,26,54,.481,14,36,.389,15,17,.882,109,41,85,.482,30,53,.566,11,32,.344,26,31,.839,119
727,PHI,2021-10-22,109,,BRK,L 109-114,240,43,91,.473,29,55,.527,14,36,.389,9,11,.818,109,41,88,.466,29,50,.580,12,38,.316,20,24,.833,114
728,CLE,2022-04-03,108,,PHI,L 108-112,240,35,78,.449,20,45,.444,15,33,.455,23,31,.742,108,33,80,.413,22,49,.449,11,31,.355,35,42,.833,112
729,GSW,2022-03-20,108,,SAS,L 108-110,240,41,90,.456,30,57,.526,11,33,.333,15,21,.714,108,38,98,.388,23,58,.397,15,40,.375,19,25,.760,110
730,ORL,2022-03-15,108,,BRK,L 108-150,240,36,95,.379,21,54,.389,15,41,.366,21,27,.778,108,53,88,.602,37,61,.607,16,27,.593,28,34,.824,150
731,SAS,2022-03-12,108,,IND,L 108-119,240,42,102,.412,31,68,.456,11,34,.324,13,16,.813,108,45,92,.489,31,56,.554,14,36,.389,15,15,1.000,119
732,DET,2022-03-09,108,,CHI,L 108-114,240,42,82,.512,31,51,.608,11,31,.355,13,17,.765,108,40,76,.526,37,61,.607,3,15,.200,31,35,.886,114
733,BOS,2022-02-11,108,,DEN,W 108-102,240,38,96,.396,28,59,.475,10,37,.270,22,30,.733,108,39,90,.433,28,46,.609,11,44,.250,13,18,.722,102
734,CHI,2022-02-06,108,,PHI,L 108-119,240,39,81,.481,32,55,.582,7,26,.269,23,26,.885,108,45,84,.536,33,60,.550,12,24,.500,17,21,.810,119
735,POR,2022-02-05,108,,MIL,L 108-137,240,41,85,.482,27,40,.675,14,45,.311,12,21,.571,108,49,92,.533,26,42,.619,23,50,.460,16,22,.727,137
736,UTA,2022-02-02,108,,DEN,W 108-104,240,42,86,.488,35,57,.614,7,29,.241,17,22,.773,108,42,79,.532,31,51,.608,11,28,.393,9,12,.750,104
737,NYK,2022-02-02,108,,MEM,L 108-120,240,38,88,.432,26,52,.500,12,36,.333,20,26,.769,108,44,102,.431,28,63,.444,16,39,.410,16,23,.696,120
738,HOU,2022-01-31,108,,GSW,L 108-122,240,36,84,.429,20,41,.488,16,43,.372,20,29,.690,108,43,80,.538,26,40,.650,17,40,.425,19,23,.826,122
739,ATL,2022-01-28,108,,BOS,W 108-92,240,41,89,.461,29,58,.500,12,31,.387,14,20,.700,108,30,86,.349,23,50,.460,7,36,.194,25,27,.926,92
740,DET,2022-01-16,108,,PHO,L 108-135,240,38,82,.463,29,57,.509,9,25,.360,23,34,.676,108,51,87,.586,40,60,.667,11,27,.407,22,30,.733,135
741,ATL,2022-01-15,108,,NYK,L 108-117,240,40,80,.500,24,36,.667,16,44,.364,12,17,.706,108,42,83,.506,29,52,.558,13,31,.419,20,26,.769,117
742,DAL,2022-01-15,108,,ORL,W 108-92,240,32,78,.410,20,44,.455,12,34,.353,32,38,.842,108,37,77,.481,30,51,.588,7,26,.269,11,16,.688,92
743,NYK,2022-01-12,108,,DAL,W 108-85,240,42,90,.467,30,63,.476,12,27,.444,12,15,.800,108,32,78,.410,24,41,.585,8,37,.216,13,19,.684,85
744,SAC,2022-01-10,108,,CLE,L 108-109,240,39,91,.429,25,61,.410,14,30,.467,16,22,.727,108,43,87,.494,33,53,.623,10,34,.294,13,15,.867,109
745,LAC,2022-01-08,108,,MEM,L 108-123,240,39,96,.406,29,64,.453,10,32,.313,20,24,.833,108,44,100,.440,32,62,.516,12,38,.316,23,31,.742,123
746,NYK,2022-01-06,108,,BOS,W 108-105,240,40,90,.444,22,54,.407,18,36,.500,10,15,.667,108,38,80,.475,21,35,.600,17,45,.378,12,13,.923,105
747,LAL,2022-01-02,108,,MIN,W 108-103,240,36,75,.480,23,34,.676,13,41,.317,23,29,.793,108,41,92,.446,32,54,.593,9,38,.237,12,16,.750,103
748,CLE,2022-01-02,108,,IND,W 108-104,240,41,88,.466,35,62,.565,6,26,.231,20,28,.714,108,37,83,.446,18,37,.486,19,46,.413,11,14,.786,104
749,IND,2021-12-29,108,,CHO,L 108-116,240,36,86,.419,19,41,.463,17,45,.378,19,29,.655,108,44,85,.518,35,59,.593,9,26,.346,19,32,.594,116
750,NOP,2021-12-28,108,,CLE,W 108-104,240,36,80,.450,20,44,.455,16,36,.444,20,26,.769,108,37,88,.420,23,47,.489,14,41,.341,16,19,.842,104
751,LAC,2021-12-27,108,,BRK,L 108-124,240,37,97,.381,23,60,.383,14,37,.378,20,27,.741,108,50,88,.568,37,54,.685,13,34,.382,11,16,.688,124
752,MIN,2021-12-27,108,,BOS,W 108-103,240,40,90,.444,26,56,.464,14,34,.412,14,19,.737,108,33,89,.371,17,42,.405,16,47,.340,21,28,.750,103
753,OKC,2021-12-22,108,,DEN,W 108-94,240,42,94,.447,34,60,.567,8,34,.235,16,19,.842,108,33,84,.393,20,40,.500,13,44,.295,15,26,.577,94
754,MEM,2021-12-09,108,,LAL,W 108-95,240,41,94,.436,27,52,.519,14,42,.333,12,18,.667,108,36,78,.462,24,48,.500,12,30,.400,11,17,.647,95
755,PHO,2021-12-06,108,,SAS,W 108-104,240,43,94,.457,33,65,.508,10,29,.345,12,18,.667,108,40,93,.430,29,64,.453,11,29,.379,13,19,.684,104
756,CLE,2021-12-05,108,,UTA,L 108-109,240,42,91,.462,28,53,.528,14,38,.368,10,13,.769,108,40,90,.444,20,42,.476,20,48,.417,9,10,.900,109
757,ORL,2021-12-01,108,,DEN,W 108-103,240,44,81,.543,38,54,.704,6,27,.222,14,19,.737,108,39,80,.488,29,46,.630,10,34,.294,15,21,.714,103
758,BOS,2021-11-22,108,,HOU,W 108-90,240,39,92,.424,27,57,.474,12,35,.343,18,19,.947,108,31,83,.373,20,41,.488,11,42,.262,17,24,.708,90
759,DEN,2021-11-19,108,,CHI,L 108-114,240,39,82,.476,25,45,.556,14,37,.378,16,20,.800,108,41,93,.441,33,62,.532,8,31,.258,24,24,1.000,114
760,MEM,2021-11-10,108,,CHO,L 108-118,240,45,107,.421,36,69,.522,9,38,.237,9,15,.600,108,41,90,.456,26,54,.481,15,36,.417,21,24,.875,118
761,DAL,2021-11-08,108,,NOP,W 108-92,240,43,85,.506,29,50,.580,14,35,.400,8,13,.615,108,37,87,.425,28,53,.528,9,34,.265,9,11,.818,92
762,MEM,2021-11-03,108,,DEN,W 108-106,240,42,81,.519,26,47,.553,16,34,.471,8,14,.571,108,43,91,.473,35,64,.547,8,27,.296,12,13,.923,106
763,SAS,2021-11-03,108,,DAL,L 108-109,240,43,88,.489,36,67,.537,7,21,.333,15,20,.750,108,40,93,.430,32,59,.542,8,34,.235,21,29,.724,109
764,MIL,2021-10-27,108,,MIN,L 108-113,240,39,95,.411,25,44,.568,14,51,.275,16,21,.762,108,43,91,.473,30,46,.652,13,45,.289,14,17,.824,113
765,TOR,2021-10-25,108,,CHI,L 108-111,240,40,83,.482,28,53,.528,12,30,.400,16,20,.800,108,39,81,.481,27,54,.500,12,27,.444,21,22,.955,111
766,NOP,2022-04-10,107,,GSW,L 107-128,240,42,99,.424,28,59,.475,14,40,.350,9,12,.750,107,49,81,.605,30,48,.625,19,33,.576,11,13,.846,128
767,POR,2022-03-30,107,,NOP,L 107-117,240,39,85,.459,25,43,.581,14,42,.333,15,18,.833,107,40,78,.513,34,54,.630,6,24,.250,31,39,.795,117
768,CLE,2022-03-28,107,,ORL,W 107-101,240,37,83,.446,24,42,.571,13,41,.317,20,23,.870,107,42,87,.483,32,50,.640,10,37,.270,7,13,.538,101
769,CHO,2022-03-25,107,,UTA,W 107-101,240,41,88,.466,28,54,.519,13,34,.382,12,17,.706,107,38,84,.452,21,37,.568,17,47,.362,8,11,.727,101
770,BRK,2022-03-03,107,,MIA,L 107-113,240,39,83,.470,27,52,.519,12,31,.387,17,22,.773,107,40,77,.519,30,47,.638,10,30,.333,23,28,.821,113
771,DEN,2022-03-02,107,,OKC,L 107-119,240,40,90,.444,28,44,.636,12,46,.261,15,17,.882,107,44,87,.506,28,58,.483,16,29,.552,15,21,.714,119
772,BOS,2022-03-01,107,,ATL,W 107-98,240,39,83,.470,28,48,.583,11,35,.314,18,19,.947,107,36,83,.434,29,52,.558,7,31,.226,19,24,.792,98
773,CHO,2022-02-17,107,,MIA,L 107-111 (2OT),290,38,95,.400,28,53,.528,10,42,.238,21,30,.700,107,41,102,.402,27,54,.500,14,48,.292,15,23,.652,111
774,MIL,2022-02-14,107,,POR,L 107-122,240,38,89,.427,25,48,.521,13,41,.317,18,24,.750,107,45,99,.455,27,56,.482,18,43,.419,14,19,.737,122
775,DET,2022-02-10,107,,MEM,L 107-132,240,41,94,.436,34,59,.576,7,35,.200,18,21,.857,107,44,92,.478,29,62,.468,15,30,.500,29,42,.690,132
776,POR,2022-02-09,107,,LAL,W 107-105,240,42,89,.472,32,57,.561,10,32,.313,13,16,.813,107,41,74,.554,24,37,.649,17,37,.459,6,13,.462,105
777,HOU,2022-02-06,107,,NOP,L 107-120,240,40,84,.476,24,39,.615,16,45,.356,11,16,.688,107,41,77,.532,29,48,.604,12,29,.414,26,36,.722,120
778,DAL,2022-02-04,107,,PHI,W 107-98,240,39,85,.459,29,51,.569,10,34,.294,19,23,.826,107,36,70,.514,27,43,.628,9,27,.333,17,23,.739,98
779,POR,2022-01-25,107,,MIN,L 107-109,240,37,94,.394,21,53,.396,16,41,.390,17,20,.850,107,36,82,.439,22,39,.564,14,43,.326,23,31,.742,109
780,SAS,2022-01-17,107,,PHO,L 107-121,240,41,92,.446,32,62,.516,9,30,.300,16,22,.727,107,49,95,.516,40,63,.635,9,32,.281,14,20,.700,121
781,PHO,2021-12-25,107,,GSW,L 107-116,240,40,83,.482,29,53,.547,11,30,.367,16,16,1.000,107,42,85,.494,28,48,.583,14,37,.378,18,21,.857,116
782,DEN,2021-12-23,107,,CHO,L 107-115,240,40,96,.417,26,56,.464,14,40,.350,13,17,.765,107,39,94,.415,23,47,.489,16,47,.340,21,24,.875,115
783,DET,2021-12-18,107,,HOU,L 107-116,240,43,93,.462,33,57,.579,10,36,.278,11,16,.688,107,46,93,.495,32,55,.582,14,38,.368,10,17,.588,116
784,BOS,2021-12-17,107,,GSW,L 107-111,240,36,82,.439,21,41,.512,15,41,.366,20,29,.690,107,39,90,.433,23,44,.523,16,46,.348,17,21,.810,111
785,DEN,2021-12-15,107,,MIN,L 107-124,240,38,84,.452,24,45,.533,14,39,.359,17,23,.739,107,45,88,.511,22,40,.550,23,48,.479,11,16,.688,124
786,POR,2021-12-14,107,,PHO,L 107-111 (OT),265,40,96,.417,27,55,.491,13,41,.317,14,22,.636,107,44,93,.473,33,62,.532,11,31,.355,12,15,.800,111
787,BRK,2021-12-04,107,,CHI,L 107-111,240,46,111,.414,38,86,.442,8,25,.320,7,9,.778,107,41,86,.477,31,55,.564,10,31,.323,19,27,.704,111
788,GSW,2021-12-04,107,,SAS,L 107-112,240,40,90,.444,27,51,.529,13,39,.333,14,21,.667,107,42,88,.477,30,53,.566,12,35,.343,16,19,.842,112
789,NOP,2021-12-01,107,,DAL,L 107-139,240,40,89,.449,27,52,.519,13,37,.351,14,16,.875,107,57,83,.687,39,49,.796,18,34,.529,7,9,.778,139
790,BRK,2021-11-27,107,,PHO,L 107-113,240,42,84,.500,35,61,.574,7,23,.304,16,21,.762,107,41,92,.446,28,54,.519,13,38,.342,18,21,.857,113
791,LAC,2021-11-26,107,,DET,W 107-96,240,39,91,.429,28,53,.528,11,38,.289,18,19,.947,107,33,90,.367,25,57,.439,8,33,.242,22,26,.846,96
792,MIN,2021-11-17,107,,SAC,W 107-97,240,41,82,.500,31,46,.674,10,36,.278,15,18,.833,107,34,93,.366,24,55,.436,10,38,.263,19,25,.760,97
793,DET,2021-11-15,107,,SAC,L 107-129,240,39,96,.406,26,49,.531,13,47,.277,16,17,.941,107,52,98,.531,36,65,.554,16,33,.485,9,11,.818,129
794,ORL,2021-11-07,107,,UTA,W 107-100,240,43,87,.494,31,55,.564,12,32,.375,9,11,.818,107,34,89,.382,26,47,.553,8,42,.190,24,29,.828,100
795,DAL,2021-11-06,107,,BOS,W 107-104,240,41,78,.526,28,39,.718,13,39,.333,12,14,.857,107,42,86,.488,33,55,.600,9,31,.290,11,16,.688,104
796,CLE,2021-11-03,107,,POR,W 107-104,240,39,74,.527,24,44,.545,15,30,.500,14,18,.778,107,40,90,.444,27,53,.509,13,37,.351,11,17,.647,104
797,CHI,2021-10-30,107,,UTA,W 107-99,240,39,91,.429,34,70,.486,5,21,.238,24,30,.800,107,35,92,.380,24,54,.444,11,38,.289,18,19,.947,99
798,BOS,2021-10-27,107,,WAS,L 107-116,240,37,85,.435,27,56,.482,10,29,.345,23,28,.821,107,43,84,.512,34,59,.576,9,25,.360,21,29,.724,116
799,PHO,2021-10-27,107,,SAC,L 107-110,240,42,93,.452,36,71,.507,6,22,.273,17,24,.708,107,42,95,.442,27,57,.474,15,38,.395,11,15,.733,110
800,MIA,2021-10-25,107,,ORL,W 107-90,240,41,87,.471,35,60,.583,6,27,.222,19,19,1.000,107,33,81,.407,21,37,.568,12,44,.273,12,19,.632,90
801,SAC,2021-10-24,107,,GSW,L 107-119,240,42,86,.488,27,40,.675,15,46,.326,8,13,.615,107,43,97,.443,30,60,.500,13,37,.351,20,24,.833,119
802,UTA,2021-10-20,107,,OKC,W 107-86,240,40,91,.440,26,44,.591,14,47,.298,13,15,.867,107,34,91,.374,27,56,.482,7,35,.200,11,18,.611,86
803,CHI,2022-04-05,106,,MIL,L 106-127,240,42,98,.429,33,65,.508,9,33,.273,13,13,1.000,106,46,87,.529,34,52,.654,12,35,.343,23,25,.920,127
804,POR,2022-03-25,106,,HOU,L 106-125,240,43,85,.506,40,65,.615,3,20,.150,17,23,.739,106,43,83,.518,24,38,.632,19,45,.422,20,23,.870,125
805,CHO,2022-03-23,106,,NYK,L 106-121,240,42,89,.472,29,43,.674,13,46,.283,9,17,.529,106,43,83,.518,23,38,.605,20,45,.444,15,17,.882,121
806,CHO,2022-03-21,106,,NOP,W 106-103,240,40,79,.506,27,42,.643,13,37,.351,13,15,.867,106,40,90,.444,31,66,.470,9,24,.375,14,16,.875,103
807,TOR,2022-03-03,106,,DET,L 106-108,240,36,83,.434,29,57,.509,7,26,.269,27,36,.750,106,38,84,.452,27,47,.574,11,37,.297,21,28,.750,108
808,BRK,2022-02-24,106,,BOS,L 106-129,240,39,94,.415,32,65,.492,7,29,.241,21,28,.750,106,46,85,.541,29,43,.674,17,42,.405,20,27,.741,129
809,DET,2022-02-24,106,,CLE,W 106-103,240,35,86,.407,24,52,.462,11,34,.324,25,28,.893,106,34,77,.442,22,42,.524,12,35,.343,23,34,.676,103
810,LAL,2022-02-16,106,,UTA,W 106-101,240,41,86,.477,31,50,.620,10,36,.278,14,22,.636,106,37,79,.468,26,46,.565,11,33,.333,16,19,.842,101
811,NYK,2022-02-16,106,,BRK,L 106-111,240,37,85,.435,21,42,.500,16,43,.372,16,18,.889,106,43,98,.439,32,64,.500,11,34,.324,14,23,.609,111
812,OKC,2022-02-16,106,,SAS,L 106-114,240,41,105,.390,30,73,.411,11,32,.344,13,19,.684,106,43,98,.439,33,64,.516,10,34,.294,18,22,.818,114
813,CHI,2022-02-12,106,,OKC,W 106-101,240,40,89,.449,33,64,.516,7,25,.280,19,23,.826,106,34,88,.386,23,52,.442,11,36,.306,22,30,.733,101
814,LAC,2022-01-09,106,,ATL,W 106-93,240,44,92,.478,32,59,.542,12,33,.364,6,7,.857,106,35,78,.449,28,52,.538,7,26,.269,16,19,.842,93
815,HOU,2022-01-07,106,,DAL,L 106-130,240,37,87,.425,25,44,.568,12,43,.279,20,29,.690,106,49,90,.544,32,52,.615,17,38,.447,15,28,.536,130
816,PHO,2022-01-06,106,,LAC,W 106-89,240,44,107,.411,34,76,.447,10,31,.323,8,10,.800,106,31,86,.360,25,58,.431,6,28,.214,21,25,.840,89
817,ORL,2022-01-05,106,,PHI,L 106-116,240,40,90,.444,28,51,.549,12,39,.308,14,20,.700,106,43,85,.506,31,57,.544,12,28,.429,18,24,.750,116
818,CLE,2022-01-04,106,,MEM,L 106-110,240,40,92,.435,30,58,.517,10,34,.294,16,21,.762,106,42,90,.467,33,63,.524,9,27,.333,17,22,.773,110
819,MIL,2022-01-03,106,,DET,L 106-115,240,39,92,.424,28,46,.609,11,46,.239,17,22,.773,106,44,91,.484,26,48,.542,18,43,.419,9,14,.643,115
820,IND,2021-12-31,106,,CHI,L 106-108,240,38,91,.418,30,60,.500,8,31,.258,22,29,.759,106,35,86,.407,23,59,.390,12,27,.444,26,30,.867,108
821,LAL,2021-12-12,106,,ORL,W 106-94,240,41,84,.488,28,56,.500,13,28,.464,11,17,.647,106,33,88,.375,20,50,.400,13,38,.342,15,19,.789,94
822,LAC,2021-12-11,106,,ORL,W 106-104,240,42,92,.457,24,56,.429,18,36,.500,4,6,.667,106,35,80,.438,23,47,.489,12,33,.364,22,24,.917,104
823,MIN,2021-12-10,106,,CLE,L 106-123,240,36,92,.391,25,53,.472,11,39,.282,23,28,.821,106,46,85,.541,33,52,.635,13,33,.394,18,22,.818,123
824,IND,2021-12-10,106,,DAL,W 106-93,240,41,87,.471,28,51,.549,13,36,.361,11,12,.917,106,39,84,.464,35,55,.636,4,29,.138,11,12,.917,93
825,CHO,2021-12-08,106,,PHI,L 106-110,240,39,80,.488,29,51,.569,10,29,.345,18,21,.857,106,36,75,.480,23,41,.561,13,34,.382,25,30,.833,110
826,SAS,2021-11-24,106,,ATL,L 106-124,240,43,100,.430,31,67,.463,12,33,.364,8,10,.800,106,45,88,.511,33,62,.532,12,26,.462,22,24,.917,124
827,NYK,2021-11-23,106,,LAL,W 106-100,240,37,82,.451,22,48,.458,15,34,.441,17,21,.810,106,34,91,.374,23,55,.418,11,36,.306,21,30,.700,100
828,NYK,2021-11-20,106,,HOU,W 106-99,240,33,78,.423,15,37,.405,18,41,.439,22,26,.846,106,38,84,.452,28,45,.622,10,39,.256,13,22,.591,99
829,LAC,2021-11-16,106,,SAS,W 106-92,240,37,85,.435,25,47,.532,12,38,.316,20,22,.909,106,41,95,.432,36,73,.493,5,22,.227,5,7,.714,92
830,CHO,2021-11-14,106,,GSW,W 106-102,240,42,88,.477,28,52,.538,14,36,.389,8,12,.667,106,38,90,.422,29,51,.569,9,39,.231,17,25,.680,102
831,MEM,2021-11-01,106,,DEN,W 106-97,240,44,97,.454,31,63,.492,13,34,.382,5,7,.714,106,39,88,.443,30,50,.600,9,38,.237,10,15,.667,97
832,DEN,2021-10-29,106,,DAL,W 106-75,240,43,83,.518,32,47,.681,11,36,.306,9,13,.692,106,23,78,.295,15,41,.366,8,37,.216,21,27,.778,75
833,NYK,2022-04-10,105,,TOR,W 105-94,240,40,87,.460,25,44,.568,15,43,.349,10,12,.833,105,36,92,.391,24,50,.480,12,42,.286,10,11,.909,94
834,UTA,2022-04-08,105,,PHO,L 105-111,240,35,88,.398,24,50,.480,11,38,.289,24,33,.727,105,46,92,.500,40,73,.548,6,19,.316,13,15,.867,111
835,MIA,2022-03-15,105,,DET,W 105-98,240,29,72,.403,17,39,.436,12,33,.364,35,39,.897,105,37,80,.463,27,46,.587,10,34,.294,14,22,.636,98
836,BOS,2022-02-13,105,,ATL,W 105-95,240,36,85,.424,25,47,.532,11,38,.289,22,27,.815,105,34,93,.366,22,55,.400,12,38,.316,15,15,1.000,95
837,CLE,2022-02-09,105,,SAS,W 105-92,240,39,82,.476,30,61,.492,9,21,.429,18,24,.750,105,38,99,.384,30,66,.455,8,33,.242,8,11,.727,92
838,DEN,2022-02-04,105,,NOP,L 105-113,240,35,78,.449,16,37,.432,19,41,.463,16,17,.941,105,42,75,.560,34,50,.680,8,25,.320,21,23,.913,113
839,NOP,2022-01-28,105,,DEN,L 105-116,240,35,90,.389,30,56,.536,5,34,.147,30,33,.909,105,41,82,.500,29,49,.592,12,33,.364,22,25,.880,116
840,PHI,2022-01-27,105,,LAL,W 105-87,240,41,82,.500,28,47,.596,13,35,.371,10,17,.588,105,36,88,.409,30,59,.508,6,29,.207,9,9,1.000,87
841,DET,2022-01-25,105,,DEN,L 105-110,240,41,97,.423,29,61,.475,12,36,.333,11,14,.786,105,36,84,.429,25,52,.481,11,32,.344,27,31,.871,110
842,TOR,2022-01-23,105,,POR,L 105-114,240,39,98,.398,21,44,.477,18,54,.333,9,14,.643,105,45,85,.529,27,53,.509,18,32,.563,6,13,.462,114
843,ORL,2022-01-21,105,,LAL,L 105-116,240,36,81,.444,25,41,.610,11,40,.275,22,29,.759,105,42,85,.494,29,55,.527,13,30,.433,19,23,.826,116
844,BOS,2022-01-21,105,,POR,L 105-109,240,37,82,.451,26,45,.578,11,37,.297,20,23,.870,105,36,76,.474,20,43,.465,16,33,.485,21,30,.700,109
845,WAS,2022-01-21,105,,TOR,L 105-109,240,43,85,.506,32,52,.615,11,33,.333,8,10,.800,105,42,90,.467,31,60,.517,11,30,.367,14,17,.824,109
846,GSW,2022-01-21,105,,HOU,W 105-103,240,39,81,.481,29,51,.569,10,30,.333,17,22,.773,105,38,89,.427,28,54,.519,10,35,.286,17,20,.850,103
847,TOR,2022-01-09,105,,NOP,W 105-101,240,36,85,.424,22,51,.431,14,34,.412,19,20,.950,105,34,75,.453,22,42,.524,12,33,.364,21,25,.840,101
848,OKC,2022-01-07,105,,MIN,L 105-135,240,36,89,.404,21,45,.467,15,44,.341,18,23,.783,105,50,90,.556,33,49,.673,17,41,.415,18,25,.720,135
849,POR,2021-12-29,105,,UTA,L 105-120,240,37,88,.420,23,48,.479,14,40,.350,17,24,.708,105,46,87,.529,38,58,.655,8,29,.276,20,32,.625,120
850,NYK,2021-12-21,105,,DET,W 105-91,240,40,90,.444,29,57,.509,11,33,.333,14,19,.737,105,34,94,.362,26,61,.426,8,33,.242,15,19,.789,91
851,ORL,2021-12-17,105,,MIA,L 105-115,240,43,89,.483,32,57,.561,11,32,.344,8,10,.800,105,41,82,.500,22,47,.468,19,35,.543,14,19,.737,115
852,SAC,2021-12-17,105,,MEM,L 105-124,240,36,88,.409,23,53,.434,13,35,.371,20,26,.769,105,45,97,.464,32,73,.438,13,24,.542,21,27,.778,124
853,CLE,2021-12-13,105,,MIA,W 105-94,240,36,81,.444,20,45,.444,16,36,.444,17,18,.944,105,38,85,.447,25,45,.556,13,40,.325,5,9,.556,94
854,ATL,2021-12-10,105,,BRK,L 105-113,240,37,94,.394,26,60,.433,11,34,.324,20,24,.833,105,46,93,.495,40,70,.571,6,23,.261,15,16,.938,113
855,CLE,2021-11-27,105,,ORL,W 105-92,240,41,90,.456,27,51,.529,14,39,.359,9,12,.750,105,35,88,.398,27,56,.482,8,32,.250,14,23,.609,92
856,SAC,2021-11-20,105,,UTA,L 105-123,240,41,91,.451,31,60,.517,10,31,.323,13,21,.619,105,46,91,.505,29,52,.558,17,39,.436,14,17,.824,123
857,PHO,2021-11-17,105,,DAL,W 105-98,240,41,93,.441,28,54,.519,13,39,.333,10,14,.714,105,38,91,.418,22,59,.373,16,32,.500,6,6,1.000,98
858,WAS,2021-11-15,105,,NOP,W 105-100,240,39,84,.464,29,56,.518,10,28,.357,17,25,.680,105,30,74,.405,19,53,.358,11,21,.524,29,34,.853,100
859,UTA,2021-11-13,105,,MIA,L 105-111,240,35,85,.412,18,32,.563,17,53,.321,18,25,.720,105,42,85,.494,29,52,.558,13,33,.394,14,16,.875,111
860,DEN,2021-11-12,105,,ATL,W 105-96,240,40,90,.444,30,55,.545,10,35,.286,15,20,.750,105,38,93,.409,33,65,.508,5,28,.179,15,21,.714,96
861,OKC,2021-11-12,105,,SAC,W 105-103,240,42,99,.424,32,69,.464,10,30,.333,11,15,.733,105,38,95,.400,24,54,.444,14,41,.341,13,17,.765,103
862,POR,2021-11-06,105,,LAL,W 105-90,240,36,95,.379,21,40,.525,15,55,.273,18,24,.750,105,31,90,.344,22,58,.379,9,32,.281,19,24,.792,90
863,CHI,2021-11-06,105,,PHI,L 105-114,240,37,92,.402,30,63,.476,7,29,.241,24,30,.800,105,43,81,.531,30,55,.545,13,26,.500,15,19,.789,114
864,DAL,2021-10-31,105,,SAC,W 105-99,240,40,90,.444,28,53,.528,12,37,.324,13,20,.650,105,38,96,.396,31,60,.517,7,36,.194,16,20,.800,99
865,BRK,2021-10-29,105,,IND,W 105-98,240,34,76,.447,28,50,.560,6,26,.231,31,41,.756,105,37,93,.398,29,64,.453,8,29,.276,16,23,.696,98
866,LAL,2021-10-22,105,,PHO,L 105-115,240,34,86,.395,19,52,.365,15,34,.441,22,29,.759,105,42,86,.488,32,54,.593,10,32,.313,21,28,.750,115
867,MIA,2022-03-23,104,,GSW,L 104-118,240,37,85,.435,23,49,.469,14,36,.389,16,21,.762,104,40,77,.519,25,41,.610,15,36,.417,23,27,.852,118
868,DEN,2022-03-20,104,,BOS,L 104-124,240,35,87,.402,21,48,.438,14,39,.359,20,25,.800,104,47,82,.573,28,42,.667,19,40,.475,11,11,1.000,124
869,MIA,2022-03-12,104,,MIN,L 104-113,240,35,88,.398,20,43,.465,15,45,.333,19,25,.760,104,35,83,.422,20,41,.488,15,42,.357,28,32,.875,113
870,SAS,2022-03-11,104,,UTA,W 104-102,240,34,85,.400,28,56,.500,6,29,.207,30,43,.698,104,37,92,.402,24,52,.462,13,40,.325,15,23,.652,102
871,SAS,2022-03-09,104,,TOR,L 104-119,240,38,84,.452,29,52,.558,9,32,.281,19,20,.950,104,41,85,.482,30,55,.545,11,30,.367,26,28,.929,119
872,CLE,2022-03-06,104,,TOR,W 104-96,240,39,85,.459,28,49,.571,11,36,.306,15,23,.652,104,37,94,.394,31,70,.443,6,24,.250,16,26,.615,96
873,LAL,2022-03-01,104,,DAL,L 104-109,240,37,82,.451,23,48,.479,14,34,.412,16,20,.800,104,41,82,.500,31,47,.660,10,35,.286,17,27,.630,109
874,DET,2022-02-26,104,,BOS,L 104-113,240,39,87,.448,32,60,.533,7,27,.259,19,22,.864,104,42,88,.477,32,62,.516,10,26,.385,19,21,.905,113
875,OKC,2022-02-24,104,,PHO,L 104-124,240,44,93,.473,38,62,.613,6,31,.194,10,11,.909,104,46,86,.535,33,52,.635,13,34,.382,19,21,.905,124
876,HOU,2022-01-25,104,,SAS,L 104-134,240,39,95,.411,30,61,.492,9,34,.265,17,25,.680,104,58,101,.574,46,69,.667,12,32,.375,6,6,1.000,134
877,DAL,2022-01-23,104,,MEM,W 104-91,240,36,74,.486,27,44,.614,9,30,.300,23,31,.742,104,37,99,.374,33,75,.440,4,24,.167,13,19,.684,91
878,LAL,2022-01-19,104,,IND,L 104-111,240,40,90,.444,29,56,.518,11,34,.324,13,18,.722,104,44,90,.489,33,60,.550,11,30,.367,12,15,.800,111
879,MIA,2022-01-19,104,,POR,W 104-92,240,37,80,.463,25,45,.556,12,35,.343,18,25,.720,104,33,81,.407,19,35,.543,14,46,.304,12,16,.750,92
880,MIA,2022-01-17,104,,TOR,W 104-99,240,38,83,.458,29,59,.492,9,24,.375,19,22,.864,104,37,90,.411,24,54,.444,13,36,.361,12,17,.706,99
881,BOS,2022-01-17,104,,NOP,W 104-92,240,38,80,.475,28,48,.583,10,32,.313,18,20,.900,104,36,87,.414,27,57,.474,9,30,.300,11,18,.611,92
882,DAL,2022-01-17,104,,OKC,W 104-102,240,35,88,.398,23,51,.451,12,37,.324,22,28,.786,104,36,83,.434,25,48,.521,11,35,.314,19,24,.792,102
883,NYK,2022-01-04,104,,IND,W 104-94,240,39,80,.488,33,52,.635,6,28,.214,20,28,.714,104,32,76,.421,23,38,.605,9,38,.237,21,32,.656,94
884,LAC,2022-01-03,104,,MIN,L 104-122,240,39,78,.500,28,46,.609,11,32,.344,15,17,.882,104,49,93,.527,33,48,.688,16,45,.356,8,9,.889,122
885,NOP,2022-01-03,104,,UTA,L 104-115,240,39,97,.402,27,51,.529,12,46,.261,14,22,.636,104,41,85,.482,22,46,.478,19,39,.487,14,17,.824,115
886,BRK,2022-01-03,104,,MEM,L 104-118,240,37,82,.451,28,51,.549,9,31,.290,21,26,.808,104,48,102,.471,38,67,.567,10,35,.286,12,21,.571,118
887,MEM,2021-12-29,104,,LAL,W 104-99,240,35,85,.412,25,55,.455,10,30,.333,24,29,.828,104,39,86,.453,24,45,.533,15,41,.366,6,8,.750,99
888,SAS,2021-12-27,104,,UTA,L 104-110,240,45,100,.450,35,70,.500,10,30,.333,4,9,.444,104,39,86,.453,30,55,.545,9,31,.290,23,30,.767,110
889,ORL,2021-12-23,104,,NOP,L 104-110,240,38,88,.432,29,56,.518,9,32,.281,19,21,.905,104,37,86,.430,24,56,.429,13,30,.433,23,26,.885,110
890,OKC,2021-12-18,104,,LAC,W 104-103,240,43,92,.467,31,61,.508,12,31,.387,6,10,.600,104,37,83,.446,21,44,.477,16,39,.410,13,19,.684,103
891,DAL,2021-12-15,104,,LAL,L 104-107 (OT),265,39,98,.398,27,54,.500,12,44,.273,14,17,.824,104,39,90,.433,24,51,.471,15,39,.385,14,18,.778,107
892,DET,2021-12-12,104,,BRK,L 104-116,240,39,92,.424,25,55,.455,14,37,.378,12,18,.667,104,41,87,.471,30,59,.508,11,28,.393,23,25,.920,116
893,MIN,2021-12-08,104,,UTA,L 104-136,240,38,95,.400,21,48,.438,17,47,.362,11,17,.647,104,50,88,.568,25,34,.735,25,54,.463,11,15,.733,136
894,GSW,2021-12-08,104,,POR,W 104-94,240,33,83,.398,19,37,.514,14,46,.304,24,31,.774,104,33,80,.413,25,50,.500,8,30,.267,20,28,.714,94
895,SAC,2021-12-04,104,,LAC,W 104-99,240,36,86,.419,24,52,.462,12,34,.353,20,25,.800,104,34,89,.382,21,55,.382,13,34,.382,18,27,.667,99
896,IND,2021-12-03,104,,MIA,L 104-113,240,35,80,.438,26,44,.591,9,36,.250,25,33,.758,104,43,81,.531,27,47,.574,16,34,.471,11,13,.846,113
897,PHO,2021-11-30,104,,GSW,W 104-96,240,43,87,.494,31,57,.544,12,30,.400,6,11,.545,104,36,86,.419,22,46,.478,14,40,.350,10,14,.714,96
898,LAC,2021-11-29,104,,NOP,L 104-123,240,37,72,.514,23,36,.639,14,36,.389,16,21,.762,104,48,94,.511,34,59,.576,14,35,.400,13,16,.813,123
899,CHI,2021-11-27,104,,MIA,L 104-107,240,38,81,.469,27,42,.643,11,39,.282,17,21,.810,104,37,86,.430,23,46,.500,14,40,.350,19,22,.864,107
900,BOS,2021-11-24,104,,BRK,L 104-123,240,34,91,.374,23,43,.535,11,48,.229,25,28,.893,104,43,85,.506,29,50,.580,14,35,.400,23,30,.767,123
901,OKC,2021-11-24,104,,UTA,L 104-110,240,37,82,.451,22,46,.478,15,36,.417,15,22,.682,104,39,86,.453,24,39,.615,15,47,.319,17,20,.850,110
902,LAC,2021-11-23,104,,DAL,L 104-112 (OT),265,35,85,.412,25,53,.472,10,32,.313,24,29,.828,104,39,89,.438,27,50,.540,12,39,.308,22,27,.815,112
903,CHO,2021-11-12,104,,NYK,W 104-96,240,39,90,.433,29,54,.537,10,36,.278,16,24,.667,104,36,93,.387,23,58,.397,13,35,.371,11,18,.611,96
904,HOU,2021-11-10,104,,DET,L 104-112,240,35,82,.427,23,48,.479,12,34,.353,22,34,.647,104,42,97,.433,26,49,.531,16,48,.333,12,18,.667,112
905,BOS,2021-11-10,104,,TOR,W 104-88,240,42,94,.447,32,65,.492,10,29,.345,10,15,.667,104,33,77,.429,27,52,.519,6,25,.240,16,19,.842,88
906,SAC,2021-11-08,104,,PHO,L 104-109,240,37,82,.451,27,58,.466,10,24,.417,20,26,.769,104,44,93,.473,32,63,.508,12,30,.400,9,11,.818,109
907,LAL,2021-11-04,104,,OKC,L 104-107,240,39,94,.415,27,61,.443,12,33,.364,14,17,.824,104,37,87,.425,22,46,.478,15,41,.366,18,26,.692,107
908,NYK,2021-11-01,104,,TOR,L 104-113,240,35,76,.461,19,38,.500,16,38,.421,18,24,.750,104,43,99,.434,29,57,.509,14,42,.333,13,14,.929,113
909,DAL,2021-10-28,104,,SAS,W 104-99,240,41,89,.461,23,44,.523,18,45,.400,4,13,.308,104,39,88,.443,27,58,.466,12,30,.400,9,15,.600,99
910,BRK,2021-10-25,104,,WAS,W 104-90,240,40,94,.426,30,59,.508,10,35,.286,14,17,.824,104,33,95,.347,24,56,.429,9,39,.231,15,20,.750,90
911,NYK,2021-10-24,104,,ORL,L 104-110,240,37,100,.370,24,52,.462,13,48,.271,17,25,.680,104,36,88,.409,24,45,.533,12,43,.279,26,34,.765,110
912,GSW,2022-03-30,103,,PHO,L 103-107,240,35,83,.422,22,45,.489,13,38,.342,20,25,.800,103,38,92,.413,31,64,.484,7,28,.250,24,30,.800,107
913,NOP,2022-03-26,103,,SAS,L 103-107,240,40,90,.444,30,58,.517,10,32,.313,13,19,.684,103,39,92,.424,32,66,.485,7,26,.269,22,25,.880,107
914,MIA,2022-03-25,103,,NYK,L 103-111,240,35,70,.500,23,37,.622,12,33,.364,21,25,.840,103,36,82,.439,19,32,.594,17,50,.340,22,28,.786,111
915,LAL,2022-03-14,103,,TOR,L 103-114,240,34,87,.391,21,45,.467,13,42,.310,22,29,.759,103,39,96,.406,29,59,.492,10,37,.270,26,36,.722,114
916,OKC,2022-03-06,103,,UTA,L 103-116,240,39,92,.424,31,52,.596,8,40,.200,17,19,.895,103,40,89,.449,17,37,.459,23,52,.442,13,17,.765,116
917,BRK,2022-02-17,103,,WAS,L 103-117,240,36,89,.404,22,51,.431,14,38,.368,17,24,.708,103,46,83,.554,34,59,.576,12,24,.500,13,16,.813,117
918,PHO,2022-02-15,103,,LAC,W 103-96,240,44,90,.489,36,65,.554,8,25,.320,7,10,.700,103,40,97,.412,30,62,.484,10,35,.286,6,9,.667,96
919,WAS,2022-02-14,103,,DET,W 103-94,240,40,85,.471,31,56,.554,9,29,.310,14,18,.778,103,32,85,.376,24,62,.387,8,23,.348,22,27,.815,94
920,PHI,2022-02-12,103,,CLE,W 103-93,240,38,79,.481,28,57,.491,10,22,.455,17,21,.810,103,36,77,.468,28,53,.528,8,24,.333,13,15,.867,93
921,DAL,2022-02-06,103,,ATL,W 103-94,240,38,88,.432,22,52,.423,16,36,.444,11,13,.846,103,37,95,.389,32,70,.457,5,25,.200,15,16,.938,94
922,PHI,2022-02-02,103,,WAS,L 103-106,240,41,91,.451,30,64,.469,11,27,.407,10,13,.769,103,41,90,.456,32,68,.471,9,22,.409,15,19,.789,106
923,PHI,2022-01-29,103,,SAC,W 103-101,240,36,70,.514,24,40,.600,12,30,.400,19,26,.731,103,36,82,.439,24,47,.511,12,35,.343,17,20,.850,101
924,DET,2022-01-14,103,,TOR,W 103-87,240,38,81,.469,30,54,.556,8,27,.296,19,23,.826,103,28,87,.322,17,49,.347,11,38,.289,20,26,.769,87
925,CHO,2022-01-10,103,,MIL,W 103-99,240,38,96,.396,25,52,.481,13,44,.295,14,16,.875,103,37,84,.440,24,41,.585,13,43,.302,12,16,.750,99
926,POR,2022-01-09,103,,SAC,W 103-88,240,37,88,.420,20,48,.417,17,40,.425,12,15,.800,103,33,85,.388,26,54,.481,7,31,.226,15,21,.714,88
927,DAL,2022-01-03,103,,DEN,W 103-89,240,35,78,.449,21,41,.512,14,37,.378,19,21,.905,103,31,67,.463,25,42,.595,6,25,.240,21,29,.724,89
928,BOS,2021-12-20,103,,PHI,L 103-108,240,38,82,.463,31,55,.564,7,27,.259,20,25,.800,103,36,72,.500,26,47,.553,10,25,.400,26,31,.839,108
929,UTA,2021-12-18,103,,WAS,L 103-109,240,35,81,.432,21,37,.568,14,44,.318,19,30,.633,103,42,94,.447,33,63,.524,9,31,.290,16,20,.800,109
930,HOU,2021-12-16,103,,NYK,L 103-116,240,34,68,.500,23,36,.639,11,32,.344,24,30,.800,103,39,83,.470,22,47,.468,17,36,.472,21,25,.840,116
931,POR,2021-12-15,103,,MEM,L 103-113,240,31,82,.378,16,44,.364,15,38,.395,26,28,.929,103,39,82,.476,28,50,.560,11,32,.344,24,30,.800,113
932,DET,2021-12-06,103,,OKC,L 103-114,240,41,99,.414,25,58,.431,16,41,.390,5,6,.833,103,41,82,.500,32,57,.561,9,25,.360,23,30,.767,114
933,WAS,2021-11-22,103,,CHO,L 103-109,240,36,94,.383,27,57,.474,9,37,.243,22,27,.815,103,40,91,.440,25,60,.417,15,31,.484,14,24,.583,109
934,WAS,2021-11-20,103,,MIA,W 103-100,240,36,74,.486,25,44,.568,11,30,.367,20,23,.870,103,38,81,.469,31,54,.574,7,27,.259,17,20,.850,100
935,LAL,2021-11-15,103,,CHI,L 103-121,240,36,79,.456,30,47,.638,6,32,.188,25,31,.806,103,49,89,.551,34,55,.618,15,34,.441,8,11,.727,121
936,TOR,2021-11-07,103,,BRK,L 103-116,240,41,87,.471,34,57,.596,7,30,.233,14,18,.778,103,41,80,.513,24,42,.571,17,38,.447,17,20,.850,116
937,PHI,2021-11-03,103,,CHI,W 103-98,240,38,77,.494,26,49,.531,12,28,.429,15,21,.714,103,38,82,.463,32,61,.525,6,21,.286,16,18,.889,98
938,MEM,2021-10-30,103,,MIA,L 103-129,240,34,88,.386,18,38,.474,16,50,.320,19,21,.905,103,46,88,.523,25,51,.490,21,37,.568,16,19,.842,129
939,GSW,2021-10-30,103,,OKC,W 103-82,240,39,92,.424,18,38,.474,21,54,.389,4,8,.500,103,29,83,.349,21,44,.477,8,39,.205,16,21,.762,82
940,CHI,2021-10-28,103,,NYK,L 103-104,240,36,84,.429,25,52,.481,11,32,.344,20,22,.909,103,39,85,.459,28,56,.500,11,29,.379,15,20,.750,104
941,OKC,2021-10-24,103,,PHI,L 103-115,240,40,84,.476,32,53,.604,8,31,.258,15,19,.789,103,41,88,.466,24,47,.511,17,41,.415,16,20,.800,115
942,DET,2022-03-31,102,,PHI,W 102-94,240,41,82,.500,31,47,.660,10,35,.286,10,15,.667,102,31,69,.449,24,43,.558,7,26,.269,25,28,.893,94
943,DET,2022-03-27,102,,NYK,L 102-104,240,39,85,.459,31,56,.554,8,29,.276,16,18,.889,102,34,85,.400,21,44,.477,13,41,.317,23,29,.793,104
944,IND,2022-03-15,102,,MEM,L 102-135,240,41,98,.418,35,68,.515,6,30,.200,14,19,.737,102,54,105,.514,39,65,.600,15,40,.375,12,20,.600,135
945,DET,2022-03-13,102,,LAC,L 102-106,240,36,80,.450,24,51,.471,12,29,.414,18,20,.900,102,40,89,.449,30,59,.508,10,30,.333,16,20,.800,106
946,DEN,2022-03-10,102,,GSW,L 102-113,240,35,84,.417,28,53,.528,7,31,.226,25,32,.781,102,42,88,.477,28,46,.609,14,42,.333,15,20,.750,113
947,NOP,2022-03-09,102,,ORL,L 102-108,240,41,93,.441,34,62,.548,7,31,.226,13,18,.722,102,36,76,.474,22,39,.564,14,37,.378,22,26,.846,108
948,LAL,2022-02-25,102,,LAC,L 102-105,240,39,93,.419,31,62,.500,8,31,.258,16,21,.762,102,41,83,.494,31,57,.544,10,26,.385,13,19,.684,105
949,MIN,2022-02-25,102,,PHI,L 102-133,240,36,86,.419,27,47,.574,9,39,.231,21,25,.840,102,42,82,.512,23,43,.535,19,39,.487,30,36,.833,133
950,PHO,2022-02-25,102,,NOP,L 102-117,240,36,82,.439,24,42,.571,12,40,.300,18,24,.750,102,38,87,.437,30,58,.517,8,29,.276,33,41,.805,117
951,ORL,2022-01-26,102,,LAC,L 102-111,240,38,84,.452,29,49,.592,9,35,.257,17,22,.773,102,36,81,.444,21,52,.404,15,29,.517,24,27,.889,111
952,SAS,2022-01-21,102,,BRK,L 102-117,240,37,95,.389,29,66,.439,8,29,.276,20,24,.833,102,48,100,.480,39,75,.520,9,25,.360,12,12,1.000,117
953,BOS,2022-01-19,102,,CHO,L 102-111,240,39,90,.433,25,44,.568,14,46,.304,10,13,.769,102,42,86,.488,26,47,.553,16,39,.410,11,15,.733,111
954,DAL,2022-01-19,102,,TOR,W 102-98,240,37,76,.487,28,43,.651,9,33,.273,19,20,.950,102,35,91,.385,27,59,.458,8,32,.250,20,25,.800,98
955,GSW,2022-01-18,102,,DET,W 102-86,240,34,83,.410,20,41,.488,14,42,.333,20,27,.741,102,30,85,.353,21,51,.412,9,34,.265,17,24,.708,86
956,DEN,2022-01-16,102,,UTA,L 102-125,240,42,95,.442,31,52,.596,11,43,.256,7,8,.875,102,44,84,.524,29,45,.644,15,39,.385,22,29,.759,125
957,OKC,2022-01-15,102,,CLE,L 102-107,240,36,83,.434,26,56,.464,10,27,.370,20,22,.909,102,40,87,.460,31,52,.596,9,35,.257,18,25,.720,107
958,SAC,2022-01-05,102,,ATL,L 102-108,240,38,90,.422,27,63,.429,11,27,.407,15,20,.750,102,39,86,.453,31,56,.554,8,30,.267,22,30,.733,108
959,CHI,2022-01-03,102,,ORL,W 102-98,240,37,86,.430,26,55,.473,11,31,.355,17,23,.739,102,36,85,.424,26,58,.448,10,27,.370,16,18,.889,98
960,BRK,2021-12-30,102,,PHI,L 102-110,240,37,81,.457,30,54,.556,7,27,.259,21,27,.778,102,42,100,.420,29,68,.426,13,32,.406,13,20,.650,110
961,SAC,2021-12-26,102,,MEM,L 102-127,240,34,81,.420,24,52,.462,10,29,.345,24,27,.889,102,47,100,.470,38,70,.543,9,30,.300,24,30,.800,127
962,PHI,2021-12-11,102,,GSW,W 102-93,240,35,76,.461,26,49,.531,9,27,.333,23,26,.885,102,34,85,.400,22,37,.595,12,48,.250,13,18,.722,93
963,TOR,2021-12-05,102,,WAS,W 102-90,240,38,85,.447,30,62,.484,8,23,.348,18,24,.750,102,30,73,.411,22,48,.458,8,25,.320,22,29,.759,90
964,HOU,2021-11-29,102,,OKC,W 102-89,240,40,96,.417,25,50,.500,15,46,.326,7,11,.636,102,31,87,.356,24,44,.545,7,43,.163,20,26,.769,89
965,DET,2021-11-19,102,,GSW,L 102-105,240,32,80,.400,18,38,.474,14,42,.333,24,30,.800,102,38,80,.475,26,50,.520,12,30,.400,17,21,.810,105
966,IND,2021-10-23,102,,MIA,W 102-91 (OT),265,38,97,.392,28,58,.483,10,39,.256,16,21,.762,102,35,91,.385,26,58,.448,9,33,.273,12,14,.857,91
967,DEN,2021-10-22,102,,SAS,W 102-96,240,44,86,.512,35,56,.625,9,30,.300,5,8,.625,102,40,84,.476,34,60,.567,6,24,.250,10,14,.714,96
968,DET,2022-04-08,101,,MIL,L 101-131,240,35,90,.389,25,42,.595,10,48,.208,21,23,.913,101,50,101,.495,39,64,.609,11,37,.297,20,23,.870,131
969,NYK,2022-04-02,101,,CLE,L 101-119,240,31,77,.403,18,47,.383,13,30,.433,26,34,.765,101,44,81,.543,29,47,.617,15,34,.441,16,21,.762,119
970,OKC,2022-04-01,101,,DET,L 101-110,240,36,84,.429,25,50,.500,11,34,.324,18,29,.621,101,40,94,.426,25,46,.543,15,48,.313,15,18,.833,110
971,CHI,2022-03-12,101,,CLE,W 101-91,240,39,88,.443,30,67,.448,9,21,.429,14,15,.933,101,36,86,.419,31,62,.500,5,24,.208,14,17,.824,91
972,CHO,2022-03-09,101,,BOS,L 101-115,240,36,85,.424,28,52,.538,8,33,.242,21,28,.750,101,46,93,.495,34,56,.607,12,37,.324,11,14,.786,115
973,OKC,2022-03-04,101,,MIN,L 101-138,240,37,86,.430,28,51,.549,9,35,.257,18,21,.857,101,49,91,.538,27,44,.614,22,47,.468,18,23,.783,138
974,GSW,2022-02-27,101,,DAL,L 101-107,240,39,91,.429,28,52,.538,11,39,.282,12,20,.600,101,39,78,.500,26,44,.591,13,34,.382,16,20,.800,107
975,CHO,2022-02-07,101,,TOR,L 101-116,240,39,95,.411,30,55,.545,9,40,.225,14,16,.875,101,41,84,.488,26,49,.531,15,35,.429,19,29,.655,116
976,CHO,2022-02-04,101,,CLE,L 101-102,240,38,92,.413,24,49,.490,14,43,.326,11,12,.917,101,36,90,.400,22,55,.400,14,35,.400,16,20,.800,102
977,DET,2022-02-01,101,,NOP,L 101-111,240,41,84,.488,33,52,.635,8,32,.250,11,14,.786,101,39,89,.438,31,61,.508,8,28,.286,25,28,.893,111
978,PHI,2022-01-21,101,,LAC,L 101-102,240,38,91,.418,28,63,.444,10,28,.357,15,21,.714,101,40,87,.460,29,55,.527,11,32,.344,11,15,.733,102
979,DAL,2022-01-20,101,,PHO,L 101-109,240,37,85,.435,26,48,.542,11,37,.297,16,20,.800,101,39,86,.453,31,50,.620,8,36,.222,23,25,.920,109
980,LAL,2022-01-17,101,,UTA,W 101-95,240,38,86,.442,27,49,.551,11,37,.297,14,23,.609,101,31,83,.373,19,37,.514,12,46,.261,21,24,.875,95
981,SAS,2022-01-15,101,,LAC,W 101-94,240,34,83,.410,23,46,.500,11,37,.297,22,27,.815,101,38,100,.380,26,62,.419,12,38,.316,6,8,.750,94
982,BOS,2022-01-10,101,,IND,W 101-98 (OT),265,35,88,.398,27,60,.450,8,28,.286,23,28,.821,101,36,94,.383,25,57,.439,11,37,.297,15,17,.882,98
983,POR,2022-01-07,101,,CLE,L 101-114,240,37,92,.402,21,57,.368,16,35,.457,11,19,.579,101,39,80,.488,22,41,.537,17,39,.436,19,29,.655,114
984,NOP,2022-01-06,101,,GSW,W 101-96,240,35,83,.422,27,49,.551,8,34,.235,23,29,.793,101,37,87,.425,30,54,.556,7,33,.212,15,18,.833,96
985,NYK,2021-12-25,101,,ATL,W 101-87,240,38,85,.447,18,35,.514,20,50,.400,5,12,.417,101,33,87,.379,20,49,.408,13,38,.342,8,14,.571,87
986,WAS,2021-12-03,101,,CLE,L 101-116,240,38,82,.463,28,51,.549,10,31,.323,15,19,.789,101,42,89,.472,29,59,.492,13,30,.433,19,25,.760,116
987,PHI,2021-11-29,101,,ORL,W 101-96,240,39,97,.402,29,64,.453,10,33,.303,13,18,.722,101,37,90,.411,29,57,.509,8,33,.242,14,18,.778,96
988,OKC,2021-11-17,101,,HOU,W 101-89,240,41,92,.446,31,53,.585,10,39,.256,9,16,.563,101,32,90,.356,20,48,.417,12,42,.286,13,19,.684,89
989,DEN,2021-11-10,101,,IND,W 101-98,240,36,84,.429,24,54,.444,12,30,.400,17,20,.850,101,40,84,.476,29,53,.547,11,31,.355,7,11,.636,98
990,WAS,2021-11-07,101,,MIL,W 101-94,240,41,81,.506,30,54,.556,11,27,.407,8,13,.615,101,37,94,.394,27,58,.466,10,36,.278,10,18,.556,94
991,TOR,2021-11-05,101,,CLE,L 101-102,240,42,99,.424,30,72,.417,12,27,.444,5,9,.556,101,38,83,.458,28,53,.528,10,30,.333,16,19,.842,102
992,PHO,2021-10-30,101,,CLE,W 101-92,240,39,84,.464,33,58,.569,6,26,.231,17,27,.630,101,36,91,.396,22,47,.468,14,44,.318,6,7,.857,92
993,GSW,2021-10-28,101,,MEM,L 101-104 (OT),265,39,90,.433,25,50,.500,14,40,.350,9,12,.750,101,39,97,.402,27,49,.551,12,48,.250,14,14,1.000,104
994,CLE,2021-10-23,101,,ATL,W 101-95,240,37,89,.416,30,61,.492,7,28,.250,20,27,.741,101,38,99,.384,28,65,.431,10,34,.294,9,15,.600,95
995,SAC,2021-10-22,101,,UTA,L 101-110,240,39,99,.394,31,63,.492,8,36,.222,15,21,.714,101,37,90,.411,21,48,.438,16,42,.381,20,23,.870,110
996,NYK,2022-03-18,100,,WAS,W 100-97,240,31,90,.344,21,57,.368,10,33,.303,28,36,.778,100,34,79,.430,21,45,.467,13,34,.382,16,21,.762,97
997,LAC,2022-03-16,100,,TOR,L 100-103,240,38,78,.487,27,48,.563,11,30,.367,13,15,.867,100,38,83,.458,27,51,.529,11,32,.344,16,21,.762,103
998,HOU,2022-03-11,100,,DAL,L 100-113,240,41,86,.477,35,56,.625,6,30,.200,12,19,.632,100,40,88,.455,29,52,.558,11,36,.306,22,28,.786,113
999,PHI,2022-03-10,100,,BRK,L 100-129,240,30,93,.323,16,57,.281,14,36,.389,26,30,.867,100,51,91,.560,33,51,.647,18,40,.450,9,17,.529,129
1000,SAC,2022-03-09,100,,DEN,L 100-106,240,38,85,.447,26,51,.510,12,34,.353,12,18,.667,100,40,82,.488,31,47,.660,9,35,.257,17,19,.895,106
1001,HOU,2022-03-01,100,,LAC,L 100-113,240,38,96,.396,25,57,.439,13,39,.333,11,17,.647,100,42,96,.438,29,65,.446,13,31,.419,16,17,.941,113
1002,NYK,2022-02-25,100,,MIA,L 100-115,240,30,75,.400,16,35,.457,14,40,.350,26,36,.722,100,39,83,.470,28,51,.549,11,32,.344,26,35,.743,115
1003,PHI,2022-02-11,100,,OKC,W 100-87,240,36,93,.387,29,67,.433,7,26,.269,21,26,.808,100,35,90,.389,29,55,.527,6,35,.171,11,12,.917,87
1004,WAS,2022-02-07,100,,MIA,L 100-121,240,36,80,.450,29,49,.592,7,31,.226,21,23,.913,100,43,76,.566,25,44,.568,18,32,.563,17,21,.810,121
1005,ATL,2022-01-31,100,,TOR,L 100-106,240,37,81,.457,25,49,.510,12,32,.375,14,16,.875,100,38,89,.427,20,53,.377,18,36,.500,12,17,.706,106
1006,MIL,2022-01-30,100,,DEN,L 100-136,240,37,78,.474,27,48,.563,10,30,.333,16,22,.727,100,53,88,.602,30,45,.667,23,43,.535,7,10,.700,136
1007,IND,2022-01-12,100,,BOS,L 100-119,240,40,86,.465,33,50,.660,7,36,.194,13,20,.650,100,40,78,.513,22,40,.550,18,38,.474,21,25,.840,119
1008,ORL,2022-01-09,100,,WAS,L 100-102,240,38,95,.400,29,67,.433,9,28,.321,15,16,.938,100,36,88,.409,25,59,.424,11,29,.379,19,24,.792,102
1009,PHO,2022-01-08,100,,MIA,L 100-123,240,30,79,.380,16,45,.356,14,34,.412,26,29,.897,100,44,88,.500,22,44,.500,22,44,.500,13,15,.867,123
1010,LAC,2021-12-26,100,,DEN,L 100-103,240,40,86,.465,32,60,.533,8,26,.308,12,18,.667,100,39,95,.411,24,54,.444,15,41,.366,10,11,.909,103
1011,MEM,2021-12-19,100,,POR,L 100-105,240,35,91,.385,26,57,.456,9,34,.265,21,25,.840,100,35,74,.473,24,42,.571,11,32,.344,24,28,.857,105
1012,DET,2021-12-19,100,,MIA,W 100-90,240,35,75,.467,27,43,.628,8,32,.250,22,30,.733,100,28,74,.378,15,31,.484,13,43,.302,21,33,.636,90
1013,IND,2021-12-13,100,,GSW,L 100-102,240,35,87,.402,28,57,.491,7,30,.233,23,31,.742,100,42,84,.500,34,54,.630,8,30,.267,10,14,.714,102
1014,MIN,2021-11-29,100,,IND,W 100-98,240,36,82,.439,27,47,.574,9,35,.257,19,26,.731,100,36,91,.396,27,54,.500,9,37,.243,17,21,.810,98
1015,IND,2021-11-28,100,,MIL,L 100-118,240,38,92,.413,26,47,.553,12,45,.267,12,16,.750,100,46,90,.511,38,55,.691,8,35,.229,18,22,.818,118
1016,MEM,2021-11-26,100,,ATL,L 100-132,240,37,91,.407,25,53,.472,12,38,.316,14,19,.737,100,52,89,.584,39,62,.629,13,27,.481,15,21,.714,132
1017,UTA,2021-11-11,100,,IND,L 100-111,240,39,83,.470,30,51,.588,9,32,.281,13,23,.565,100,43,96,.448,32,65,.492,11,31,.355,14,19,.737,111
1018,NOP,2021-11-10,100,,OKC,L 100-108,240,34,97,.351,25,62,.403,9,35,.257,23,32,.719,100,37,87,.425,27,53,.509,10,34,.294,24,30,.800,108
1019,NYK,2021-11-10,100,,MIL,L 100-112,240,36,83,.434,20,46,.435,16,37,.432,12,17,.706,100,40,90,.444,14,40,.350,26,50,.520,6,9,.667,112
1020,WAS,2021-11-03,100,,TOR,L 100-109,240,34,78,.436,26,46,.565,8,32,.250,24,30,.800,100,41,88,.466,31,63,.492,10,25,.400,17,20,.850,109
1021,ORL,2022-03-08,99,,PHO,L 99-102,240,35,92,.380,28,53,.528,7,39,.179,22,25,.880,99,35,92,.380,22,55,.400,13,37,.351,19,23,.826,102
1022,MIA,2022-03-05,99,,PHI,W 99-82,240,35,72,.486,22,44,.500,13,28,.464,16,19,.842,99,28,82,.341,21,41,.512,7,41,.171,19,23,.826,82
1023,MIA,2022-02-15,99,,DAL,L 99-107,240,35,84,.417,28,57,.491,7,27,.259,22,27,.815,99,34,76,.447,16,35,.457,18,41,.439,21,33,.636,107
1024,LAL,2022-02-02,99,,POR,W 99-94,240,33,78,.423,22,48,.458,11,30,.367,22,33,.667,99,35,98,.357,21,56,.375,14,42,.333,10,19,.526,94
1025,BOS,2022-01-08,99,,NYK,W 99-75,240,36,76,.474,24,47,.511,12,29,.414,15,17,.882,99,29,79,.367,18,48,.375,11,31,.355,6,15,.400,75
1026,DAL,2022-01-05,99,,GSW,W 99-82,240,33,87,.379,21,47,.447,12,40,.300,21,26,.808,99,33,81,.407,28,53,.528,5,28,.179,11,16,.688,82
1027,CHO,2022-01-02,99,,PHO,L 99-133,240,39,85,.459,30,50,.600,9,35,.257,12,21,.571,99,52,103,.505,35,62,.565,17,41,.415,12,12,1.000,133
1028,MEM,2021-12-20,99,,OKC,L 99-102,240,39,101,.386,28,69,.406,11,32,.344,10,13,.769,99,36,84,.429,25,46,.543,11,38,.289,19,28,.679,102
1029,ORL,2021-12-15,99,,ATL,L 99-111,240,35,90,.389,25,55,.455,10,35,.286,19,21,.905,99,42,85,.494,31,54,.574,11,31,.355,16,16,1.000,111
1030,DAL,2021-12-07,99,,BRK,L 99-102,240,36,90,.400,27,44,.614,9,46,.196,18,22,.818,99,42,83,.506,34,57,.596,8,26,.308,10,13,.769,102
1031,NYK,2021-12-04,99,,DEN,L 99-113,240,35,88,.398,23,48,.479,12,40,.300,17,21,.810,99,44,84,.524,24,41,.585,20,43,.465,5,5,1.000,113
1032,OKC,2021-11-26,99,,WAS,L 99-101,240,38,94,.404,27,61,.443,11,33,.333,12,14,.857,99,38,79,.481,28,50,.560,10,29,.345,15,15,1.000,101
1033,ORL,2021-11-24,99,,CHO,L 99-106,240,38,93,.409,23,51,.451,15,42,.357,8,10,.800,99,39,93,.419,27,53,.509,12,40,.300,16,21,.762,106
1034,BRK,2021-11-16,99,,GSW,L 99-117,240,34,88,.386,24,52,.462,10,36,.278,21,27,.778,99,41,79,.519,28,39,.718,13,40,.325,22,28,.786,117
1035,OKC,2021-11-07,99,,SAS,W 99-94,240,35,94,.372,23,52,.442,12,42,.286,17,20,.850,99,41,100,.410,35,70,.500,6,30,.200,6,9,.667,94
1036,LAC,2021-11-01,99,,OKC,W 99-94,240,35,92,.380,20,50,.400,15,42,.357,14,19,.737,99,35,90,.389,24,53,.453,11,37,.297,13,16,.813,94
1037,NOP,2021-10-27,99,,ATL,L 99-102,240,40,93,.430,29,57,.509,11,36,.306,8,9,.889,99,40,96,.417,32,66,.485,8,30,.267,14,17,.824,102
1038,NYK,2022-04-06,98,,BRK,L 98-110,240,32,83,.386,19,45,.422,13,38,.342,21,36,.583,98,41,93,.441,27,52,.519,14,41,.341,14,18,.778,110
1039,OKC,2022-04-05,98,,POR,W 98-94,240,39,81,.481,30,52,.577,9,29,.310,11,22,.500,98,35,83,.422,24,51,.471,11,32,.344,13,16,.813,94
1040,BOS,2022-03-30,98,,MIA,L 98-106,240,35,85,.412,24,48,.500,11,37,.297,17,23,.739,98,38,79,.481,25,45,.556,13,34,.382,17,25,.680,106
1041,POR,2022-03-26,98,,HOU,L 98-115,240,37,93,.398,25,53,.472,12,40,.300,12,17,.706,98,44,84,.524,29,49,.592,15,35,.429,12,18,.667,115
1042,HOU,2022-03-20,98,,MEM,L 98-122,240,37,86,.430,27,55,.491,10,31,.323,14,24,.583,98,46,96,.479,30,62,.484,16,34,.471,14,17,.824,122
1043,CLE,2022-03-02,98,,CHO,L 98-119,240,37,79,.468,27,48,.563,10,31,.323,14,21,.667,98,43,85,.506,26,47,.553,17,38,.447,16,22,.727,119
1044,HOU,2022-02-27,98,,LAC,L 98-99,240,35,92,.380,18,50,.360,17,42,.405,11,18,.611,98,34,77,.442,23,43,.535,11,34,.324,20,28,.714,99
1045,OKC,2022-02-09,98,,TOR,L 98-117,240,36,87,.414,22,40,.550,14,47,.298,12,14,.857,98,45,88,.511,32,53,.604,13,35,.371,14,14,1.000,117
1046,OKC,2022-02-07,98,,GSW,L 98-110,240,37,90,.411,26,54,.481,11,36,.306,13,17,.765,98,41,82,.500,26,39,.667,15,43,.349,13,17,.765,110
1047,CLE,2022-02-06,98,,IND,W 98-85,240,34,84,.405,23,52,.442,11,32,.344,19,28,.679,98,31,83,.373,23,52,.442,8,31,.258,15,17,.882,85
1048,OKC,2022-01-31,98,,POR,W 98-81,240,35,86,.407,23,45,.511,12,41,.293,16,17,.941,98,34,81,.420,27,43,.628,7,38,.184,6,8,.750,81
1049,MIA,2022-01-15,98,,PHI,L 98-109,240,33,86,.384,24,51,.471,9,35,.257,23,30,.767,98,40,79,.506,27,47,.574,13,32,.406,16,21,.762,109
1050,PHI,2022-01-12,98,,CHO,L 98-109,240,34,73,.466,22,43,.512,12,30,.400,18,28,.643,98,46,89,.517,36,55,.655,10,34,.294,7,8,.875,109
1051,MIN,2022-01-05,98,,OKC,W 98-90,240,36,90,.400,24,46,.522,12,44,.273,14,20,.700,98,33,90,.367,24,55,.436,9,35,.257,15,18,.833,90
1052,ATL,2021-12-22,98,,ORL,L 98-104,240,32,80,.400,20,49,.408,12,31,.387,22,29,.759,98,38,85,.447,27,48,.563,11,37,.297,17,23,.739,104
1053,WAS,2021-12-11,98,,UTA,L 98-123,240,41,89,.461,33,64,.516,8,25,.320,8,14,.571,98,48,93,.516,35,54,.648,13,39,.333,14,17,.824,123
1054,NYK,2021-11-17,98,,ORL,L 98-104,240,37,88,.420,21,39,.538,16,49,.327,8,12,.667,98,39,96,.406,28,58,.483,11,38,.289,15,18,.833,104
1055,CLE,2021-11-12,98,,DET,W 98-78,240,39,82,.476,25,41,.610,14,41,.341,6,9,.667,98,29,79,.367,20,49,.408,9,30,.300,11,13,.846,78
1056,MIL,2021-11-05,98,,NYK,L 98-113,240,33,82,.402,17,39,.436,16,43,.372,16,21,.762,98,41,96,.427,31,56,.554,10,40,.250,21,26,.808,113
1057,DET,2021-11-04,98,,PHI,L 98-109,240,35,87,.402,24,51,.471,11,36,.306,17,19,.895,98,41,83,.494,29,51,.569,12,32,.375,15,22,.682,109
1058,ATL,2021-11-04,98,,UTA,L 98-116,240,35,82,.427,28,54,.519,7,28,.250,21,26,.808,98,41,81,.506,24,40,.600,17,41,.415,17,23,.739,116
1059,OKC,2021-10-26,98,,GSW,L 98-106,240,36,86,.419,24,52,.462,12,34,.353,14,17,.824,98,39,83,.470,25,43,.581,14,40,.350,14,18,.778,106
1060,MIN,2021-10-25,98,,NOP,L 98-107,240,31,90,.344,16,40,.400,15,50,.300,21,27,.778,98,39,87,.448,29,57,.509,10,30,.333,19,23,.826,107
1061,PHO,2021-10-20,98,,DEN,L 98-110,240,36,87,.414,22,50,.440,14,37,.378,12,17,.706,98,44,83,.530,27,44,.614,17,39,.436,5,9,.556,110
1062,DEN,2022-04-05,97,,SAS,L 97-116,240,41,98,.418,34,65,.523,7,33,.212,8,12,.667,97,44,89,.494,32,63,.508,12,26,.462,16,24,.667,116
1063,DET,2022-03-25,97,,WAS,L 97-100,240,39,95,.411,33,63,.524,6,32,.188,13,14,.929,97,36,83,.434,27,53,.509,9,30,.300,19,21,.905,100
1064,LAC,2022-03-25,97,,PHI,L 97-122,240,34,85,.400,26,60,.433,8,25,.320,21,25,.840,97,43,92,.467,28,57,.491,15,35,.429,21,24,.875,122
1065,SAC,2022-03-18,97,,BOS,L 97-126,240,33,79,.418,20,43,.465,13,36,.361,18,24,.750,97,46,82,.561,24,42,.571,22,40,.550,12,17,.706,126
1066,TOR,2022-03-04,97,,ORL,L 97-103,240,37,93,.398,25,56,.446,12,37,.324,11,17,.647,97,36,95,.379,25,58,.431,11,37,.297,20,21,.952,103
1067,BRK,2022-02-28,97,,TOR,L 97-133,240,33,86,.384,21,51,.412,12,35,.343,19,24,.792,97,51,99,.515,33,61,.541,18,38,.474,13,22,.591,133
1068,DAL,2022-02-12,97,,LAC,L 97-99,240,35,85,.412,20,46,.435,15,39,.385,12,19,.632,97,43,82,.524,36,60,.600,7,22,.318,6,11,.545,99
1069,NOP,2022-02-10,97,,MIA,L 97-112,240,36,85,.424,25,44,.568,11,41,.268,14,16,.875,97,39,81,.481,29,49,.592,10,32,.313,24,28,.857,112
1070,NOP,2022-01-29,97,,BOS,L 97-107,240,36,82,.439,28,50,.560,8,32,.250,17,23,.739,97,43,81,.531,29,40,.725,14,41,.341,7,11,.636,107
1071,UTA,2022-01-26,97,,PHO,L 97-105,240,34,79,.430,22,49,.449,12,30,.400,17,23,.739,97,40,82,.488,33,64,.516,7,18,.389,18,27,.667,105
1072,DET,2022-01-08,97,,ORL,W 97-92,240,38,87,.437,28,54,.519,10,33,.303,11,16,.688,97,29,86,.337,15,40,.375,14,46,.304,20,23,.870,92
1073,BOS,2022-01-05,97,,SAS,L 97-99,240,40,90,.444,31,62,.500,9,28,.321,8,9,.889,97,42,88,.477,32,62,.516,10,26,.385,5,5,1.000,99
1074,NYK,2021-12-12,97,,MIL,L 97-112,240,35,82,.427,18,33,.545,17,49,.347,10,13,.769,97,42,88,.477,28,47,.596,14,41,.341,14,17,.824,112
1075,TOR,2021-12-02,97,,MIL,W 97-93,240,37,88,.420,23,48,.479,14,40,.350,9,14,.643,97,32,85,.376,21,54,.389,11,31,.355,18,25,.720,93
1076,TOR,2021-11-28,97,,BOS,L 97-109,240,35,93,.376,22,51,.431,13,42,.310,14,16,.875,97,34,82,.415,22,48,.458,12,34,.353,29,31,.935,109
1077,UTA,2021-11-26,97,,NOP,L 97-98,240,36,80,.450,23,47,.489,13,33,.394,12,18,.667,97,38,89,.427,27,62,.435,11,27,.407,11,13,.846,98
1078,NYK,2021-11-26,97,,PHO,L 97-118,240,34,92,.370,22,53,.415,12,39,.308,17,22,.773,97,44,79,.557,31,51,.608,13,28,.464,17,21,.810,118
1079,LAC,2021-11-21,97,,DAL,W 97-91,240,36,75,.480,24,46,.522,12,29,.414,13,18,.722,97,34,83,.410,28,53,.528,6,30,.200,17,18,.944,91
1080,DET,2021-11-17,97,,IND,W 97-89,240,34,80,.425,26,52,.500,8,28,.286,21,28,.750,97,33,79,.418,24,42,.571,9,37,.243,14,19,.737,89
1081,CHO,2021-11-17,97,,WAS,W 97-87,240,42,96,.438,32,64,.500,10,32,.313,3,6,.500,97,33,90,.367,25,48,.521,8,42,.190,13,16,.813,87
1082,MIN,2021-11-01,97,,ORL,L 97-115,240,36,97,.371,22,46,.478,14,51,.275,11,19,.579,97,37,82,.451,20,39,.513,17,43,.395,24,30,.800,115
1083,HOU,2021-10-24,97,,BOS,L 97-107,240,32,75,.427,18,43,.419,14,32,.438,19,24,.792,97,38,86,.442,23,39,.590,15,47,.319,16,20,.800,107
1084,CHI,2021-10-23,97,,DET,W 97-82,240,35,84,.417,24,58,.414,11,26,.423,16,19,.842,97,34,88,.386,29,60,.483,5,28,.179,9,15,.600,82
1085,NOP,2021-10-20,97,,PHI,L 97-117,240,39,93,.419,26,63,.413,13,30,.433,6,9,.667,97,44,85,.518,31,60,.517,13,25,.520,16,20,.800,117
1086,POR,2022-03-23,96,,SAS,L 96-133,240,36,94,.383,29,68,.426,7,26,.269,17,18,.944,96,46,94,.489,27,50,.540,19,44,.432,22,24,.917,133
1087,BRK,2022-01-25,96,,LAL,L 96-106,240,37,88,.420,30,61,.492,7,27,.259,15,22,.682,96,42,89,.472,30,51,.588,12,38,.316,10,10,1.000,106
1088,MIL,2022-01-15,96,,TOR,L 96-103,240,26,77,.338,14,38,.368,12,39,.308,32,35,.914,96,40,91,.440,28,56,.500,12,35,.343,11,20,.550,103
1089,CHI,2022-01-14,96,,GSW,L 96-138,240,37,87,.425,27,49,.551,10,38,.263,12,18,.667,96,53,94,.564,34,52,.654,19,42,.452,13,17,.765,138
1090,GSW,2022-01-09,96,,CLE,W 96-82,240,39,97,.402,29,55,.527,10,42,.238,8,10,.800,96,32,75,.427,25,51,.490,7,24,.292,11,18,.611,82
1091,SAC,2021-12-31,96,,DAL,L 96-112,240,38,91,.418,28,62,.452,10,29,.345,10,12,.833,96,42,81,.519,33,59,.559,9,22,.409,19,22,.864,112
1092,WAS,2021-12-26,96,,PHI,L 96-117,240,35,90,.389,27,57,.474,8,33,.242,18,28,.643,96,43,86,.500,31,55,.564,12,31,.387,19,22,.864,117
1093,PHI,2021-12-23,96,,ATL,L 96-98,240,33,80,.413,27,53,.509,6,27,.222,24,26,.923,96,37,82,.451,30,58,.517,7,24,.292,17,19,.895,98
1094,PHI,2021-12-15,96,,MIA,L 96-101,240,35,79,.443,23,42,.548,12,37,.324,14,17,.824,96,35,78,.449,17,34,.500,18,44,.409,13,17,.765,101
1095,NYK,2021-12-14,96,,GSW,L 96-105,240,30,83,.361,14,41,.341,16,42,.381,20,22,.909,96,35,77,.455,20,37,.541,15,40,.375,20,27,.741,105
1096,PHI,2021-12-09,96,,UTA,L 96-118,240,38,88,.432,32,55,.582,6,33,.182,14,15,.933,96,43,91,.473,28,51,.549,15,40,.375,17,24,.708,118
1097,MEM,2021-12-08,96,,DAL,L 96-104,240,36,90,.400,27,59,.458,9,31,.290,15,25,.600,96,37,77,.481,25,44,.568,12,33,.364,18,23,.783,104
1098,ATL,2021-12-03,96,,PHI,L 96-98,240,31,76,.408,21,48,.438,10,28,.357,24,30,.800,96,38,81,.469,29,59,.492,9,22,.409,13,17,.765,98
1099,DAL,2021-11-29,96,,CLE,L 96-114,240,39,89,.438,27,50,.540,12,39,.308,6,15,.400,96,45,80,.563,35,61,.574,10,19,.526,14,18,.778,114
1100,SAS,2021-11-26,96,,BOS,W 96-88,240,38,87,.437,32,63,.508,6,24,.250,14,19,.737,96,34,92,.370,24,58,.414,10,34,.294,10,15,.667,88
1101,NOP,2021-11-22,96,,MIN,L 96-110,240,37,88,.420,31,56,.554,6,32,.188,16,18,.889,96,40,100,.400,30,56,.536,10,44,.227,20,28,.714,110
1102,MIL,2021-11-19,96,,OKC,W 96-89,240,31,83,.373,19,42,.452,12,41,.293,22,26,.846,96,32,91,.352,20,43,.465,12,48,.250,13,21,.619,89
1103,MIN,2021-11-15,96,,PHO,L 96-99,240,31,85,.365,18,41,.439,13,44,.295,21,27,.778,96,32,85,.376,25,54,.463,7,31,.226,28,36,.778,99
1104,OKC,2021-11-14,96,,BRK,L 96-120,240,36,90,.400,22,45,.489,14,45,.311,10,11,.909,96,41,82,.500,23,39,.590,18,43,.419,20,21,.952,120
1105,PHI,2021-11-08,96,,NYK,L 96-103,240,35,91,.385,22,51,.431,13,40,.325,13,16,.813,96,40,91,.440,27,51,.529,13,40,.325,10,13,.769,103
1106,MIN,2021-10-23,96,,NOP,W 96-89,240,39,96,.406,27,58,.466,12,38,.316,6,10,.600,96,31,89,.348,22,49,.449,9,40,.225,18,23,.783,89
1107,ORL,2021-10-22,96,,NYK,L 96-121,240,33,83,.398,16,40,.400,17,43,.395,13,15,.867,96,44,88,.500,20,34,.588,24,54,.444,9,17,.529,121
1108,MIA,2022-03-26,95,,BRK,L 95-110,240,33,75,.440,23,41,.561,10,34,.294,19,26,.731,95,39,83,.470,28,50,.560,11,33,.333,21,26,.808,110
1109,LAL,2022-02-27,95,,NOP,L 95-123,240,35,84,.417,28,50,.560,7,34,.206,18,20,.900,95,47,92,.511,34,62,.548,13,30,.433,16,25,.640,123
1110,POR,2022-02-24,95,,GSW,L 95-132,240,31,79,.392,22,44,.500,9,35,.257,24,29,.828,95,45,88,.511,30,47,.638,15,41,.366,27,32,.844,132
1111,POR,2022-02-08,95,,ORL,L 95-113,240,32,91,.352,21,53,.396,11,38,.289,20,26,.769,95,44,90,.489,25,52,.481,19,38,.500,6,8,.750,113
1112,SAS,2022-02-03,95,,MIA,L 95-112,240,30,80,.375,22,47,.468,8,33,.242,27,38,.711,95,42,83,.506,30,53,.566,12,30,.400,16,18,.889,112
1113,CLE,2022-01-24,95,,NYK,W 95-93,240,35,81,.432,22,45,.489,13,36,.361,12,20,.600,95,35,84,.417,23,46,.500,12,38,.316,11,21,.524,93
1114,TOR,2022-01-11,95,,PHO,L 95-99,240,36,89,.404,28,52,.538,8,37,.216,15,25,.600,95,35,74,.473,24,42,.571,11,32,.344,18,22,.818,99
1115,OKC,2022-01-09,95,,DEN,L 95-99,240,38,88,.432,29,50,.580,9,38,.237,10,12,.833,95,37,89,.416,24,53,.453,13,36,.361,12,16,.750,99
1116,OKC,2021-12-31,95,,NYK,W 95-80,240,36,87,.414,18,44,.409,18,43,.419,5,7,.714,95,30,81,.370,22,40,.550,8,41,.195,12,22,.545,80
1117,SAC,2021-12-29,95,,DAL,W 95-94,240,36,75,.480,26,49,.531,10,26,.385,13,15,.867,95,38,81,.469,29,57,.509,9,24,.375,9,13,.692,94
1118,DAL,2021-12-23,95,,MIL,L 95-102,240,35,86,.407,23,41,.561,12,45,.267,13,17,.765,95,37,82,.451,27,46,.587,10,36,.278,18,22,.818,102
1119,OKC,2021-12-10,95,,LAL,L 95-116,240,38,96,.396,28,52,.538,10,44,.227,9,14,.643,95,41,87,.471,22,45,.489,19,42,.452,15,20,.750,116
1120,DEN,2021-11-06,95,,HOU,W 95-94,240,36,89,.404,27,49,.551,9,40,.225,14,17,.824,95,35,75,.467,27,47,.574,8,28,.286,16,24,.667,94
1121,MIL,2021-10-31,95,,UTA,L 95-107,240,39,96,.406,27,55,.491,12,41,.293,5,6,.833,95,35,75,.467,23,38,.605,12,37,.324,25,27,.926,107
1122,LAL,2021-10-31,95,,HOU,W 95-85,240,39,96,.406,30,65,.462,9,31,.290,8,13,.615,95,32,76,.421,26,48,.542,6,28,.214,15,29,.517,85
1123,BRK,2021-10-24,95,,CHO,L 95-111,240,38,87,.437,29,52,.558,9,35,.257,10,12,.833,95,43,94,.457,33,64,.516,10,30,.333,15,19,.789,111
1124,TOR,2021-10-23,95,,DAL,L 95-103,240,34,85,.400,23,48,.479,11,37,.297,16,23,.696,95,38,91,.418,24,49,.490,14,42,.333,13,18,.722,103
1125,SAS,2022-04-09,94,,GSW,L 94-100,240,32,80,.400,22,49,.449,10,31,.323,20,27,.741,94,33,81,.407,25,49,.510,8,32,.250,26,33,.788,100
1126,CHI,2022-04-06,94,,BOS,L 94-117,240,35,80,.438,28,57,.491,7,23,.304,17,23,.739,94,43,88,.489,26,51,.510,17,37,.459,14,22,.636,117
1127,WAS,2022-03-29,94,,CHI,L 94-107,240,38,79,.481,32,53,.604,6,26,.231,12,17,.706,94,43,85,.506,37,67,.552,6,18,.333,15,18,.833,107
1128,CLE,2022-03-26,94,,CHI,L 94-98,240,34,82,.415,27,51,.529,7,31,.226,19,27,.704,94,36,75,.480,31,54,.574,5,21,.238,21,25,.840,98
1129,ORL,2022-03-22,94,,GSW,W 94-90,240,34,79,.430,24,43,.558,10,36,.278,16,20,.800,94,34,85,.400,23,53,.434,11,32,.344,11,16,.688,90
1130,GSW,2022-01-23,94,,UTA,W 94-92,240,36,83,.434,23,41,.561,13,42,.310,9,10,.900,94,31,81,.383,20,46,.435,11,35,.314,19,23,.826,92
1131,CLE,2022-01-22,94,,OKC,W 94-87,240,35,76,.461,29,49,.592,6,27,.222,18,35,.514,94,33,85,.388,21,44,.477,12,41,.293,9,16,.563,87
1132,MIL,2022-01-21,94,,CHI,W 94-90,240,34,88,.386,28,57,.491,6,31,.194,20,28,.714,94,31,85,.365,24,47,.511,7,38,.184,21,24,.875,90
1133,IND,2022-01-14,94,,PHO,L 94-112,240,34,88,.386,21,45,.467,13,43,.302,13,18,.722,94,40,88,.455,29,60,.483,11,28,.393,21,23,.913,112
1134,SAC,2021-11-22,94,,PHI,L 94-102,240,33,80,.413,26,49,.531,7,31,.226,21,29,.724,94,36,85,.424,27,53,.509,9,32,.281,21,27,.778,102
1135,NOP,2021-11-19,94,,LAC,W 94-81,240,38,87,.437,25,57,.439,13,30,.433,5,8,.625,94,34,90,.378,25,53,.472,9,37,.243,4,5,.800,81
1136,MEM,2021-11-12,94,,PHO,L 94-119,240,37,98,.378,30,65,.462,7,33,.212,13,23,.565,94,46,94,.489,28,57,.491,18,37,.486,9,9,1.000,119
1137,CLE,2021-11-10,94,,WAS,L 94-97,240,35,76,.461,26,45,.578,9,31,.290,15,21,.714,94,35,84,.417,25,56,.446,10,28,.357,17,17,1.000,97
1138,IND,2021-10-30,94,,TOR,L 94-97,240,35,81,.432,22,38,.579,13,43,.302,11,16,.688,94,39,92,.424,28,60,.467,11,32,.344,8,12,.667,97
1139,NYK,2022-03-20,93,,UTA,L 93-108,240,31,83,.373,15,43,.349,16,40,.400,15,21,.714,93,34,74,.459,17,28,.607,17,46,.370,23,29,.793,108
1140,LAC,2022-03-06,93,,NYK,L 93-116,240,33,88,.375,22,54,.407,11,34,.324,16,22,.727,93,42,89,.472,29,60,.483,13,29,.448,19,30,.633,116
1141,POR,2022-02-04,93,,OKC,L 93-96,240,40,101,.396,34,68,.500,6,33,.182,7,10,.700,93,33,87,.379,18,45,.400,15,42,.357,15,21,.714,96
1142,DET,2022-02-04,93,,BOS,L 93-102,240,34,104,.327,24,78,.308,10,26,.385,15,20,.750,93,37,82,.451,28,54,.519,9,28,.321,19,25,.760,102
1143,CLE,2022-01-31,93,,NOP,W 93-90,240,36,84,.429,27,53,.509,9,31,.290,12,14,.857,93,33,85,.388,27,55,.491,6,30,.200,18,21,.857,90
1144,MIA,2021-12-26,93,,ORL,W 93-83,240,36,89,.404,26,55,.473,10,34,.294,11,18,.611,93,31,72,.431,21,40,.525,10,32,.313,11,17,.647,83
1145,BRK,2021-12-18,93,,ORL,L 93-100,240,39,102,.382,30,56,.536,9,46,.196,6,8,.750,93,39,94,.415,29,63,.460,10,31,.323,12,13,.923,100
1146,MIL,2021-10-30,93,,SAS,L 93-102,240,36,89,.404,26,50,.520,10,39,.256,11,16,.688,93,39,95,.411,32,64,.500,7,31,.226,17,24,.708,102
1147,BRK,2021-10-27,93,,MIA,L 93-106,240,33,85,.388,19,42,.452,14,43,.326,13,14,.929,93,38,96,.396,30,67,.448,8,29,.276,22,26,.846,106
1148,WAS,2022-04-08,92,,NYK,L 92-114,240,35,69,.507,26,41,.634,9,28,.321,13,17,.765,92,41,88,.466,25,49,.510,16,39,.410,16,20,.800,114
1149,BOS,2022-03-13,92,,DAL,L 92-95,240,33,88,.375,24,51,.471,9,37,.243,17,19,.895,92,33,74,.446,18,37,.486,15,37,.405,14,19,.737,95
1150,POR,2022-02-27,92,,DEN,L 92-124,240,34,91,.374,28,55,.509,6,36,.167,18,26,.692,92,44,86,.512,32,49,.653,12,37,.324,24,31,.774,124
1151,CLE,2022-02-26,92,,WAS,W 92-86,240,32,83,.386,24,58,.414,8,25,.320,20,24,.833,92,35,81,.432,24,58,.414,11,23,.478,5,6,.833,86
1152,LAC,2021-12-20,92,,SAS,L 92-116,240,34,87,.391,25,55,.455,9,32,.281,15,20,.750,92,50,114,.439,38,77,.494,12,37,.324,4,6,.667,116
1153,SAC,2021-11-30,92,,LAL,L 92-117,240,35,79,.443,29,50,.580,6,29,.207,16,22,.727,92,46,92,.500,35,64,.547,11,28,.393,14,20,.700,117
1154,DET,2021-11-23,92,,MIA,L 92-100,240,35,84,.417,25,46,.543,10,38,.263,12,14,.857,92,35,76,.461,26,47,.553,9,29,.310,21,29,.724,100
1155,NYK,2021-11-15,92,,IND,W 92-84,240,37,86,.430,26,52,.500,11,34,.324,7,10,.700,92,32,86,.372,24,49,.490,8,37,.216,12,16,.750,84
1156,CLE,2021-11-15,92,,BOS,L 92-98,240,32,83,.386,16,43,.372,16,40,.400,12,16,.750,92,36,78,.462,26,49,.531,10,29,.345,16,20,.800,98
1157,ORL,2021-11-13,92,,WAS,L 92-104,240,31,92,.337,18,52,.346,13,40,.325,17,20,.850,92,42,84,.500,30,49,.612,12,35,.343,8,10,.800,104
1158,HOU,2021-11-12,92,,POR,L 92-104,240,34,85,.400,27,53,.509,7,32,.219,17,27,.630,92,34,87,.391,23,51,.451,11,36,.306,25,31,.806,104
1159,SAS,2022-03-18,91,,NOP,L 91-124,240,32,89,.360,21,45,.467,11,44,.250,16,20,.800,91,48,96,.500,34,62,.548,14,34,.412,14,18,.778,124
1160,MIN,2022-02-16,91,,TOR,L 91-103,240,30,77,.390,20,35,.571,10,42,.238,21,29,.724,91,40,88,.455,32,63,.508,8,25,.320,15,19,.789,103
1161,BRK,2022-02-08,91,,BOS,L 91-126,240,38,99,.384,28,63,.444,10,36,.278,5,13,.385,91,50,91,.549,36,51,.706,14,40,.350,12,16,.750,126
1162,CHO,2022-01-23,91,,ATL,L 91-113,240,34,87,.391,30,51,.588,4,36,.111,19,27,.704,91,40,88,.455,25,49,.510,15,39,.385,18,24,.750,113
1163,NYK,2022-01-20,91,,NOP,L 91-102,240,29,77,.377,20,39,.513,9,38,.237,24,36,.667,91,38,76,.500,27,48,.563,11,28,.393,15,22,.682,102
1164,UTA,2022-01-12,91,,CLE,L 91-111,240,34,85,.400,18,38,.474,16,47,.340,7,11,.636,91,43,81,.531,32,51,.627,11,30,.367,14,17,.824,111
1165,ATL,2022-01-12,91,,MIA,L 91-115,240,31,82,.378,18,37,.486,13,45,.289,16,23,.696,91,43,90,.478,27,45,.600,16,45,.356,13,14,.929,115
1166,HOU,2022-01-10,91,,PHI,L 91-111,240,30,77,.390,17,35,.486,13,42,.310,18,27,.667,91,43,94,.457,33,59,.559,10,35,.286,15,18,.833,111
1167,DAL,2021-12-03,91,,NOP,L 91-107,240,32,79,.405,22,45,.489,10,34,.294,17,26,.654,91,37,90,.411,25,60,.417,12,30,.400,21,28,.750,107
1168,TOR,2021-11-30,91,,MEM,L 91-98,240,36,91,.396,26,52,.500,10,39,.256,9,12,.750,91,36,93,.387,26,59,.441,10,34,.294,16,19,.842,98
1169,CLE,2021-11-13,91,,BOS,W 91-89,240,31,81,.383,21,43,.488,10,38,.263,19,22,.864,91,33,78,.423,27,55,.491,6,23,.261,17,18,.944,89
1170,SAC,2021-11-07,91,,IND,L 91-94,240,31,84,.369,21,50,.420,10,34,.294,19,22,.864,91,37,83,.446,31,58,.534,6,25,.240,14,18,.778,94
1171,MIN,2021-10-30,91,,DEN,L 91-93,240,35,89,.393,22,48,.458,13,41,.317,8,9,.889,91,36,88,.409,27,51,.529,9,37,.243,12,16,.750,93
1172,HOU,2021-10-28,91,,UTA,L 91-122,240,31,95,.326,22,51,.431,9,44,.205,20,23,.870,91,41,85,.482,25,39,.641,16,46,.348,24,30,.800,122
1173,SAC,2022-04-03,90,,GSW,L 90-109,240,31,81,.383,24,48,.500,7,33,.212,21,24,.875,90,41,79,.519,25,45,.556,16,34,.471,11,15,.733,109
1174,ORL,2022-03-20,90,,OKC,W 90-85,240,32,83,.386,25,52,.481,7,31,.226,19,24,.792,90,30,92,.326,17,44,.386,13,48,.271,12,18,.667,85
1175,MIA,2022-03-09,90,,PHO,L 90-111,240,35,88,.398,25,55,.455,10,33,.303,10,13,.769,90,45,99,.455,34,62,.548,11,37,.297,10,10,1.000,111
1176,CHO,2022-01-30,90,,LAC,L 90-115,240,32,98,.327,24,64,.375,8,34,.235,18,27,.667,90,44,84,.524,33,56,.589,11,28,.393,16,19,.842,115
1177,LAL,2021-12-21,90,,PHO,L 90-108,240,34,87,.391,27,52,.519,7,35,.200,15,23,.652,90,41,93,.441,29,52,.558,12,41,.293,14,15,.933,108
1178,MIL,2021-12-18,90,,CLE,L 90-119,240,35,89,.393,23,51,.451,12,38,.316,8,11,.727,90,45,90,.500,29,45,.644,16,45,.356,13,14,.929,119
1179,TOR,2021-12-10,90,,NYK,W 90-87,240,30,87,.345,18,52,.346,12,35,.343,18,23,.783,90,29,81,.358,20,47,.426,9,34,.265,20,24,.833,87
1180,MIA,2021-12-06,90,,MEM,L 90-105,240,35,76,.461,29,54,.537,6,22,.273,14,17,.824,90,38,89,.427,25,56,.446,13,33,.394,16,21,.762,105
1181,POR,2021-12-06,90,,LAC,L 90-102,240,35,79,.443,30,57,.526,5,22,.227,15,20,.750,90,41,92,.446,30,56,.536,11,36,.306,9,14,.643,102
1182,DAL,2021-12-04,90,,MEM,L 90-97,240,31,92,.337,16,49,.327,15,43,.349,13,19,.684,90,37,76,.487,28,50,.560,9,26,.346,14,24,.583,97
1183,LAC,2021-11-28,90,,GSW,L 90-105,240,32,80,.400,23,52,.442,9,28,.321,17,25,.680,90,38,86,.442,21,46,.457,17,40,.425,12,22,.545,105
1184,ATL,2021-11-27,90,,NYK,L 90-99,240,33,93,.355,24,56,.429,9,37,.243,15,20,.750,90,36,82,.439,25,53,.472,11,29,.379,16,22,.727,99
1185,OKC,2021-11-15,90,,MIA,L 90-103,240,34,83,.410,19,42,.452,15,41,.366,7,10,.700,90,37,82,.451,19,42,.452,18,40,.450,11,13,.846,103
1186,LAC,2021-11-14,90,,CHI,L 90-100,240,29,81,.358,18,47,.383,11,34,.324,21,21,1.000,90,38,86,.442,27,57,.474,11,29,.379,13,14,.929,100
1187,ORL,2021-11-10,90,,BRK,L 90-123,240,35,92,.380,31,59,.525,4,33,.121,16,24,.667,90,46,91,.505,30,54,.556,16,37,.432,15,17,.882,123
1188,DET,2021-11-05,90,,BRK,L 90-96,240,33,87,.379,22,53,.415,11,34,.324,13,18,.722,90,36,80,.450,25,53,.472,11,27,.407,13,14,.929,96
1189,ORL,2022-04-01,89,,TOR,L 89-102,240,34,79,.430,23,44,.523,11,35,.314,10,11,.909,89,36,86,.419,23,44,.523,13,42,.310,17,20,.850,102
1190,SAC,2021-12-22,89,,LAC,L 89-105,240,34,85,.400,22,47,.468,12,38,.316,9,12,.750,89,42,82,.512,35,58,.603,7,24,.292,14,16,.875,105
1191,SAC,2021-11-19,89,,TOR,L 89-108,240,32,84,.381,23,47,.489,9,37,.243,16,25,.640,89,38,84,.452,26,53,.491,12,31,.387,20,24,.833,108
1192,DEN,2021-11-18,89,,PHI,L 89-103,240,32,89,.360,20,53,.377,12,36,.333,13,16,.813,89,43,85,.506,32,56,.571,11,29,.379,6,12,.500,103
1193,CLE,2021-11-18,89,,GSW,L 89-104,240,34,80,.425,22,41,.537,12,39,.308,9,16,.563,89,41,83,.494,26,40,.650,15,43,.349,7,8,.875,104
1194,HOU,2021-11-14,89,,PHO,L 89-115,240,35,85,.412,28,53,.528,7,32,.219,12,18,.667,89,42,97,.433,28,57,.491,14,40,.350,17,20,.850,115
1195,ORL,2021-11-05,89,,SAS,L 89-102,240,35,89,.393,23,48,.479,12,41,.293,7,10,.700,89,40,90,.444,34,71,.479,6,19,.316,16,18,.889,102
1196,DET,2021-11-02,89,,MIL,L 89-117,240,30,93,.323,22,46,.478,8,47,.170,21,30,.700,89,42,84,.500,25,47,.532,17,37,.459,16,21,.762,117
1197,ORL,2022-04-03,88,,NYK,L 88-118,240,30,85,.353,18,41,.439,12,44,.273,16,27,.593,88,45,93,.484,30,49,.612,15,44,.341,13,16,.813,118
1198,PHI,2022-03-20,88,,TOR,L 88-93,240,30,73,.411,23,46,.500,7,27,.259,21,28,.750,88,35,93,.376,28,67,.418,7,26,.269,16,23,.696,93
1199,GSW,2022-03-16,88,,BOS,L 88-110,240,32,86,.372,21,38,.553,11,48,.229,13,16,.813,88,38,81,.469,23,41,.561,15,40,.375,19,22,.864,110
1200,ORL,2022-01-17,88,,POR,L 88-98,240,34,90,.378,26,58,.448,8,32,.250,12,20,.600,88,37,90,.411,30,56,.536,7,34,.206,17,18,.944,98
1201,MIN,2021-12-28,88,,NYK,L 88-96,240,34,85,.400,27,47,.574,7,38,.184,13,20,.650,88,37,90,.411,21,50,.420,16,40,.400,6,16,.375,96
1202,BOS,2021-12-01,88,,PHI,W 88-87,240,33,79,.418,22,51,.431,11,28,.393,11,15,.733,88,33,89,.371,25,58,.431,8,31,.258,13,17,.765,87
1203,ORL,2021-11-26,88,,CHI,L 88-123,240,30,80,.375,23,48,.479,7,32,.219,21,30,.700,88,48,86,.558,31,52,.596,17,34,.500,10,16,.625,123
1204,DET,2021-10-20,88,,CHI,L 88-94,240,36,90,.400,30,62,.484,6,28,.214,10,13,.769,88,37,86,.430,30,63,.476,7,23,.304,13,15,.867,94
1205,PHI,2022-02-15,87,,BOS,L 87-135,240,23,80,.288,15,48,.313,8,32,.250,33,39,.846,87,46,82,.561,21,37,.568,25,45,.556,18,22,.818,135
1206,WAS,2022-01-23,87,,BOS,L 87-116,240,33,93,.355,25,59,.424,8,34,.235,13,16,.813,87,40,90,.444,21,51,.412,19,39,.487,17,21,.810,116
1207,NYK,2022-01-17,87,,CHO,L 87-97,240,32,80,.400,20,46,.435,12,34,.353,11,21,.524,87,36,86,.419,22,47,.468,14,39,.359,11,17,.647,97
1208,LAC,2022-01-11,87,,DEN,W 87-85,240,34,84,.405,24,50,.480,10,34,.294,9,12,.750,87,32,80,.400,28,47,.596,4,33,.121,17,20,.850,85
1209,DEN,2021-10-25,87,,CLE,L 87-99,240,35,86,.407,26,48,.542,9,38,.237,8,12,.667,87,38,82,.463,31,57,.544,7,25,.280,16,20,.800,99
1210,CHO,2022-02-05,86,,MIA,L 86-104,240,33,86,.384,23,50,.460,10,36,.278,10,16,.625,86,38,91,.418,27,59,.458,11,32,.344,17,18,.944,104
1211,OKC,2022-01-02,86,,DAL,L 86-95,240,35,85,.412,25,55,.455,10,30,.333,6,9,.667,86,38,85,.447,24,46,.522,14,39,.359,5,7,.714,95
1212,GSW,2021-12-28,86,,DEN,L 86-89,240,30,72,.417,20,40,.500,10,32,.313,16,31,.516,86,34,83,.410,26,50,.520,8,33,.242,13,20,.650,89
1213,MEM,2022-01-14,85,,DAL,L 85-112,240,34,89,.382,27,58,.466,7,31,.226,10,13,.769,85,47,91,.516,39,59,.661,8,32,.250,10,16,.625,112
1214,DET,2021-12-29,85,,NYK,L 85-94,240,30,81,.370,18,46,.391,12,35,.343,13,17,.765,85,31,81,.383,23,50,.460,8,31,.258,24,27,.889,94
1215,MIA,2021-12-01,85,,CLE,L 85-111,240,32,85,.376,20,48,.417,12,37,.324,9,13,.692,85,37,68,.544,21,37,.568,16,31,.516,21,23,.913,111
1216,OKC,2021-12-12,84,,DAL,L 84-103,240,30,80,.375,17,43,.395,13,37,.351,11,16,.688,84,38,90,.422,29,57,.509,9,33,.273,18,23,.783,103
1217,MIN,2021-11-05,84,,LAC,L 84-104,240,31,89,.348,14,37,.378,17,52,.327,5,7,.714,84,36,88,.409,30,60,.500,6,28,.214,26,32,.813,104
1218,ORL,2022-02-06,83,,BOS,L 83-116,240,29,81,.358,24,55,.436,5,26,.192,20,21,.952,83,45,99,.455,32,53,.604,13,46,.283,13,14,.929,116
1219,POR,2021-12-02,83,,SAS,L 83-114,240,29,82,.354,17,48,.354,12,34,.353,13,17,.765,83,44,91,.484,30,55,.545,14,36,.389,12,16,.750,114
1220,LAL,2021-11-12,83,,MIN,L 83-107,240,29,82,.354,20,41,.488,9,41,.220,16,20,.800,83,43,94,.457,31,57,.544,12,37,.324,9,12,.750,107
1221,BOS,2021-10-22,83,,TOR,L 83-115,240,32,82,.390,21,48,.438,11,34,.324,8,11,.727,83,42,100,.420,32,65,.492,10,35,.286,21,21,1.000,115
1222,TOR,2021-10-20,83,,WAS,L 83-98,240,30,97,.309,23,63,.365,7,34,.206,16,22,.727,83,36,81,.444,31,54,.574,5,27,.185,21,26,.808,98
1223,BOS,2021-12-29,82,,LAC,L 82-91,240,35,101,.347,31,59,.525,4,42,.095,8,11,.727,82,33,81,.407,22,53,.415,11,28,.393,14,17,.824,91
1224,POR,2022-04-10,80,,UTA,L 80-111,240,31,83,.373,22,49,.449,9,34,.265,9,12,.750,80,37,82,.451,28,46,.609,9,36,.250,28,38,.737,111
1225,WAS,2022-02-05,80,,PHO,L 80-95,240,30,85,.353,25,61,.410,5,24,.208,15,19,.789,80,40,99,.404,32,68,.471,8,31,.258,7,14,.500,95
1226,ORL,2021-11-03,79,,BOS,L 79-92,240,27,84,.321,18,41,.439,9,43,.209,16,20,.800,79,33,79,.418,23,42,.548,10,37,.270,16,25,.640,92
1227,LAC,2021-10-27,79,,CLE,L 79-92,240,31,87,.356,22,46,.478,9,41,.220,8,13,.615,79,33,81,.407,30,61,.492,3,20,.150,23,27,.852,92
1228,MIA,2021-11-04,78,,BOS,L 78-95,240,28,81,.346,19,40,.475,9,41,.220,13,19,.684,78,31,78,.397,15,37,.405,16,41,.390,17,20,.850,95
1229,DAL,2022-03-09,77,,NYK,L 77-107,240,27,86,.314,21,42,.500,6,44,.136,17,25,.680,77,36,84,.429,27,50,.540,9,34,.265,26,33,.788,107
1230,CHI,2021-11-22,77,,IND,L 77-109,240,31,85,.365,25,57,.439,6,28,.214,9,15,.600,77,40,90,.444,27,59,.458,13,31,.419,16,18,.889,109